UNITID,EFFYLEV,LSTUDY,EFYTOTLT,EFYTOTLM,EFYTOTLW
100654,1,999,6388,2892,3496
100654,2,1,5295,2533,2762
100654,4,3,1093,359,734
100663,1,999,20647,8110,12537
100663,2,1,13004,5384,7620
100663,4,3,7643,2726,4917
100690,1,999,1062,512,550
100690,2,1,508,258,250
100690,4,3,554,254,300
100706,1,999,8976,4885,4091
100706,2,1,6984,3680,3304
100706,4,3,1992,1205,787
100724,1,999,6517,2614,3903
100724,2,1,5548,2331,3217
100724,4,3,969,283,686
100751,1,999,33681,15605,18076
100751,2,1,27175,12961,14214
100751,4,3,6506,2644,3862
100760,1,999,3411,1224,2187
100760,2,1,3411,1224,2187
100812,1,999,4782,1715,3067
100812,2,1,4782,1715,3067
100830,1,999,7119,2619,4500
100830,2,1,5833,2236,3597
100830,4,3,1286,383,903
100858,1,999,26840,13796,13044
100858,2,1,21322,11077,10245
100858,4,3,5518,2719,2799
100937,1,999,1594,807,787
100937,2,1,1571,795,776
100937,4,3,23,12,11
101028,1,999,2525,904,1621
101028,2,1,2525,904,1621
101073,1,999,774,440,334
101073,2,1,774,440,334
101116,1,999,1353,337,1016
101116,2,1,1248,322,926
101116,4,3,105,15,90
101143,1,999,4103,2417,1686
101143,2,1,4103,2417,1686
101161,1,999,6846,2521,4325
101161,2,1,6846,2521,4325
101189,1,999,3961,1648,2313
101189,2,1,3316,1341,1975
101189,4,3,645,307,338
101240,1,999,9949,3813,6136
101240,2,1,9949,3813,6136
101277,1,999,52,2,50
101277,2,1,52,2,50
101286,1,999,6992,2387,4605
101286,2,1,6992,2387,4605
101295,1,999,8505,3135,5370
101295,2,1,8505,3135,5370
101301,1,999,3385,1112,2273
101301,2,1,3385,1112,2273
101365,1,999,755,238,517
101365,2,1,755,238,517
101435,1,999,1315,616,699
101435,2,1,1315,616,699
101453,1,999,109,91,18
101453,2,1,73,58,15
101453,4,3,36,33,3
101462,1,999,2318,933,1385
101462,2,1,2318,933,1385
101471,1,999,1007,683,324
101471,2,1,1007,683,324
101480,1,999,11394,4844,6550
101480,2,1,9526,4152,5374
101480,4,3,1868,692,1176
101499,1,999,1956,858,1098
101499,2,1,1956,858,1098
101505,1,999,14856,5946,8910
101505,2,1,14856,5946,8910
101514,1,999,17627,7772,9855
101514,2,1,17627,7772,9855
101541,1,999,336,12,324
101541,2,1,336,12,324
101569,1,999,7058,2653,4405
101569,2,1,7058,2653,4405
101587,1,999,6871,1648,5223
101587,2,1,2259,944,1315
101587,4,3,4612,704,3908
101602,1,999,2657,908,1749
101602,2,1,2657,908,1749
101648,1,999,494,361,133
101648,2,1,494,361,133
101675,1,999,1954,947,1007
101675,2,1,1954,947,1007
101693,1,999,1998,581,1417
101693,2,1,1729,535,1194
101693,4,3,269,46,223
101709,1,999,3474,1111,2363
101709,2,1,2779,953,1826
101709,4,3,695,158,537
101736,1,999,6054,2585,3469
101736,2,1,6054,2585,3469
101879,1,999,8691,3714,4977
101879,2,1,7282,3140,4142
101879,4,3,1409,574,835
101897,1,999,4647,1780,2867
101897,2,1,4647,1780,2867
101912,1,999,2100,911,1189
101912,2,1,2048,883,1165
101912,4,3,52,28,24
101949,1,999,2171,718,1453
101949,2,1,2171,718,1453
101958,1,999,151,8,143
101958,2,1,151,8,143
101994,1,999,1074,418,656
101994,2,1,1074,418,656
102030,1,999,5906,2116,3790
102030,2,1,5906,2116,3790
102049,1,999,5190,2112,3078
102049,2,1,3118,1138,1980
102049,4,3,2072,974,1098
102058,1,999,522,280,242
102058,2,1,479,250,229
102058,4,3,43,30,13
102067,1,999,9728,4492,5236
102067,2,1,9728,4492,5236
102076,1,999,3305,1191,2114
102076,2,1,3305,1191,2114
102094,1,999,17544,6964,10580
102094,2,1,13706,6000,7706
102094,4,3,3838,964,2874
102234,1,999,1849,702,1147
102234,2,1,1548,603,945
102234,4,3,301,99,202
102261,1,999,212,112,100
102261,2,1,212,112,100
102270,1,999,1145,513,632
102270,2,1,1145,513,632
102298,1,999,799,350,449
102298,2,1,799,350,449
102313,1,999,2642,1293,1349
102313,2,1,2642,1293,1349
102368,1,999,36806,13936,22870
102368,2,1,28121,11005,17116
102368,4,3,8685,2931,5754
102377,1,999,2985,1254,1731
102377,2,1,2511,1102,1409
102377,4,3,474,152,322
102395,1,999,1165,801,364
102395,2,1,243,202,41
102395,4,3,922,599,323
102429,1,999,6508,2378,4130
102429,2,1,6508,2378,4130
102553,1,999,28019,11199,16820
102553,2,1,26399,10640,15759
102553,4,3,1620,559,1061
102580,1,999,80,43,37
102580,2,1,80,43,37
102614,1,999,15579,6355,9224
102614,2,1,14118,5723,8395
102614,4,3,1461,632,829
102632,1,999,6842,2354,4488
102632,2,1,6214,2185,4029
102632,4,3,628,169,459
102669,1,999,918,306,612
102669,2,1,653,215,438
102669,4,3,265,91,174
102711,1,999,1182,840,342
102711,2,1,1182,840,342
102845,1,999,3347,888,2459
102845,2,1,3347,888,2459
103361,1,999,2604,1496,1108
103361,2,1,2604,1496,1108
103501,1,999,482,84,398
103501,2,1,482,84,398
103644,1,999,8280,2248,6032
103644,2,1,8280,2248,6032
103723,1,999,1695,1254,441
103723,2,1,1695,1254,441
103732,1,999,157,14,143
103732,2,1,157,14,143
103741,1,999,295,24,271
103741,2,1,295,24,271
103778,1,999,1414,974,440
103778,2,1,2,0,2
103778,4,3,1412,974,438
103787,1,999,114,52,62
103787,2,1,114,52,62
103811,1,999,1673,1500,173
103811,2,1,1673,1500,173
103893,1,999,1611,295,1316
103893,2,1,1611,295,1316
103909,1,999,1671,363,1308
103909,2,1,1671,363,1308
103927,1,999,1264,295,969
103927,2,1,1264,295,969
103945,1,999,333,61,272
103945,2,1,333,61,272
103954,1,999,117,8,109
103954,2,1,117,8,109
103963,1,999,2769,2597,172
103963,2,1,2769,2597,172
104090,1,999,3032,497,2535
104090,2,1,3032,497,2535
104151,1,999,79274,38858,40416
104151,2,1,63101,31100,32001
104151,4,3,16173,7758,8415
104160,1,999,13344,5760,7584
104160,2,1,13344,5760,7584
104179,1,999,42779,20501,22278
104179,2,1,33005,15866,17139
104179,4,3,9774,4635,5139
104188,1,999,330,143,187
104188,2,1,330,143,187
104294,1,999,373,40,333
104294,2,1,373,40,333
104346,1,999,14646,6323,8323
104346,2,1,14646,6323,8323
104364,1,999,1383,618,765
104364,2,1,1383,618,765
104391,1,999,122,17,105
104391,2,1,122,17,105
104425,1,999,16192,10499,5693
104425,2,1,16192,10499,5693
104434,1,999,76,3,73
104434,2,1,76,3,73
104443,1,999,291,26,265
104443,2,1,291,26,265
104504,1,999,318,83,235
104504,2,1,318,83,235
104531,1,999,2754,1920,834
104531,2,1,2754,1920,834
104568,1,999,374,26,348
104568,2,1,374,26,348
104577,1,999,10426,5038,5388
104577,2,1,10426,5038,5388
104586,1,999,1846,1509,337
104586,2,1,1791,1470,321
104586,4,3,55,39,16
104665,1,999,32,22,10
104665,2,1,10,7,3
104665,4,3,22,15,7
104708,1,999,32962,15393,17569
104708,2,1,32962,15393,17569
104717,1,999,65509,15494,50015
104717,2,1,38583,9126,29457
104717,4,3,26926,6368,20558
104805,1,999,3411,874,2537
104805,2,1,3411,874,2537
104911,1,999,449,29,420
104911,2,1,449,29,420
104984,1,999,487,93,394
104984,2,1,487,93,394
105118,1,999,836,202,634
105118,2,1,836,202,634
105127,1,999,212,17,195
105127,2,1,212,17,195
105145,1,999,13266,6047,7219
105145,2,1,13266,6047,7219
105154,1,999,41836,19739,22097
105154,2,1,41836,19739,22097
105163,1,999,918,731,187
105163,2,1,918,731,187
105172,1,999,1361,1018,343
105172,2,1,1361,1018,343
105206,1,999,9558,3586,5972
105206,2,1,9558,3586,5972
105215,1,999,4455,4282,173
105215,2,1,4455,4282,173
105297,1,999,3121,1097,2024
105297,2,1,3121,1097,2024
105330,1,999,28561,11135,17426
105330,2,1,22253,9269,12984
105330,4,3,6308,1866,4442
105349,1,999,8054,3070,4984
105349,2,1,8054,3070,4984
105367,1,999,2653,657,1996
105367,2,1,973,292,681
105367,4,3,1680,365,1315
105428,1,999,21392,8486,12906
105428,2,1,21392,8486,12906
105482,1,999,205,56,149
105482,2,1,205,56,149
105516,1,999,8276,3616,4660
105516,2,1,5861,2607,3254
105516,4,3,2415,1009,1406
105525,1,999,56916,25779,31137
105525,2,1,56916,25779,31137
105534,1,999,2847,639,2208
105534,2,1,2847,639,2208
105543,1,999,1856,349,1507
105543,2,1,1856,349,1507
105589,1,999,1526,564,962
105589,2,1,1037,418,619
105589,4,3,489,146,343
105659,1,999,1077,1067,10
105659,2,1,1077,1067,10
105668,1,999,57746,21797,35949
105668,2,1,57746,21797,35949
105677,1,999,70,69,1
105677,2,1,70,69,1
105701,1,999,116,8,108
105701,2,1,116,8,108
105747,1,999,17702,8367,9335
105747,2,1,17702,8367,9335
105792,1,999,10186,4110,6076
105792,2,1,10186,4110,6076
105899,1,999,514,288,226
105899,2,1,514,288,226
105987,1,999,940,350,590
105987,2,1,940,350,590
106041,1,999,4352,4254,98
106041,2,1,4352,4254,98
106102,1,999,4961,1977,2984
106102,2,1,3798,1393,2405
106102,4,3,1163,584,579
106111,1,999,385,36,349
106111,2,1,385,36,349
106148,1,999,12973,5513,7460
106148,2,1,12973,5513,7460
106245,1,999,16723,6427,10296
106245,2,1,12137,4775,7362
106245,4,3,4586,1652,2934
106263,1,999,3209,1021,2188
106263,2,1,1191,249,942
106263,4,3,2018,772,1246
106281,1,999,93,36,57
106281,2,1,93,36,57
106306,1,999,1398,861,537
106306,2,1,1398,861,537
106315,1,999,73,5,68
106315,2,1,73,5,68
106324,1,999,74,4,70
106324,2,1,74,4,70
106342,1,999,690,304,386
106342,2,1,690,304,386
106351,1,999,160,92,68
106351,2,1,160,92,68
106360,1,999,67,4,63
106360,2,1,67,4,63
106397,1,999,24559,12598,11961
106397,2,1,19405,9986,9419
106397,4,3,5154,2612,2542
106412,1,999,3811,1644,2167
106412,2,1,3624,1571,2053
106412,4,3,187,73,114
106449,1,999,6973,2824,4149
106449,2,1,6973,2824,4149
106458,1,999,17591,6545,11046
106458,2,1,11913,4946,6967
106458,4,3,5678,1599,4079
106467,1,999,11783,5318,6465
106467,2,1,10738,4992,5746
106467,4,3,1045,326,719
106485,1,999,4606,1820,2786
106485,2,1,4392,1749,2643
106485,4,3,214,71,143
106494,1,999,100,8,92
106494,2,1,100,8,92
106546,1,999,1090,162,928
106546,2,1,1090,162,928
106607,1,999,84,4,80
106607,2,1,84,4,80
106625,1,999,3750,1536,2214
106625,2,1,3750,1536,2214
106704,1,999,13293,5371,7922
106704,2,1,11208,4893,6315
106704,4,3,2085,478,1607
106713,1,999,972,533,439
106713,2,1,972,533,439
106795,1,999,2292,723,1569
106795,2,1,2292,723,1569
106810,1,999,222,118,104
106810,2,1,222,118,104
106829,1,999,399,215,184
106829,2,1,399,215,184
106883,1,999,2284,747,1537
106883,2,1,2284,747,1537
106892,1,999,421,36,385
106892,2,1,421,36,385
106908,1,999,640,42,598
106908,2,1,640,42,598
106980,1,999,5135,1937,3198
106980,2,1,5135,1937,3198
106999,1,999,2239,687,1552
106999,2,1,2239,687,1552
107044,1,999,7740,3042,4698
107044,2,1,4653,2159,2494
107044,4,3,3087,883,2204
107071,1,999,4432,1898,2534
107071,2,1,3753,1730,2023
107071,4,3,679,168,511
107080,1,999,1501,643,858
107080,2,1,1488,634,854
107080,4,3,13,9,4
107099,1,999,99,4,95
107099,2,1,99,4,95
107123,1,999,57,16,41
107123,2,1,57,16,41
107141,1,999,2390,1045,1345
107141,2,1,1856,825,1031
107141,4,3,534,220,314
107211,1,999,39,3,36
107211,2,1,39,3,36
107220,1,999,539,30,509
107220,2,1,539,30,509
107275,1,999,23,0,23
107275,2,1,23,0,23
107293,1,999,106,3,103
107293,2,1,106,3,103
107318,1,999,3544,1232,2312
107318,2,1,3544,1232,2312
107327,1,999,3040,1078,1962
107327,2,1,3040,1078,1962
107363,1,999,92,10,82
107363,2,1,92,10,82
107442,1,999,113,72,41
107442,2,1,113,72,41
107460,1,999,3220,1313,1907
107460,2,1,3220,1313,1907
107488,1,999,367,210,157
107488,2,1,367,210,157
107512,1,999,1581,735,846
107512,2,1,1581,735,846
107521,1,999,1992,779,1213
107521,2,1,1992,779,1213
107549,1,999,2165,653,1512
107549,2,1,2165,653,1512
107558,1,999,656,298,358
107558,2,1,656,298,358
107585,1,999,3287,1265,2022
107585,2,1,3287,1265,2022
107600,1,999,743,253,490
107600,2,1,743,253,490
107619,1,999,2895,1002,1893
107619,2,1,2895,1002,1893
107637,1,999,3101,1074,2027
107637,2,1,3101,1074,2027
107655,1,999,104,5,99
107655,2,1,104,5,99
107664,1,999,15861,5494,10367
107664,2,1,15861,5494,10367
107725,1,999,2172,766,1406
107725,2,1,2172,766,1406
107743,1,999,1369,466,903
107743,2,1,1369,466,903
107789,1,999,171,13,158
107789,2,1,171,13,158
107831,1,999,116,3,113
107831,2,1,116,3,113
107877,1,999,714,293,421
107877,2,1,714,293,421
107974,1,999,2503,663,1840
107974,2,1,2503,663,1840
107983,1,999,4008,1605,2403
107983,2,1,3343,1437,1906
107983,4,3,665,168,497
107992,1,999,3849,1927,1922
107992,2,1,3849,1927,1922
108065,1,999,21,2,19
108065,2,1,21,2,19
108092,1,999,9389,4026,5363
108092,2,1,9389,4026,5363
108199,1,999,16401,7625,8776
108199,2,1,16401,7625,8776
108232,1,999,22236,9390,12846
108232,2,1,15415,6654,8761
108232,4,3,6821,2736,4085
108250,1,999,1264,1020,244
108250,2,1,1264,1020,244
108269,1,999,133,53,80
108269,4,3,133,53,80
108348,1,999,96,49,47
108348,2,1,96,49,47
108649,1,999,173,6,167
108649,2,1,173,6,167
108667,1,999,11642,5230,6412
108667,2,1,11642,5230,6412
108807,1,999,19552,10177,9375
108807,2,1,19552,10177,9375
108852,1,999,220,98,122
108852,2,1,220,98,122
108861,1,999,86,57,29
108861,4,3,86,57,29
108870,1,999,356,239,117
108870,4,3,356,239,117
108977,1,999,60,4,56
108977,2,1,60,4,56
109040,1,999,3675,856,2819
109040,2,1,3675,856,2819
109086,1,999,80,43,37
109086,2,1,51,27,24
109086,4,3,29,16,13
109208,1,999,54155,26303,27852
109208,2,1,54155,26303,27852
109332,1,999,684,60,624
109332,2,1,684,60,624
109350,1,999,19052,7898,11154
109350,2,1,19052,7898,11154
109651,1,999,2256,1281,975
109651,2,1,2056,1157,899
109651,4,3,200,124,76
109721,1,999,957,559,398
109721,2,1,957,559,398
109730,1,999,231,189,42
109730,2,1,231,189,42
109785,1,999,11474,3956,7518
109785,2,1,6254,2254,4000
109785,4,3,5220,1702,3518
109819,1,999,27426,12483,14943
109819,2,1,27426,12483,14943
109891,1,999,30,0,30
109891,2,1,30,0,30
109907,1,999,5193,2143,3050
109907,2,1,5193,2143,3050
109934,1,999,326,20,306
109934,2,1,326,20,306
110060,1,999,378,204,174
110060,2,1,237,127,110
110060,4,3,141,77,64
110097,1,999,6758,3271,3487
110097,2,1,4504,1806,2698
110097,4,3,2254,1465,789
110185,1,999,1215,670,545
110185,2,1,1158,637,521
110185,4,3,57,33,24
110194,1,999,354,353,1
110194,2,1,354,353,1
110219,1,999,1535,276,1259
110219,2,1,1535,276,1259
110246,1,999,17877,8567,9310
110246,2,1,17877,8567,9310
110307,1,999,316,48,268
110307,4,3,316,48,268
110316,1,999,1603,458,1145
110316,2,1,134,45,89
110316,4,3,1469,413,1056
110334,1,999,20424,9631,10793
110334,2,1,20424,9631,10793
110361,1,999,5822,1972,3850
110361,2,1,4443,1628,2815
110361,4,3,1379,344,1035
110370,1,999,2061,815,1246
110370,2,1,1587,630,957
110370,4,3,474,185,289
110398,1,999,1321,609,712
110398,4,3,1321,609,712
110404,1,999,2274,1521,753
110404,2,1,1008,617,391
110404,4,3,1266,904,362
110413,1,999,4812,1996,2816
110413,2,1,2917,1221,1696
110413,4,3,1895,775,1120
110422,1,999,19077,10557,8520
110422,2,1,17736,9797,7939
110422,4,3,1341,760,581
110468,1,999,4517,1289,3228
110468,2,1,347,135,212
110468,4,3,4170,1154,3016
110486,1,999,9456,3467,5989
110486,2,1,7812,2996,4816
110486,4,3,1644,471,1173
110495,1,999,9411,3244,6167
110495,2,1,7786,2805,4981
110495,4,3,1625,439,1186
110510,1,999,19065,7058,12007
110510,2,1,15947,5960,9987
110510,4,3,3118,1098,2020
110529,1,999,22770,12732,10038
110529,2,1,20345,11617,8728
110529,4,3,2425,1115,1310
110538,1,999,16912,8047,8865
110538,2,1,15531,7580,7951
110538,4,3,1381,467,914
110547,1,999,15909,5235,10674
110547,2,1,12474,4378,8096
110547,4,3,3435,857,2578
110556,1,999,22285,9307,12978
110556,2,1,18878,8185,10693
110556,4,3,3407,1122,2285
110565,1,999,39521,16799,22722
110565,2,1,33248,14432,18816
110565,4,3,6273,2367,3906
110574,1,999,15357,6072,9285
110574,2,1,12327,4931,7396
110574,4,3,3030,1141,1889
110583,1,999,37602,15458,22144
110583,2,1,30931,12891,18040
110583,4,3,6671,2567,4104
110592,1,999,22830,9197,13633
110592,2,1,17889,7398,10491
110592,4,3,4941,1799,3142
110608,1,999,37832,16152,21680
110608,2,1,31896,14030,17866
110608,4,3,5936,2122,3814
110617,1,999,30362,12747,17615
110617,2,1,26333,11364,14969
110617,4,3,4029,1383,2646
110635,1,999,39175,19328,19847
110635,2,1,28437,13396,15041
110635,4,3,10738,5932,4806
110644,1,999,33786,15511,18275
110644,2,1,26833,12089,14744
110644,4,3,6953,3422,3531
110653,1,999,29200,14201,14999
110653,2,1,23688,11074,12614
110653,4,3,5512,3127,2385
110662,1,999,40863,19467,21396
110662,2,1,28379,12765,15614
110662,4,3,12484,6702,5782
110671,1,999,22067,10898,11169
110671,2,1,19441,9475,9966
110671,4,3,2626,1423,1203
110680,1,999,31089,15749,15340
110680,2,1,25324,12414,12910
110680,4,3,5765,3335,2430
110699,1,999,3080,1131,1949
110699,4,3,3080,1131,1949
110705,1,999,24078,11607,12471
110705,2,1,20795,9898,10897
110705,4,3,3283,1709,1574
110714,1,999,18412,8944,9468
110714,2,1,16729,8063,8666
110714,4,3,1683,881,802
110778,1,999,604,121,483
110778,4,3,604,121,483
110875,1,999,171,2,169
110875,2,1,171,2,169
110918,1,999,26,15,11
110918,2,1,26,15,11
110945,1,999,2224,858,1366
110945,2,1,2224,858,1366
111009,1,999,1271,724,547
111009,2,1,1271,724,547
111054,1,999,380,19,361
111054,2,1,380,19,361
111081,1,999,1491,728,763
111081,2,1,919,472,447
111081,4,3,572,256,316
111188,1,999,870,755,115
111188,2,1,870,755,115
111391,1,999,1026,474,552
111391,4,3,1026,474,552
111434,1,999,10762,3815,6947
111434,2,1,10762,3815,6947
111461,1,999,33263,20746,12517
111461,2,1,33263,20746,12517
111513,1,999,326,15,311
111513,2,1,326,15,311
111638,1,999,1006,231,775
111638,2,1,1006,231,775
111708,1,999,472,375,97
111708,2,1,472,375,97
111717,1,999,1129,641,488
111717,2,1,1129,641,488
111726,1,999,502,378,124
111726,2,1,502,378,124
111744,1,999,381,344,37
111744,2,1,381,344,37
111762,1,999,256,153,103
111762,2,1,256,153,103
111771,1,999,351,253,98
111771,2,1,351,253,98
111799,1,999,176,81,95
111799,2,1,176,81,95
111887,1,999,28810,12831,15979
111887,2,1,28810,12831,15979
111896,1,999,11427,4408,7019
111896,2,1,11427,4408,7019
111920,1,999,21214,9731,11483
111920,2,1,21214,9731,11483
111939,1,999,25455,10637,14818
111939,2,1,25455,10637,14818
111948,1,999,7706,3246,4460
111948,2,1,5440,2268,3172
111948,4,3,2266,978,1288
111966,1,999,337,107,230
111966,2,1,164,63,101
111966,4,3,173,44,129
112075,1,999,3916,1703,2213
112075,2,1,1717,678,1039
112075,4,3,2199,1025,1174
112084,1,999,602,302,300
112084,2,1,578,297,281
112084,4,3,24,5,19
112127,1,999,93,52,41
112127,4,3,93,52,41
112172,1,999,17293,7853,9440
112172,2,1,17293,7853,9440
112190,1,999,46543,21891,24652
112190,2,1,46543,21891,24652
112251,1,999,2503,1175,1328
112251,4,3,2503,1175,1328
112260,1,999,1289,696,593
112260,2,1,1272,682,590
112260,4,3,17,14,3
112288,1,999,592,66,526
112288,2,1,592,66,526
112312,1,999,343,212,131
112312,2,1,83,51,32
112312,4,3,260,161,99
112367,1,999,1918,568,1350
112367,2,1,1918,568,1350
112385,1,999,18477,8447,10030
112385,2,1,18477,8447,10030
112394,1,999,293,237,56
112394,2,1,293,237,56
112446,1,999,1097,944,153
112446,2,1,942,829,113
112446,4,3,155,115,40
112455,1,999,163,18,145
112455,2,1,163,18,145
112525,1,999,3037,1085,1952
112525,4,3,3037,1085,1952
112561,1,999,5224,2462,2762
112561,2,1,5224,2462,2762
112570,1,999,412,291,121
112570,2,1,412,291,121
112686,1,999,16127,6042,10085
112686,2,1,16127,6042,10085
112783,1,999,740,212,528
112783,2,1,740,212,528
112826,1,999,12468,4860,7608
112826,2,1,12468,4860,7608
113096,1,999,22825,9861,12964
113096,2,1,22825,9861,12964
113111,1,999,8379,4048,4331
113111,2,1,8379,4048,4331
113193,1,999,15033,7289,7744
113193,2,1,15033,7289,7744
113218,1,999,14897,6641,8256
113218,2,1,14897,6641,8256
113227,1,999,314,11,303
113227,2,1,314,11,303
113236,1,999,21655,9479,12176
113236,2,1,21655,9479,12176
113333,1,999,38281,19030,19251
113333,2,1,38281,19030,19251
113397,1,999,1031,54,977
113397,2,1,1031,54,977
113449,1,999,466,114,352
113449,2,1,466,114,352
113537,1,999,46,18,28
113537,2,1,33,14,19
113537,4,3,13,4,9
113573,1,999,12549,5682,6867
113573,2,1,12549,5682,6867
113582,1,999,339,32,307
113582,2,1,339,32,307
113607,1,999,15081,9657,5424
113607,2,1,15081,9657,5424
113634,1,999,32207,15182,17025
113634,2,1,32207,15182,17025
113698,1,999,2495,689,1806
113698,2,1,1702,456,1246
113698,4,3,793,233,560
113704,1,999,95,74,21
113704,4,3,95,74,21
113856,1,999,54962,27164,27798
113856,2,1,54962,27164,27798
113908,1,999,1363,68,1295
113908,2,1,1363,68,1295
113953,1,999,8711,3180,5531
113953,2,1,8711,3180,5531
113980,1,999,35392,16938,18454
113980,2,1,35392,16938,18454
114044,1,999,126,8,118
114044,2,1,126,8,118
114062,1,999,276,8,268
114062,2,1,276,8,268
114071,1,999,875,44,831
114071,2,1,875,44,831
114080,1,999,754,39,715
114080,2,1,754,39,715
114114,1,999,226,48,178
114114,4,3,226,48,178
114123,1,999,937,221,716
114123,2,1,937,221,716
114266,1,999,15419,7372,8047
114266,2,1,15419,7372,8047
114354,1,999,5793,690,5103
114354,2,1,5793,690,5103
114372,1,999,169,23,146
114372,2,1,169,23,146
114390,1,999,1228,112,1116
114390,2,1,1228,112,1116
114415,1,999,497,60,437
114415,2,1,497,60,437
114433,1,999,3041,1264,1777
114433,2,1,3041,1264,1777
114460,1,999,400,10,390
114460,2,1,400,10,390
114549,1,999,1943,534,1409
114549,4,3,1943,534,1409
114585,1,999,471,149,322
114585,4,3,471,149,322
114628,1,999,189,26,163
114628,2,1,189,26,163
114716,1,999,30120,14086,16034
114716,2,1,30120,14086,16034
114734,1,999,69,30,39
114734,4,3,69,30,39
114761,1,999,126,5,121
114761,2,1,126,5,121
114789,1,999,32524,15597,16927
114789,2,1,32524,15597,16927
114813,1,999,5027,1897,3130
114813,2,1,3617,1496,2121
114813,4,3,1410,401,1009
114840,1,999,4414,2922,1492
114840,4,3,4414,2922,1492
114859,1,999,31415,15099,16316
114859,2,1,31415,15099,16316
114895,1,999,195,24,171
114895,2,1,195,24,171
114938,1,999,12835,7267,5568
114938,2,1,12835,7267,5568
114947,1,999,7379,2527,4852
114947,2,1,7379,2527,4852
115001,1,999,22282,9924,12358
115001,2,1,22282,9924,12358
115010,1,999,499,155,344
115010,2,1,499,155,344
115083,1,999,5002,2227,2775
115083,2,1,616,288,328
115083,4,3,4386,1939,2447
115126,1,999,19785,9158,10627
115126,2,1,19785,9158,10627
115214,1,999,282,150,132
115214,4,3,282,150,132
115296,1,999,28040,12242,15798
115296,2,1,28040,12242,15798
115357,1,999,82,5,77
115357,2,1,82,5,77
115393,1,999,14412,7598,6814
115393,2,1,14412,7598,6814
115409,1,999,823,488,335
115409,2,1,823,488,335
115454,1,999,2347,750,1597
115454,2,1,2347,750,1597
115472,1,999,3366,1090,2276
115472,2,1,3366,1090,2276
115490,1,999,2689,914,1775
115490,2,1,2689,914,1775
115515,1,999,2477,863,1614
115515,2,1,2477,863,1614
115533,1,999,2477,863,1614
115533,2,1,2477,863,1614
115658,1,999,264,22,242
115658,2,1,264,22,242
115728,1,999,1448,356,1092
115728,2,1,870,213,657
115728,4,3,578,143,435
115746,1,999,911,243,668
115746,4,3,911,243,668
115755,1,999,8446,3883,4563
115755,2,1,7750,3606,4144
115755,4,3,696,277,419
115773,1,999,1638,355,1283
115773,2,1,1360,264,1096
115773,4,3,278,91,187
115861,1,999,11579,5143,6436
115861,2,1,11579,5143,6436
115931,1,999,895,532,363
115931,2,1,895,532,363
116040,1,999,1636,230,1406
116040,2,1,1636,230,1406
116226,1,999,530,39,491
116226,2,1,521,38,483
116226,4,3,9,1,8
116350,1,999,371,58,313
116350,2,1,371,58,313
116439,1,999,23330,10773,12557
116439,2,1,23330,10773,12557
116466,1,999,2770,2274,496
116466,2,1,2770,2274,496
116475,1,999,1220,981,239
116475,2,1,1220,981,239
116484,1,999,1716,1321,395
116484,2,1,1716,1321,395
116563,1,999,154,1,153
116563,2,1,154,1,153
116712,1,999,1799,466,1333
116712,2,1,358,87,271
116712,4,3,1441,379,1062
116846,1,999,251,126,125
116846,2,1,135,62,73
116846,4,3,116,64,52
117052,1,999,20871,8800,12071
117052,2,1,20871,8800,12071
117104,1,999,648,350,298
117104,2,1,648,350,298
117113,1,999,2824,1463,1361
117113,2,1,2824,1463,1361
117140,1,999,10304,4068,6236
117140,2,1,5528,2260,3268
117140,4,3,4776,1808,2968
117168,1,999,527,195,332
117168,2,1,483,183,300
117168,4,3,44,12,32
117195,1,999,5785,2463,3322
117195,2,1,5785,2463,3322
117238,1,999,195,32,163
117238,2,1,195,32,163
117247,1,999,20881,9217,11664
117247,2,1,20881,9217,11664
117274,1,999,6071,4747,1324
117274,2,1,6071,4747,1324
117520,1,999,410,233,177
117520,4,3,410,233,177
117557,1,999,524,283,241
117557,2,1,146,59,87
117557,4,3,378,224,154
117575,1,999,271,177,94
117575,2,1,105,72,33
117575,4,3,166,105,61
117627,1,999,2824,1239,1585
117627,2,1,2051,905,1146
117627,4,3,773,334,439
117636,1,999,5130,1945,3185
117636,2,1,1403,391,1012
117636,4,3,3727,1554,2173
117645,1,999,35722,17332,18390
117645,2,1,35722,17332,18390
117672,1,999,1190,552,638
117672,2,1,641,241,400
117672,4,3,549,311,238
117690,1,999,15515,6366,9149
117690,2,1,15515,6366,9149
117706,1,999,30280,13770,16510
117706,2,1,30280,13770,16510
117715,1,999,11299,3316,7983
117715,2,1,11299,3316,7983
117724,1,999,23287,12081,11206
117724,2,1,23287,12081,11206
117733,1,999,29543,12371,17172
117733,2,1,29543,12371,17172
117751,1,999,1780,1094,686
117751,2,1,1184,627,557
117751,4,3,596,467,129
117788,1,999,31261,13398,17863
117788,2,1,31261,13398,17863
117803,1,999,354,92,262
117803,2,1,354,92,262
117867,1,999,16115,6296,9819
117867,2,1,16115,6296,9819
117894,1,999,14574,6584,7990
117894,2,1,14574,6584,7990
117928,1,999,2161,1138,1023
117928,2,1,2145,1128,1017
117928,4,3,16,10,6
117946,1,999,9752,4092,5660
117946,2,1,6232,2644,3588
117946,4,3,3520,1448,2072
117955,1,999,331,9,322
117955,2,1,331,9,322
118116,1,999,187,17,170
118116,2,1,187,17,170
118125,1,999,110,2,108
118125,2,1,110,2,108
118134,1,999,166,4,162
118134,2,1,166,4,162
118143,1,999,122,12,110
118143,2,1,122,12,110
118161,1,999,191,7,184
118161,2,1,191,7,184
118189,1,999,207,31,176
118189,2,1,207,31,176
118198,1,999,929,241,688
118198,2,1,929,241,688
118259,1,999,963,174,789
118259,2,1,963,174,789
118277,1,999,2110,500,1610
118277,2,1,2110,500,1610
118286,1,999,1828,402,1426
118286,2,1,1828,402,1426
118347,1,999,11139,4641,6498
118347,2,1,11139,4641,6498
118356,1,999,4439,242,4197
118356,2,1,4439,242,4197
118541,1,999,885,431,454
118541,2,1,885,431,454
118684,1,999,7015,2783,4232
118684,2,1,7015,2783,4232
118693,1,999,684,431,253
118693,2,1,684,431,253
118718,1,999,15155,6560,8595
118718,2,1,15155,6560,8595
118772,1,999,10895,3782,7113
118772,2,1,10895,3782,7113
118888,1,999,1676,122,1554
118888,2,1,1021,0,1021
118888,4,3,655,122,533
118912,1,999,22363,9577,12786
118912,2,1,22363,9577,12786
118921,1,999,756,78,678
118921,2,1,756,78,678
118930,1,999,16522,7241,9281
118930,2,1,16522,7241,9281
118958,1,999,90,19,71
118958,2,1,90,19,71
118967,1,999,1741,852,889
118967,2,1,1741,852,889
118976,1,999,24009,10440,13569
118976,2,1,24009,10440,13569
118994,1,999,46,44,2
118994,2,1,46,44,2
119058,1,999,894,355,539
119058,2,1,13,5,8
119058,4,3,881,350,531
119067,1,999,18209,9477,8732
119067,2,1,18209,9477,8732
119137,1,999,22840,10478,12362
119137,2,1,22840,10478,12362
119164,1,999,37922,18710,19212
119164,2,1,37922,18710,19212
119173,1,999,3175,353,2822
119173,2,1,2492,206,2286
119173,4,3,683,147,536
119216,1,999,24497,10393,14104
119216,2,1,24497,10393,14104
119234,1,999,418,118,300
119234,2,1,418,118,300
119270,1,999,2395,1944,451
119270,2,1,2395,1944,451
119331,1,999,8975,3960,5015
119331,2,1,8975,3960,5015
119340,1,999,839,95,744
119340,2,1,839,95,744
119359,1,999,1484,332,1152
119359,2,1,1484,332,1152
119368,1,999,672,52,620
119368,2,1,672,52,620
119438,1,999,871,108,763
119438,2,1,871,108,763
119456,1,999,1404,160,1244
119456,2,1,1404,160,1244
119465,1,999,1129,285,844
119465,2,1,1129,285,844
119508,1,999,1540,472,1068
119508,2,1,1540,472,1068
119544,1,999,798,272,526
119544,2,1,546,179,367
119544,4,3,252,93,159
119553,1,999,837,267,570
119553,2,1,837,267,570
119605,1,999,27820,10335,17485
119605,2,1,11886,4869,7017
119605,4,3,15934,5466,10468
119678,1,999,4382,3750,632
119678,4,3,4382,3750,632
119775,1,999,711,482,229
119775,2,1,439,321,118
119775,4,3,272,161,111
119845,1,999,316,12,304
119845,2,1,316,12,304
119951,1,999,589,27,562
119951,2,1,589,27,562
120069,1,999,379,51,328
120069,2,1,379,51,328
120078,1,999,641,155,486
120078,2,1,641,155,486
120087,1,999,252,51,201
120087,2,1,252,51,201
120166,1,999,1395,861,534
120166,2,1,302,192,110
120166,4,3,1093,669,424
120184,1,999,2203,662,1541
120184,2,1,1186,409,777
120184,4,3,1017,253,764
120254,1,999,2174,944,1230
120254,2,1,2154,939,1215
120254,4,3,20,5,15
120272,1,999,177,16,161
120272,2,1,177,16,161
120290,1,999,17973,9301,8672
120290,2,1,17973,9301,8672
120342,1,999,30841,15861,14980
120342,2,1,30841,15861,14980
120403,1,999,1298,409,889
120403,2,1,1197,378,819
120403,4,3,101,31,70
120421,1,999,10993,4962,6031
120421,2,1,10993,4962,6031
120537,1,999,1587,713,874
120537,2,1,1023,443,580
120537,4,3,564,270,294
120661,1,999,797,206,591
120661,2,1,797,206,591
120698,1,999,714,176,538
120698,2,1,114,43,71
120698,4,3,600,133,467
120740,1,999,144,72,72
120740,4,3,144,72,72
120768,1,999,665,39,626
120768,2,1,180,9,171
120768,4,3,485,30,455
120795,1,999,213,97,116
120795,4,3,213,97,116
120838,1,999,332,181,151
120838,2,1,25,16,9
120838,4,3,307,165,142
120865,1,999,1962,850,1112
120865,2,1,1951,848,1103
120865,4,3,11,2,9
120883,1,999,7310,3214,4096
120883,2,1,4020,1817,2203
120883,4,3,3290,1397,1893
120953,1,999,5745,4377,1368
120953,2,1,5745,4377,1368
120971,1,999,39116,20254,18862
120971,2,1,39116,20254,18862
121008,1,999,347,23,324
121008,2,1,347,23,324
121017,1,999,177,7,170
121017,2,1,177,7,170
121044,1,999,35756,17076,18680
121044,2,1,35756,17076,18680
121071,1,999,1164,568,596
121071,2,1,1096,555,541
121071,4,3,68,13,55
121150,1,999,8201,3546,4655
121150,2,1,3617,1665,1952
121150,4,3,4584,1881,2703
121257,1,999,1110,443,667
121257,2,1,1110,443,667
121275,1,999,380,284,96
121275,2,1,380,284,96
121309,1,999,4330,1497,2833
121309,2,1,2510,975,1535
121309,4,3,1820,522,1298
121345,1,999,1579,784,795
121345,2,1,1579,784,795
121363,1,999,6017,2249,3768
121363,2,1,6017,2249,3768
121381,1,999,1194,544,650
121381,2,1,1194,544,650
121433,1,999,250,15,235
121433,2,1,250,15,235
121619,1,999,48363,31203,17160
121619,2,1,48363,31203,17160
121628,1,999,122,72,50
121628,4,3,122,72,50
121637,1,999,100,2,98
121637,2,1,100,2,98
121691,1,999,5964,2710,3254
121691,2,1,3704,1684,2020
121691,4,3,2260,1026,1234
121707,1,999,9467,4305,5162
121707,2,1,9467,4305,5162
121859,1,999,258,12,246
121859,2,1,258,12,246
121868,1,999,151,7,144
121868,2,1,151,7,144
121877,1,999,351,3,348
121877,2,1,351,3,348
121886,1,999,30143,17447,12696
121886,2,1,30143,17447,12696
121901,1,999,30470,13138,17332
121901,2,1,30470,13138,17332
121983,1,999,1255,328,927
121983,2,1,218,61,157
121983,4,3,1037,267,770
121992,1,999,295,119,176
121992,2,1,295,119,176
122117,1,999,360,161,199
122117,2,1,101,46,55
122117,4,3,259,115,144
122180,1,999,37957,16183,21774
122180,2,1,37957,16183,21774
122205,1,999,37586,15960,21626
122205,2,1,37586,15960,21626
122296,1,999,1845,392,1453
122296,2,1,933,147,786
122296,4,3,912,245,667
122339,1,999,29873,13778,16095
122339,2,1,29873,13778,16095
122366,1,999,541,527,14
122366,2,1,541,527,14
122375,1,999,40844,19262,21582
122375,2,1,40844,19262,21582
122384,1,999,23179,12678,10501
122384,2,1,23179,12678,10501
122409,1,999,34999,15215,19784
122409,2,1,29115,12868,16247
122409,4,3,5884,2347,3537
122436,1,999,9106,3949,5157
122436,2,1,5740,2588,3152
122436,4,3,3366,1361,2005
122454,1,999,735,289,446
122454,2,1,469,202,267
122454,4,3,266,87,179
122506,1,999,407,191,216
122506,2,1,195,102,93
122506,4,3,212,89,123
122597,1,999,32633,13595,19038
122597,2,1,27564,11774,15790
122597,4,3,5069,1821,3248
122603,1,999,385,188,197
122603,4,3,385,188,197
122612,1,999,11313,4285,7028
122612,2,1,6707,2553,4154
122612,4,3,4606,1732,2874
122649,1,999,213,118,95
122649,4,3,213,118,95
122658,1,999,25367,10823,14544
122658,2,1,25367,10823,14544
122685,1,999,2538,714,1824
122685,2,1,2538,714,1824
122694,1,999,1692,626,1066
122694,2,1,1692,626,1066
122728,1,999,964,379,585
122728,2,1,900,364,536
122728,4,3,64,15,49
122746,1,999,16994,7475,9519
122746,2,1,16994,7475,9519
122755,1,999,31575,14836,16739
122755,2,1,25151,12283,12868
122755,4,3,6424,2553,3871
122791,1,999,16105,7699,8406
122791,2,1,16105,7699,8406
122834,1,999,1561,462,1099
122834,2,1,1561,462,1099
122843,1,999,8525,4473,4052
122843,2,1,8264,4353,3911
122843,4,3,261,120,141
122852,1,999,536,82,454
122852,2,1,536,82,454
122889,1,999,27236,12518,14718
122889,2,1,27236,12518,14718
122931,1,999,10184,5307,4877
122931,2,1,5566,2699,2867
122931,4,3,4618,2608,2010
122977,1,999,46490,20906,25584
122977,2,1,46490,20906,25584
123013,1,999,36845,16827,20018
123013,2,1,36845,16827,20018
123095,1,999,776,209,567
123095,4,3,776,209,567
123165,1,999,1052,27,1025
123165,2,1,1028,16,1012
123165,4,3,24,11,13
123208,1,999,3115,2934,181
123208,2,1,3115,2934,181
123217,1,999,18665,8538,10127
123217,2,1,18665,8538,10127
123280,1,999,77,39,38
123280,2,1,55,31,24
123280,4,3,22,8,14
123299,1,999,13656,5732,7924
123299,2,1,13656,5732,7924
123341,1,999,26986,12688,14298
123341,2,1,26986,12688,14298
123350,1,999,216,24,192
123350,2,1,216,24,192
123396,1,999,214,14,200
123396,2,1,214,14,200
123448,1,999,223,101,122
123448,4,3,223,101,122
123457,1,999,1495,530,965
123457,2,1,1096,387,709
123457,4,3,399,143,256
123484,1,999,4467,2026,2441
123484,2,1,4467,2026,2441
123493,1,999,1638,808,830
123493,2,1,1638,808,830
123509,1,999,16298,7510,8788
123509,2,1,16298,7510,8788
123527,1,999,19105,8309,10796
123527,2,1,19105,8309,10796
123554,1,999,4357,1609,2748
123554,2,1,2965,1139,1826
123554,4,3,1392,470,922
123563,1,999,17920,7306,10614
123563,2,1,17920,7306,10614
123572,1,999,9013,3393,5620
123572,2,1,7817,3076,4741
123572,4,3,1196,317,879
123581,1,999,261,251,10
123581,2,1,261,251,10
123633,1,999,971,485,486
123633,2,1,464,206,258
123633,4,3,507,279,228
123642,1,999,602,59,543
123642,2,1,602,59,543
123651,1,999,2970,994,1976
123651,2,1,2671,880,1791
123651,4,3,299,114,185
123679,1,999,855,237,618
123679,2,1,855,237,618
123800,1,999,25907,12088,13819
123800,2,1,25907,12088,13819
123855,1,999,95,82,13
123855,4,3,95,82,13
123916,1,999,78,27,51
123916,4,3,78,27,51
123943,1,999,586,181,405
123943,4,3,586,181,405
123952,1,999,506,334,172
123952,2,1,268,185,83
123952,4,3,238,149,89
123961,1,999,40515,20271,20244
123961,2,1,18876,9360,9516
123961,4,3,21639,10911,10728
123970,1,999,1476,703,773
123970,4,3,1476,703,773
124113,1,999,16256,12607,3649
124113,2,1,16256,12607,3649
124283,1,999,436,240,196
124283,4,3,436,240,196
124292,1,999,361,166,195
124292,2,1,361,166,195
124344,1,999,338,14,324
124344,2,1,338,14,324
124487,1,999,397,205,192
124487,2,1,397,205,192
124681,1,999,22275,6924,15351
124681,2,1,22275,6924,15351
124706,1,999,918,171,747
124706,2,1,918,171,747
124779,1,999,62,2,60
124779,2,1,62,2,60
124937,1,999,802,279,523
124937,2,1,802,279,523
125028,1,999,21401,9384,12017
125028,2,1,21401,9384,12017
125037,1,999,116,59,57
125037,4,3,116,59,57
125082,1,999,252,5,247
125082,2,1,252,5,247
125091,1,999,18526,8185,10341
125091,2,1,18526,8185,10341
125170,1,999,11853,5007,6846
125170,2,1,11853,5007,6846
125231,1,999,71763,16604,55159
125231,2,1,14642,3825,10817
125231,4,3,57121,12779,44342
125301,1,999,2599,1079,1520
125301,2,1,2599,1079,1520
125462,1,999,4588,2063,2525
125462,2,1,4588,2063,2525
125471,1,999,17410,6722,10688
125471,2,1,17410,6722,10688
125499,1,999,18852,8708,10144
125499,2,1,18852,8708,10144
125532,1,999,2559,432,2127
125532,2,1,2559,432,2127
125718,1,999,174,162,12
125718,4,3,174,162,12
125727,1,999,1422,520,902
125727,2,1,1404,519,885
125727,4,3,18,1,17
125763,1,999,2514,1155,1359
125763,2,1,1570,750,820
125763,4,3,944,405,539
125897,1,999,2273,1093,1180
125897,2,1,1777,862,915
125897,4,3,496,231,265
126012,1,999,432,117,315
126012,4,3,432,117,315
126030,1,999,485,254,231
126030,4,3,485,254,231
126049,1,999,1231,717,514
126049,4,3,1231,717,514
126076,1,999,130,130,0
126076,2,1,130,130,0
126119,1,999,10718,4305,6413
126119,2,1,10718,4305,6413
126164,1,999,134,5,129
126164,2,1,134,5,129
126182,1,999,4151,1704,2447
126182,2,1,3132,1414,1718
126182,4,3,1019,290,729
126207,1,999,8071,3529,4542
126207,2,1,8071,3529,4542
126289,1,999,18336,7683,10653
126289,2,1,18336,7683,10653
126359,1,999,998,160,838
126359,2,1,998,160,838
126401,1,999,1184,268,916
126401,2,1,1184,268,916
126410,1,999,205,56,149
126410,2,1,205,56,149
126562,1,999,31972,12901,19071
126562,2,1,17042,7599,9443
126562,4,3,14930,5302,9628
126580,1,999,12729,5810,6919
126580,2,1,9050,4202,4848
126580,4,3,3679,1608,2071
126605,1,999,1251,1187,64
126605,2,1,1251,1187,64
126614,1,999,36946,19711,17235
126614,2,1,30058,15825,14233
126614,4,3,6888,3886,3002
126669,1,999,4229,1523,2706
126669,2,1,3716,1371,2345
126669,4,3,513,152,361
126678,1,999,2484,1132,1352
126678,2,1,2378,1103,1275
126678,4,3,106,29,77
126687,1,999,766,144,622
126687,2,1,766,144,622
126702,1,999,2925,1425,1500
126702,2,1,2925,1425,1500
126711,1,999,10740,4682,6058
126711,2,1,10740,4682,6058
126748,1,999,2319,1042,1277
126748,2,1,2319,1042,1277
126775,1,999,6709,4341,2368
126775,2,1,3962,2979,983
126775,4,3,2747,1362,1385
126784,1,999,254,252,2
126784,2,1,254,252,2
126818,1,999,33712,16459,17253
126818,2,1,25042,12153,12889
126818,4,3,8670,4306,4364
126827,1,999,4359,2631,1728
126827,2,1,3052,1746,1306
126827,4,3,1307,885,422
126854,1,999,176,23,153
126854,2,1,176,23,153
126863,1,999,11652,4918,6734
126863,2,1,11652,4918,6734
126872,1,999,1298,309,989
126872,2,1,1298,309,989
126915,1,999,2165,1032,1133
126915,2,1,2165,1032,1133
126924,1,999,233,11,222
126924,2,1,233,11,222
126942,1,999,19455,8358,11097
126942,2,1,19455,8358,11097
126951,1,999,1607,1506,101
126951,2,1,1607,1506,101
126979,1,999,1156,693,463
126979,4,3,1156,693,463
127024,1,999,1151,727,424
127024,2,1,1151,727,424
127060,1,999,13879,6065,7814
127060,2,1,5900,2588,3312
127060,4,3,7979,3477,4502
127158,1,999,4738,2706,2032
127158,2,1,4738,2706,2032
127185,1,999,4191,2172,2019
127185,2,1,4191,2172,2019
127200,1,999,30268,12852,17416
127200,2,1,30268,12852,17416
127219,1,999,69,2,67
127219,2,1,69,2,67
127228,1,999,351,9,342
127228,2,1,351,9,342
127273,1,999,402,176,226
127273,4,3,402,176,226
127316,1,999,375,69,306
127316,2,1,375,69,306
127389,1,999,1370,565,805
127389,2,1,1370,565,805
127556,1,999,10010,4480,5530
127556,2,1,9840,4428,5412
127556,4,3,170,52,118
127565,1,999,29924,13834,16090
127565,2,1,29852,13807,16045
127565,4,3,72,27,45
127617,1,999,2865,969,1896
127617,2,1,2865,969,1896
127653,1,999,1194,413,781
127653,2,1,504,197,307
127653,4,3,690,216,474
127680,1,999,635,239,396
127680,2,1,635,239,396
127699,1,999,653,122,531
127699,2,1,653,122,531
127714,1,999,1396,876,520
127714,2,1,1396,876,520
127732,1,999,3062,1196,1866
127732,2,1,3062,1196,1866
127741,1,999,15503,5404,10099
127741,2,1,11619,4413,7206
127741,4,3,3884,991,2893
127778,1,999,2317,982,1335
127778,2,1,2317,982,1335
127787,1,999,1342,269,1073
127787,2,1,1342,269,1073
127820,1,999,21987,9269,12718
127820,2,1,21987,9269,12718
127839,1,999,787,180,607
127839,2,1,787,180,607
127884,1,999,12224,6308,5916
127884,2,1,12224,6308,5916
127909,1,999,15229,7641,7588
127909,2,1,15229,7641,7588
127918,1,999,14706,5093,9613
127918,2,1,7123,2507,4616
127918,4,3,7583,2586,4997
127945,1,999,835,324,511
127945,2,1,835,324,511
127954,1,999,78,8,70
127954,2,1,18,1,17
127954,4,3,60,7,53
128106,1,999,13665,4099,9566
128106,2,1,7398,3177,4221
128106,4,3,6267,922,5345
128151,1,999,1596,858,738
128151,2,1,1596,858,738
128179,1,999,582,428,154
128179,2,1,582,428,154
128188,1,999,848,160,688
128188,2,1,848,160,688
128258,1,999,2910,1248,1662
128258,2,1,2910,1248,1662
128328,1,999,4629,3657,972
128328,2,1,4629,3657,972
128337,1,999,251,11,240
128337,2,1,251,11,240
128391,1,999,2588,1506,1082
128391,2,1,2479,1475,1004
128391,4,3,109,31,78
128425,1,999,24,24,0
128425,2,1,22,22,0
128425,4,3,2,2,0
128498,1,999,2514,826,1688
128498,2,1,1968,648,1320
128498,4,3,546,178,368
128540,1,999,152,9,143
128540,2,1,152,9,143
128577,1,999,2685,1175,1510
128577,2,1,2685,1175,1510
128586,1,999,82,82,0
128586,2,1,82,82,0
128674,1,999,992,221,771
128674,2,1,992,221,771
128683,1,999,1446,329,1117
128683,2,1,1446,329,1117
128726,1,999,228,34,194
128726,2,1,228,34,194
128744,1,999,6201,2426,3775
128744,2,1,3076,962,2114
128744,4,3,3125,1464,1661
128762,1,999,415,33,382
128762,2,1,415,33,382
128771,1,999,15391,7299,8092
128771,2,1,11868,6136,5732
128771,4,3,3523,1163,2360
128780,1,999,3235,1140,2095
128780,2,1,3235,1140,2095
128896,1,999,552,123,429
128896,2,1,552,123,429
128902,1,999,2087,810,1277
128902,2,1,2079,810,1269
128902,4,3,8,0,8
128957,1,999,281,67,214
128957,2,1,281,67,214
129002,1,999,792,570,222
129002,2,1,792,570,222
129020,1,999,27648,13733,13915
129020,2,1,18461,9349,9112
129020,4,3,9187,4384,4803
129154,1,999,4169,681,3488
129154,2,1,4169,681,3488
129181,1,999,1977,1897,80
129181,2,1,1977,1897,80
129215,1,999,6551,2919,3632
129215,2,1,6114,2792,3322
129215,4,3,437,127,310
129242,1,999,5802,2282,3520
129242,2,1,4279,1776,2503
129242,4,3,1523,506,1017
129349,1,999,333,31,302
129349,2,1,333,31,302
129367,1,999,6514,1950,4564
129367,2,1,6514,1950,4564
129428,1,999,514,419,95
129428,4,3,514,419,95
129482,1,999,676,106,570
129482,2,1,676,106,570
129491,1,999,219,106,113
129491,4,3,219,106,113
129525,1,999,8695,3987,4708
129525,2,1,6288,3011,3277
129525,4,3,2407,976,1431
129534,1,999,479,331,148
129534,2,1,67,31,36
129534,4,3,412,300,112
129543,1,999,9008,3359,5649
129543,2,1,9008,3359,5649
129613,1,999,489,49,440
129613,2,1,489,49,440
129640,1,999,53,11,42
129640,2,1,53,11,42
129686,1,999,93,38,55
129686,2,1,89,36,53
129686,4,3,4,2,2
129695,1,999,10524,4914,5610
129695,2,1,10524,4914,5610
129729,1,999,9837,4138,5699
129729,2,1,9837,4138,5699
129756,1,999,4424,1759,2665
129756,2,1,4424,1759,2665
129774,1,999,1093,586,507
129774,2,1,1093,586,507
129808,1,999,6832,2877,3955
129808,2,1,6832,2877,3955
129923,1,999,1406,531,875
129923,2,1,1406,531,875
129932,1,999,981,910,71
129932,2,1,981,910,71
129941,1,999,6981,3453,3528
129941,2,1,4751,2400,2351
129941,4,3,2230,1053,1177
129969,1,999,567,130,437
129969,2,1,567,130,437
130004,1,999,9288,3818,5470
130004,2,1,9288,3818,5470
130040,1,999,2506,800,1706
130040,2,1,2506,800,1706
130110,1,999,241,81,160
130110,2,1,241,81,160
130129,1,999,193,49,144
130129,2,1,193,49,144
130174,1,999,6018,3903,2115
130174,2,1,6018,3903,2115
130183,1,999,8128,3235,4893
130183,2,1,6978,2884,4094
130183,4,3,1150,351,799
130217,1,999,3191,1109,2082
130217,2,1,3191,1109,2082
130226,1,999,9116,3336,5780
130226,2,1,6413,2360,4053
130226,4,3,2703,976,1727
130253,1,999,7662,2766,4896
130253,2,1,4862,1914,2948
130253,4,3,2800,852,1948
130314,1,999,2879,251,2628
130314,2,1,1179,22,1157
130314,4,3,1700,229,1471
130396,1,999,10706,4191,6515
130396,2,1,10706,4191,6515
130448,1,999,699,98,601
130448,2,1,699,98,601
130493,1,999,14217,4996,9221
130493,2,1,9983,3918,6065
130493,4,3,4234,1078,3156
130509,1,999,636,95,541
130509,2,1,636,95,541
130581,1,999,169,42,127
130581,4,3,169,42,127
130590,1,999,2602,1283,1319
130590,2,1,2453,1209,1244
130590,4,3,149,74,75
130606,1,999,6619,2773,3846
130606,2,1,6619,2773,3846
130624,1,999,1017,720,297
130624,2,1,1017,720,297
130697,1,999,3514,1693,1821
130697,2,1,3055,1472,1583
130697,4,3,459,221,238
130776,1,999,7872,3402,4470
130776,2,1,7000,3115,3885
130776,4,3,872,287,585
130785,1,999,12,2,10
130785,4,3,12,2,10
130794,1,999,12893,6329,6564
130794,2,1,6446,3094,3352
130794,4,3,6447,3235,3212
130837,1,999,58,4,54
130837,2,1,58,4,54
130873,1,999,1501,152,1349
130873,2,1,1501,152,1349
130891,1,999,6427,2271,4156
130891,2,1,6427,2271,4156
130907,1,999,4820,1748,3072
130907,2,1,4820,1748,3072
130916,1,999,10406,4266,6140
130916,2,1,10406,4266,6140
130934,1,999,4099,1605,2494
130934,2,1,3619,1413,2206
130934,4,3,480,192,288
130943,1,999,23239,10247,12992
130943,2,1,19071,8230,10841
130943,4,3,4168,2017,2151
130989,1,999,1565,783,782
130989,2,1,848,382,466
130989,4,3,717,401,316
131061,1,999,233,8,225
131061,2,1,233,8,225
131098,1,999,2337,1072,1265
131098,2,1,2133,1018,1115
131098,4,3,204,54,150
131113,1,999,14769,5169,9600
131113,2,1,8821,3294,5527
131113,4,3,5948,1875,4073
131159,1,999,13618,5486,8132
131159,2,1,7595,3088,4507
131159,4,3,6023,2398,3625
131283,1,999,7536,3460,4076
131283,2,1,3751,1669,2082
131283,4,3,3785,1791,1994
131308,1,999,1037,240,797
131308,2,1,762,216,546
131308,4,3,275,24,251
131399,1,999,12440,4607,7833
131399,2,1,11995,4441,7554
131399,4,3,445,166,279
131405,1,999,92,77,15
131405,4,3,92,77,15
131450,1,999,1727,660,1067
131450,2,1,1222,549,673
131450,4,3,505,111,394
131469,1,999,29887,13125,16762
131469,2,1,11503,5161,6342
131469,4,3,18384,7964,10420
131496,1,999,20320,9765,10555
131496,2,1,9695,4301,5394
131496,4,3,10625,5464,5161
131520,1,999,11115,3937,7178
131520,2,1,7496,2507,4989
131520,4,3,3619,1430,2189
131742,1,999,2633,665,1968
131742,2,1,2633,665,1968
131803,1,999,3492,1346,2146
131803,2,1,2579,983,1596
131803,4,3,913,363,550
131830,1,999,46,20,26
131830,2,1,46,20,26
131876,1,999,2771,255,2516
131876,2,1,1860,89,1771
131876,4,3,911,166,745
131973,1,999,763,374,389
131973,4,3,763,374,389
132268,1,999,1574,1484,90
132268,2,1,1574,1484,90
132338,1,999,3990,1811,2179
132338,2,1,3990,1811,2179
132374,1,999,3318,2467,851
132374,2,1,3318,2467,851
132408,1,999,768,484,284
132408,2,1,740,457,283
132408,4,3,28,27,1
132471,1,999,11200,3583,7617
132471,2,1,5930,1949,3981
132471,4,3,5270,1634,3636
132523,1,999,53,34,19
132523,4,3,53,34,19
132602,1,999,3822,1531,2291
132602,2,1,3785,1512,2273
132602,4,3,37,19,18
132657,1,999,2589,1307,1282
132657,2,1,1937,1015,922
132657,4,3,652,292,360
132666,1,999,190,73,117
132666,2,1,190,73,117
132675,1,999,296,179,117
132675,2,1,296,179,117
132693,1,999,25283,10592,14691
132693,2,1,25283,10592,14691
132709,1,999,60085,24807,35278
132709,2,1,60085,24807,35278
132806,1,999,798,167,631
132806,2,1,798,167,631
132842,1,999,1373,298,1075
132842,2,1,457,114,343
132842,4,3,916,184,732
132851,1,999,12325,4811,7514
132851,2,1,12325,4811,7514
132879,1,999,376,198,178
132879,2,1,376,198,178
132903,1,999,66273,29530,36743
132903,2,1,55378,25063,30315
132903,4,3,10895,4467,6428
132976,1,999,491,172,319
132976,2,1,491,172,319
133021,1,999,2963,1162,1801
133021,2,1,2963,1162,1801
133085,1,999,628,305,323
133085,2,1,611,296,315
133085,4,3,17,9,8
133155,1,999,1035,432,603
133155,2,1,1035,432,603
133386,1,999,25231,10032,15199
133386,2,1,25231,10032,15199
133465,1,999,1744,387,1357
133465,2,1,1632,368,1264
133465,4,3,112,19,93
133492,1,999,2800,1101,1699
133492,2,1,2800,1101,1699
133508,1,999,24097,9372,14725
133508,2,1,24097,9372,14725
133526,1,999,903,496,407
133526,2,1,903,496,407
133553,1,999,5639,4693,946
133553,2,1,4956,4182,774
133553,4,3,683,511,172
133650,1,999,14702,5935,8767
133650,2,1,12461,5070,7391
133650,4,3,2241,865,1376
133669,1,999,36164,14919,21245
133669,2,1,29230,12445,16785
133669,4,3,6934,2474,4460
133702,1,999,49670,20214,29456
133702,2,1,49670,20214,29456
133711,1,999,2962,1238,1724
133711,2,1,2962,1238,1724
133809,1,999,497,238,259
133809,2,1,497,238,259
133845,1,999,655,99,556
133845,2,1,655,99,556
133854,1,999,634,87,547
133854,2,1,634,87,547
133863,1,999,607,104,503
133863,2,1,607,104,503
133872,1,999,3527,710,2817
133872,2,1,3459,686,2773
133872,4,3,68,24,44
133881,1,999,14649,6947,7702
133881,2,1,9641,4108,5533
133881,4,3,5008,2839,2169
133942,1,999,87,6,81
133942,2,1,87,6,81
133951,1,999,56288,24521,31767
133951,2,1,44972,19950,25022
133951,4,3,11316,4571,6745
133960,1,999,2183,942,1241
133960,2,1,2183,942,1241
133979,1,999,2273,893,1380
133979,2,1,2201,872,1329
133979,4,3,72,21,51
133997,1,999,9445,3281,6164
133997,2,1,9445,3281,6164
134024,1,999,270,90,180
134024,2,1,270,90,180
134079,1,999,3398,1566,1832
134079,2,1,3192,1511,1681
134079,4,3,206,55,151
134097,1,999,45876,20759,25117
134097,2,1,35191,16033,19158
134097,4,3,10685,4726,5959
134112,1,999,3616,1040,2576
134112,2,1,3616,1040,2576
134121,1,999,331,108,223
134121,2,1,331,108,223
134130,1,999,58082,27064,31018
134130,2,1,36637,16689,19948
134130,4,3,21445,10375,11070
134149,1,999,2820,686,2134
134149,2,1,2269,572,1697
134149,4,3,551,114,437
134228,1,999,42,14,28
134228,2,1,42,14,28
134237,1,999,23871,17563,6308
134237,2,1,20529,15929,4600
134237,4,3,3342,1634,1708
134291,1,999,1218,928,290
134291,2,1,1218,928,290
134307,1,999,1471,1375,96
134307,2,1,1471,1375,96
134343,1,999,10716,4361,6355
134343,2,1,10716,4361,6355
134422,1,999,157,18,139
134422,2,1,157,18,139
134495,1,999,40213,17311,22902
134495,2,1,40213,17311,22902
134510,1,999,120,64,56
134510,2,1,120,64,56
134529,1,999,374,9,365
134529,2,1,374,9,365
134574,1,999,351,104,247
134574,2,1,351,104,247
134608,1,999,26197,10418,15779
134608,2,1,26197,10418,15779
134680,1,999,1956,959,997
134680,2,1,1949,957,992
134680,4,3,7,2,5
134714,1,999,440,67,373
134714,2,1,440,67,373
134811,1,999,5659,2557,3102
134811,2,1,5535,2501,3034
134811,4,3,124,56,68
134875,1,999,2217,506,1711
134875,2,1,2217,506,1711
134909,1,999,1456,1061,395
134909,2,1,1456,1061,395
134945,1,999,5627,1911,3716
134945,2,1,4941,1652,3289
134945,4,3,686,259,427
135063,1,999,1022,213,809
135063,2,1,1022,213,809
135081,1,999,30432,9071,21361
135081,2,1,29495,8797,20698
135081,4,3,937,274,663
135124,1,999,1444,438,1006
135124,2,1,1444,438,1006
135142,1,999,645,14,631
135142,2,1,645,14,631
135160,1,999,4575,1613,2962
135160,2,1,4575,1613,2962
135179,1,999,1148,539,609
135179,2,1,1148,539,609
135188,1,999,6736,2499,4237
135188,2,1,6736,2499,4237
135267,1,999,1354,889,465
135267,2,1,1354,889,465
135276,1,999,1838,957,881
135276,2,1,1838,957,881
135294,1,999,1654,939,715
135294,2,1,1654,939,715
135337,1,999,349,45,304
135337,2,1,349,45,304
135364,1,999,1628,1201,427
135364,2,1,559,394,165
135364,4,3,1069,807,262
135391,1,999,17404,6892,10512
135391,2,1,17404,6892,10512
135407,1,999,1807,908,899
135407,2,1,1807,908,899
135416,1,999,1058,138,920
135416,2,1,1058,138,920
135434,1,999,1050,219,831
135434,2,1,1050,219,831
135522,1,999,835,436,399
135522,2,1,835,436,399
135610,1,999,427,148,279
135610,2,1,278,88,190
135610,4,3,149,60,89
135647,1,999,2161,1523,638
135647,2,1,2161,1523,638
135717,1,999,99232,41833,57399
135717,2,1,99232,41833,57399
135726,1,999,17797,8590,9207
135726,2,1,11674,5565,6109
135726,4,3,6123,3025,3098
135735,1,999,2483,2207,276
135735,2,1,2483,2207,276
135771,1,999,1310,344,966
135771,2,1,1310,344,966
135939,1,999,406,175,231
135939,2,1,406,175,231
135957,1,999,1669,284,1385
135957,2,1,1669,284,1385
136011,1,999,1514,335,1179
136011,2,1,1514,335,1179
136048,1,999,218,49,169
136048,2,1,218,49,169
136066,1,999,4194,1743,2451
136066,2,1,4194,1743,2451
136075,1,999,615,77,538
136075,2,1,615,77,538
136109,1,999,306,24,282
136109,2,1,306,24,282
136145,1,999,1924,648,1276
136145,2,1,1924,648,1276
136172,1,999,18950,8252,10698
136172,2,1,16539,7313,9226
136172,4,3,2411,939,1472
136206,1,999,782,458,324
136206,2,1,741,440,301
136206,4,3,41,18,23
136215,1,999,39245,12344,26901
136215,2,1,7777,2208,5569
136215,4,3,31468,10136,21332
136233,1,999,11803,4958,6845
136233,2,1,11803,4958,6845
136251,1,999,113,10,103
136251,2,1,113,10,103
136288,1,999,2191,523,1668
136288,2,1,2104,476,1628
136288,4,3,87,47,40
136303,1,999,1103,273,830
136303,2,1,1103,273,830
136330,1,999,4040,1475,2565
136330,2,1,3111,1182,1929
136330,4,3,929,293,636
136358,1,999,43530,18349,25181
136358,2,1,43530,18349,25181
136400,1,999,15065,5739,9326
136400,2,1,15065,5739,9326
136473,1,999,17485,6800,10685
136473,2,1,17485,6800,10685
136491,1,999,1948,1237,711
136491,2,1,1948,1237,711
136516,1,999,15150,5709,9441
136516,2,1,15150,5709,9441
136659,1,999,390,239,151
136659,2,1,390,239,151
136701,1,999,95,92,3
136701,4,3,95,92,3
136738,1,999,1997,1695,302
136738,2,1,1997,1695,302
136747,1,999,2210,2088,122
136747,2,1,2210,2088,122
136765,1,999,940,478,462
136765,2,1,940,478,462
136774,1,999,1383,576,807
136774,2,1,1383,576,807
136783,1,999,79,3,76
136783,2,1,79,3,76
136826,1,999,1587,801,786
136826,2,1,1587,801,786
136950,1,999,3634,1537,2097
136950,2,1,2794,1133,1661
136950,4,3,840,404,436
137023,1,999,1155,582,573
137023,2,1,1155,582,573
137032,1,999,26033,10754,15279
137032,2,1,21608,9025,12583
137032,4,3,4425,1729,2696
137078,1,999,43534,17420,26114
137078,2,1,43534,17420,26114
137087,1,999,1930,899,1031
137087,2,1,1930,899,1031
137096,1,999,21793,9868,11925
137096,2,1,21793,9868,11925
137120,1,999,1321,799,522
137120,2,1,1321,799,522
137148,1,999,2498,586,1912
137148,2,1,213,50,163
137148,4,3,2285,536,1749
137209,1,999,26884,11152,15732
137209,2,1,26884,11152,15732
137245,1,999,3337,1417,1920
137245,2,1,3337,1417,1920
137272,1,999,69,69,0
137272,2,1,51,51,0
137272,4,3,18,18,0
137281,1,999,9676,3814,5862
137281,2,1,9676,3814,5862
137315,1,999,4351,1832,2519
137315,2,1,4351,1832,2519
137351,1,999,47862,20162,27700
137351,2,1,35840,15613,20227
137351,4,3,12022,4549,7473
137476,1,999,5000,2057,2943
137476,2,1,3189,1290,1899
137476,4,3,1811,767,1044
137537,1,999,329,29,300
137537,2,1,329,29,300
137546,1,999,4086,1783,2303
137546,2,1,2237,966,1271
137546,4,3,1849,817,1032
137564,1,999,3144,1324,1820
137564,2,1,2796,1199,1597
137564,4,3,348,125,223
137591,1,999,475,144,331
137591,2,1,475,144,331
137713,1,999,237,57,180
137713,2,1,237,57,180
137759,1,999,21176,9493,11683
137759,2,1,21176,9493,11683
137777,1,999,57,57,0
137777,2,1,43,43,0
137777,4,3,14,14,0
137801,1,999,2600,944,1656
137801,2,1,2544,925,1619
137801,4,3,56,19,37
137810,1,999,1342,327,1015
137810,2,1,1305,312,993
137810,4,3,37,15,22
137847,1,999,7412,3240,4172
137847,2,1,6408,2783,3625
137847,4,3,1004,457,547
137856,1,999,380,222,158
137856,2,1,380,222,158
137865,1,999,901,441,460
137865,2,1,901,441,460
137892,1,999,1436,599,837
137892,2,1,1436,599,837
137953,1,999,252,150,102
137953,2,1,246,146,100
137953,4,3,6,4,2
137962,1,999,235,143,92
137962,2,1,235,143,92
138132,1,999,153,15,138
138132,2,1,153,15,138
138187,1,999,59259,25901,33358
138187,2,1,59259,25901,33358
138275,1,999,1378,564,814
138275,2,1,1179,497,682
138275,4,3,199,67,132
138284,1,999,943,489,454
138284,2,1,943,489,454
138293,1,999,864,540,324
138293,2,1,774,503,271
138293,4,3,90,37,53
138309,1,999,8878,2413,6465
138309,2,1,8878,2413,6465
138354,1,999,14670,5958,8712
138354,2,1,11771,4890,6881
138354,4,3,2899,1068,1831
138372,1,999,1141,515,626
138372,2,1,1141,515,626
138479,1,999,1822,1104,718
138479,2,1,1822,1104,718
138488,1,999,909,275,634
138488,2,1,909,275,634
138497,1,999,648,372,276
138497,2,1,648,372,276
138558,1,999,3989,1778,2211
138558,2,1,3989,1778,2211
138594,1,999,5317,1095,4222
138594,2,1,5317,1095,4222
138600,1,999,1021,28,993
138600,2,1,996,23,973
138600,4,3,25,5,20
138655,1,999,517,410,107
138655,2,1,517,410,107
138664,1,999,36,16,20
138664,2,1,36,16,20
138682,1,999,7029,2752,4277
138682,2,1,7029,2752,4277
138691,1,999,8506,2546,5960
138691,2,1,8506,2546,5960
138716,1,999,5348,1737,3611
138716,2,1,4723,1592,3131
138716,4,3,625,145,480
138761,1,999,387,175,212
138761,2,1,387,175,212
138789,1,999,9297,3173,6124
138789,2,1,8250,2955,5295
138789,4,3,1047,218,829
138813,1,999,5830,3203,2627
138813,2,1,5830,3203,2627
138822,1,999,1270,97,1173
138822,2,1,1270,97,1173
138840,1,999,8239,3481,4758
138840,2,1,8239,3481,4758
138868,1,999,1352,517,835
138868,2,1,1352,517,835
138901,1,999,4661,1665,2996
138901,2,1,4661,1665,2996
138929,1,999,631,328,303
138929,4,3,631,328,303
138938,1,999,474,81,393
138938,2,1,474,81,393
138947,1,999,4301,1237,3064
138947,2,1,3561,990,2571
138947,4,3,740,247,493
138956,1,999,7624,2863,4761
138956,2,1,7624,2863,4761
138983,1,999,8460,3139,5321
138983,2,1,7032,2712,4320
138983,4,3,1428,427,1001
139010,1,999,5427,1734,3693
139010,2,1,5427,1734,3693
139074,1,999,1197,326,871
139074,2,1,1197,326,871
139092,1,999,123,11,112
139092,2,1,123,11,112
139144,1,999,2220,722,1498
139144,2,1,2002,657,1345
139144,4,3,218,65,153
139153,1,999,845,364,481
139153,2,1,640,281,359
139153,4,3,205,83,122
139199,1,999,3480,479,3001
139199,2,1,2230,237,1993
139199,4,3,1250,242,1008
139205,1,999,1156,544,612
139205,2,1,1156,544,612
139214,1,999,371,21,350
139214,2,1,371,21,350
139250,1,999,4560,1442,3118
139250,2,1,4560,1442,3118
139278,1,999,12507,3976,8531
139278,2,1,12507,3976,8531
139287,1,999,285,187,98
139287,2,1,285,187,98
139311,1,999,8693,2618,6075
139311,2,1,8365,2426,5939
139311,4,3,328,192,136
139348,1,999,397,209,188
139348,4,3,397,209,188
139357,1,999,6889,2307,4582
139357,2,1,6889,2307,4582
139366,1,999,10321,4186,6135
139366,2,1,8693,3523,5170
139366,4,3,1628,663,965
139384,1,999,10411,3738,6673
139384,2,1,10411,3738,6673
139393,1,999,1356,609,747
139393,2,1,1293,577,716
139393,4,3,63,32,31
139463,1,999,7328,2868,4460
139463,2,1,7328,2868,4460
139506,1,999,309,117,192
139506,2,1,309,117,192
139533,1,999,7245,3587,3658
139533,2,1,7245,3587,3658
139579,1,999,2504,697,1807
139579,2,1,1644,442,1202
139579,4,3,860,255,605
139621,1,999,4067,1715,2352
139621,2,1,4067,1715,2352
139630,1,999,855,411,444
139630,2,1,855,411,444
139658,1,999,14751,6595,8156
139658,2,1,7735,3488,4247
139658,4,3,7016,3107,3909
139700,1,999,7269,2703,4566
139700,2,1,7269,2703,4566
139719,1,999,4351,1787,2564
139719,2,1,4048,1708,2340
139719,4,3,303,79,224
139746,1,999,109,17,92
139746,2,1,109,17,92
139755,1,999,23017,16380,6637
139755,2,1,15175,10507,4668
139755,4,3,7842,5873,1969
139764,1,999,3832,1358,2474
139764,2,1,3422,1266,2156
139764,4,3,410,92,318
139773,1,999,11565,5294,6271
139773,2,1,11565,5294,6271
139861,1,999,7723,3070,4653
139861,2,1,6295,2543,3752
139861,4,3,1428,527,901
139904,1,999,2227,1089,1138
139904,2,1,2227,1089,1138
139931,1,999,23026,11115,11911
139931,2,1,19599,9895,9704
139931,4,3,3427,1220,2207
139940,1,999,37712,15084,22628
139940,2,1,27824,11206,16618
139940,4,3,9888,3878,6010
139959,1,999,38822,16246,22576
139959,2,1,28891,12209,16682
139959,4,3,9931,4037,5894
139968,1,999,6430,2213,4217
139968,2,1,6430,2213,4217
139986,1,999,9892,3281,6611
139986,2,1,9892,3281,6611
139995,1,999,320,154,166
139995,2,1,320,154,166
140003,1,999,775,117,658
140003,2,1,775,117,658
140012,1,999,11010,4445,6565
140012,2,1,11010,4445,6565
140085,1,999,7666,3585,4081
140085,2,1,7666,3585,4081
140146,1,999,470,277,193
140146,4,3,470,277,193
140164,1,999,28407,11767,16640
140164,2,1,25834,10680,15154
140164,4,3,2573,1087,1486
140234,1,999,1129,436,693
140234,2,1,898,372,526
140234,4,3,231,64,167
140243,1,999,6921,2480,4441
140243,2,1,6921,2480,4441
140252,1,999,2874,1534,1340
140252,2,1,1050,502,548
140252,4,3,1824,1032,792
140304,1,999,12199,4186,8013
140304,2,1,12199,4186,8013
140322,1,999,8442,2891,5551
140322,2,1,8442,2891,5551
140331,1,999,20402,8130,12272
140331,2,1,20402,8130,12272
140340,1,999,941,345,596
140340,2,1,941,345,596
140401,1,999,2646,922,1724
140401,2,1,560,82,478
140401,4,3,2086,840,1246
140447,1,999,9530,3056,6474
140447,2,1,5119,1599,3520
140447,4,3,4411,1457,2954
140483,1,999,4563,2128,2435
140483,2,1,4563,2128,2435
140553,1,999,2721,2714,7
140553,2,1,2721,2714,7
140562,1,999,329,103,226
140562,4,3,329,103,226
140599,1,999,4164,1539,2625
140599,2,1,4164,1539,2625
140669,1,999,6914,2942,3972
140669,2,1,6222,2734,3488
140669,4,3,692,208,484
140678,1,999,4296,1775,2521
140678,2,1,4296,1775,2521
140696,1,999,1330,510,820
140696,2,1,1248,508,740
140696,4,3,82,2,80
140720,1,999,1064,406,658
140720,2,1,1064,406,658
140818,1,999,3113,720,2393
140818,2,1,1345,408,937
140818,4,3,1768,312,1456
140827,1,999,144,57,87
140827,2,1,144,57,87
140872,1,999,1466,638,828
140872,2,1,1347,608,739
140872,4,3,119,30,89
140942,1,999,9750,3416,6334
140942,2,1,9750,3416,6334
140951,1,999,11379,4456,6923
140951,2,1,9027,3459,5568
140951,4,3,2352,997,1355
140960,1,999,4700,2084,2616
140960,2,1,4548,2045,2503
140960,4,3,152,39,113
140988,1,999,1975,980,995
140988,2,1,1940,968,972
140988,4,3,35,12,23
140997,1,999,2867,1099,1768
140997,2,1,2867,1099,1768
141006,1,999,4407,2060,2347
141006,2,1,4407,2060,2347
141015,1,999,371,180,191
141015,2,1,371,180,191
141060,1,999,2228,0,2228
141060,2,1,2228,0,2228
141097,1,999,6678,5160,1518
141097,2,1,5699,4570,1129
141097,4,3,979,590,389
141158,1,999,2671,862,1809
141158,2,1,2671,862,1809
141167,1,999,1383,448,935
141167,2,1,1101,397,704
141167,4,3,282,51,231
141185,1,999,837,388,449
141185,2,1,837,388,449
141237,1,999,848,432,416
141237,2,1,848,432,416
141255,1,999,9008,3097,5911
141255,2,1,9008,3097,5911
141264,1,999,15095,5765,9330
141264,2,1,12295,5042,7253
141264,4,3,2800,723,2077
141307,1,999,1740,544,1196
141307,2,1,1740,544,1196
141325,1,999,814,41,773
141325,2,1,732,28,704
141325,4,3,82,13,69
141334,1,999,13314,5042,8272
141334,2,1,11189,4444,6745
141334,4,3,2125,598,1527
141361,1,999,862,376,486
141361,2,1,862,376,486
141468,1,999,3128,1151,1977
141468,2,1,3128,1151,1977
141486,1,999,3815,1377,2438
141486,2,1,2776,1069,1707
141486,4,3,1039,308,731
141565,1,999,4788,1913,2875
141565,2,1,4114,1647,2467
141565,4,3,674,266,408
141574,1,999,23854,10613,13241
141574,2,1,16468,7579,8889
141574,4,3,7386,3034,4352
141608,1,999,168,41,127
141608,2,1,168,41,127
141644,1,999,10331,4715,5616
141644,2,1,8697,3999,4698
141644,4,3,1634,716,918
141680,1,999,6519,3546,2973
141680,2,1,6519,3546,2973
141796,1,999,13304,5556,7748
141796,2,1,13304,5556,7748
141802,1,999,1787,695,1092
141802,2,1,1787,695,1092
141811,1,999,10697,4263,6434
141811,2,1,10697,4263,6434
141839,1,999,5773,2019,3754
141839,2,1,5773,2019,3754
141848,1,999,288,14,274
141848,2,1,288,14,274
141936,1,999,55,19,36
141936,4,3,55,19,36
141945,1,999,244,63,181
141945,2,1,244,63,181
141981,1,999,1811,556,1255
141981,2,1,1811,556,1255
141990,1,999,3705,1433,2272
141990,2,1,3705,1433,2272
142054,1,999,1083,182,901
142054,2,1,1083,182,901
142090,1,999,202,106,96
142090,2,1,202,106,96
142115,1,999,29520,12577,16943
142115,2,1,22520,10463,12057
142115,4,3,7000,2114,4886
142179,1,999,1420,615,805
142179,2,1,1420,615,805
142276,1,999,18620,8038,10582
142276,2,1,15414,6656,8758
142276,4,3,3206,1382,1824
142285,1,999,15087,8071,7016
142285,2,1,10962,5873,5089
142285,4,3,4125,2198,1927
142294,1,999,1074,443,631
142294,2,1,1048,438,610
142294,4,3,26,5,21
142328,1,999,5816,2294,3522
142328,2,1,5816,2294,3522
142337,1,999,913,617,296
142337,2,1,913,617,296
142407,1,999,70,2,68
142407,2,1,70,2,68
142416,1,999,35,2,33
142416,2,1,35,2,33
142443,1,999,8675,3482,5193
142443,2,1,8675,3482,5193
142461,1,999,2561,1022,1539
142461,2,1,1599,658,941
142461,4,3,962,364,598
142489,1,999,113,3,110
142489,2,1,113,3,110
142522,1,999,24584,11164,13420
142522,2,1,24584,11164,13420
142559,1,999,13727,5265,8462
142559,2,1,13727,5265,8462
142832,1,999,988,218,770
142832,4,3,988,218,770
142869,1,999,44,2,42
142869,2,1,44,2,42
142878,1,999,74,4,70
142878,2,1,74,4,70
142887,1,999,511,264,247
142887,2,1,511,264,247
143048,1,999,3599,1151,2448
143048,2,1,2799,911,1888
143048,4,3,800,240,560
143075,1,999,698,160,538
143075,2,1,698,160,538
143084,1,999,2692,1117,1575
143084,2,1,2692,1117,1575
143118,1,999,8004,2169,5835
143118,2,1,2956,1054,1902
143118,4,3,5048,1115,3933
143181,1,999,80,8,72
143181,2,1,80,8,72
143215,1,999,24685,11699,12986
143215,2,1,24685,11699,12986
143233,1,999,82,40,42
143233,4,3,82,40,42
143279,1,999,13098,5899,7199
143279,2,1,13098,5899,7199
143288,1,999,624,255,369
143288,2,1,624,255,369
143297,1,999,289,29,260
143297,2,1,265,28,237
143297,4,3,24,1,23
143303,1,999,20,1,19
143303,2,1,20,1,19
143358,1,999,6206,2897,3309
143358,2,1,5273,2457,2816
143358,4,3,933,440,493
143376,1,999,547,14,533
143376,2,1,547,14,533
143464,1,999,201,3,198
143464,2,1,201,3,198
143473,1,999,91,1,90
143473,2,1,91,1,90
143482,1,999,80,2,78
143482,2,1,80,2,78
143491,1,999,140,1,139
143491,2,1,140,1,139
143516,1,999,109,1,108
143516,2,1,109,1,108
143534,1,999,142,2,140
143534,2,1,142,2,140
143543,1,999,201,11,190
143543,2,1,201,11,190
143552,1,999,166,8,158
143552,2,1,166,8,158
143613,1,999,4843,1693,3150
143613,2,1,4843,1693,3150
143659,1,999,541,311,230
143659,4,3,541,311,230
143695,1,999,69,1,68
143695,2,1,69,1,68
143853,1,999,2239,879,1360
143853,4,3,2239,879,1360
143978,1,999,3425,652,2773
143978,4,3,3425,652,2773
144005,1,999,8981,2729,6252
144005,2,1,6768,2011,4757
144005,4,3,2213,718,1495
144014,1,999,248,136,112
144014,4,3,248,136,112
144050,1,999,17645,9930,7715
144050,2,1,5402,2792,2610
144050,4,3,12243,7138,5105
144157,1,999,10320,3558,6762
144157,2,1,10320,3558,6762
144166,1,999,13065,4636,8429
144166,2,1,13065,4636,8429
144175,1,999,7791,2544,5247
144175,2,1,7791,2544,5247
144184,1,999,20587,9096,11491
144184,2,1,20587,9096,11491
144193,1,999,14819,5850,8969
144193,2,1,14819,5850,8969
144209,1,999,16512,8058,8454
144209,2,1,16512,8058,8454
144218,1,999,19590,8361,11229
144218,2,1,19590,8361,11229
144281,1,999,13173,6122,7051
144281,2,1,12566,5925,6641
144281,4,3,607,197,410
144351,1,999,6513,1781,4732
144351,2,1,1463,628,835
144351,4,3,5050,1153,3897
144467,1,999,1860,1089,771
144467,2,1,1860,1089,771
144485,1,999,1811,1422,389
144485,2,1,1811,1422,389
144564,1,999,9418,3960,5458
144564,2,1,9418,3960,5458
144573,1,999,94,6,88
144573,2,1,94,6,88
144616,1,999,54,2,52
144616,2,1,54,2,52
144740,1,999,29862,14019,15843
144740,2,1,18654,8511,10143
144740,4,3,11208,5508,5700
144759,1,999,44709,22510,22199
144759,2,1,44418,22413,22005
144759,4,3,291,97,194
144795,1,999,196,8,188
144795,2,1,196,8,188
144865,1,999,48128,22092,26036
144865,2,1,48128,22092,26036
144883,1,999,1223,523,700
144883,2,1,1223,523,700
144892,1,999,13376,5630,7746
144892,2,1,10976,4654,6322
144892,4,3,2400,976,1424
144944,1,999,19357,8580,10777
144944,2,1,19357,8580,10777
144962,1,999,3758,1426,2332
144962,2,1,3444,1301,2143
144962,4,3,314,125,189
144971,1,999,832,363,469
144971,2,1,832,363,469
145099,1,999,256,14,242
145099,2,1,256,14,242
145239,1,999,497,104,393
145239,2,1,497,104,393
145275,1,999,428,193,235
145275,4,3,428,193,235
145309,1,999,71,24,47
145309,2,1,71,24,47
145336,1,999,7440,2193,5247
145336,2,1,3894,1258,2636
145336,4,3,3546,935,2611
145354,1,999,81,5,76
145354,2,1,81,5,76
145372,1,999,2027,922,1105
145372,2,1,1594,795,799
145372,4,3,433,127,306
145406,1,999,410,21,389
145406,2,1,410,21,389
145424,1,999,136,4,132
145424,2,1,136,4,132
145433,1,999,159,12,147
145433,2,1,159,12,147
145460,1,999,1390,326,1064
145460,2,1,1253,306,947
145460,4,3,137,20,117
145497,1,999,560,78,482
145497,2,1,550,68,482
145497,4,3,10,10,0
145521,1,999,3972,1351,2621
145521,2,1,3972,1351,2621
145558,1,999,1939,911,1028
145558,4,3,1939,911,1028
145600,1,999,31221,14023,17198
145600,2,1,18583,8932,9651
145600,4,3,12638,5091,7547
145619,1,999,10152,3367,6785
145619,2,1,4828,1858,2970
145619,4,3,5324,1509,3815
145628,1,999,640,225,415
145628,4,3,640,225,415
145637,1,999,47146,25234,21912
145637,2,1,32790,17995,14795
145637,4,3,14356,7239,7117
145646,1,999,2108,884,1224
145646,2,1,2108,884,1224
145682,1,999,19573,8497,11076
145682,2,1,19573,8497,11076
145691,1,999,908,468,440
145691,2,1,908,468,440
145707,1,999,2725,880,1845
145707,2,1,2725,880,1845
145725,1,999,8654,5526,3128
145725,2,1,2819,1970,849
145725,4,3,5835,3556,2279
145770,1,999,2022,595,1427
145770,2,1,489,157,332
145770,4,3,1533,438,1095
145813,1,999,23785,10297,13488
145813,2,1,19847,8909,10938
145813,4,3,3938,1388,2550
145831,1,999,8315,3790,4525
145831,2,1,8315,3790,4525
145886,1,999,98,14,84
145886,4,3,98,14,84
146010,1,999,2144,901,1243
146010,2,1,2144,901,1243
146205,1,999,19035,7171,11864
146205,2,1,19035,7171,11864
146241,1,999,1872,1028,844
146241,4,3,1872,1028,844
146278,1,999,4231,1734,2497
146278,2,1,4231,1734,2497
146296,1,999,31847,14749,17098
146296,2,1,31847,14749,17098
146339,1,999,1535,655,880
146339,2,1,1315,574,741
146339,4,3,220,81,139
146348,1,999,10765,4382,6383
146348,2,1,10765,4382,6383
146366,1,999,9566,3910,5656
146366,2,1,9566,3910,5656
146384,1,999,12907,5268,7639
146384,4,3,12907,5268,7639
146393,1,999,3436,909,2527
146393,2,1,3436,909,2527
146418,1,999,7588,3470,4118
146418,2,1,7588,3470,4118
146427,1,999,1429,584,845
146427,2,1,1429,584,845
146454,1,999,91,4,87
146454,2,1,91,4,87
146472,1,999,31045,14132,16913
146472,2,1,31045,14132,16913
146481,1,999,1533,616,917
146481,2,1,1507,605,902
146481,4,3,26,11,15
146490,1,999,905,535,370
146490,4,3,905,535,370
146506,1,999,21523,13345,8178
146506,2,1,21523,13345,8178
146533,1,999,395,47,348
146533,2,1,395,47,348
146603,1,999,12323,5589,6734
146603,2,1,12323,5589,6734
146612,1,999,7740,3082,4658
146612,2,1,5120,2221,2899
146612,4,3,2620,861,1759
146621,1,999,68,0,68
146621,2,1,68,0,68
146667,1,999,1260,626,634
146667,2,1,736,351,385
146667,4,3,524,275,249
146676,1,999,1508,587,921
146676,2,1,1508,587,921
146685,1,999,14666,6084,8582
146685,2,1,14666,6084,8582
146700,1,999,2376,1743,633
146700,2,1,2376,1743,633
146719,1,999,18190,6602,11588
146719,2,1,10972,4029,6943
146719,4,3,7218,2573,4645
146728,1,999,299,145,154
146728,4,3,299,145,154
146755,1,999,299,51,248
146755,2,1,299,51,248
146791,1,999,899,420,479
146791,2,1,899,420,479
146807,1,999,86,16,70
146807,2,1,86,16,70
146816,1,999,212,35,177
146816,2,1,212,35,177
146825,1,999,560,203,357
146825,2,1,560,203,357
146977,1,999,286,136,150
146977,4,3,286,136,150
147004,1,999,11541,5095,6446
147004,2,1,11541,5095,6446
147013,1,999,4116,1656,2460
147013,2,1,2828,1238,1590
147013,4,3,1288,418,870
147031,1,999,141,53,88
147031,4,3,141,53,88
147129,1,999,585,65,520
147129,2,1,585,65,520
147165,1,999,980,194,786
147165,2,1,980,194,786
147244,1,999,2692,1064,1628
147244,2,1,2580,1014,1566
147244,4,3,112,50,62
147341,1,999,1375,652,723
147341,2,1,1375,652,723
147369,1,999,4136,2403,1733
147369,2,1,3366,1912,1454
147369,4,3,770,491,279
147378,1,999,31301,14822,16479
147378,2,1,31301,14822,16479
147396,1,999,105,98,7
147396,2,1,105,98,7
147411,1,999,8335,3483,4852
147411,2,1,8335,3483,4852
147439,1,999,117,6,111
147439,2,1,117,6,111
147536,1,999,9773,2146,7627
147536,2,1,2089,561,1528
147536,4,3,7684,1585,6099
147590,1,999,1006,469,537
147590,2,1,151,51,100
147590,4,3,855,418,437
147642,1,999,127,9,118
147642,2,1,127,9,118
147660,1,999,3336,1501,1835
147660,2,1,2899,1297,1602
147660,4,3,437,204,233
147679,1,999,3777,1369,2408
147679,2,1,2491,950,1541
147679,4,3,1286,419,867
147697,1,999,223,141,82
147697,4,3,223,141,82
147703,1,999,27287,12891,14396
147703,2,1,19512,9596,9916
147703,4,3,7775,3295,4480
147749,1,999,1243,279,964
147749,2,1,1243,279,964
147767,1,999,23634,12126,11508
147767,2,1,10802,5107,5695
147767,4,3,12832,7019,5813
147776,1,999,14818,6035,8783
147776,2,1,11536,4942,6594
147776,4,3,3282,1093,2189
147800,1,999,27138,11311,15827
147800,2,1,27138,11311,15827
147819,1,999,101,3,98
147819,2,1,101,3,98
147828,1,999,6448,2029,4419
147828,2,1,3569,1297,2272
147828,4,3,2879,732,2147
147916,1,999,17840,8728,9112
147916,2,1,17840,8728,9112
147970,1,999,281,16,265
147970,2,1,281,16,265
148007,1,999,12010,4795,7215
148007,2,1,12010,4795,7215
148016,1,999,571,275,296
148016,2,1,571,275,296
148098,1,999,78,4,74
148098,2,1,78,4,74
148131,1,999,2781,903,1878
148131,2,1,1399,592,807
148131,4,3,1382,311,1071
148140,1,999,626,264,362
148140,2,1,626,264,362
148177,1,999,4153,1765,2388
148177,2,1,4153,1765,2388
148256,1,999,14698,6770,7928
148256,2,1,14698,6770,7928
148292,1,999,7559,3359,4200
148292,2,1,7559,3359,4200
148335,1,999,5661,2324,3337
148335,2,1,4866,2009,2857
148335,4,3,795,315,480
148380,1,999,16326,7135,9191
148380,2,1,16326,7135,9191
148399,1,999,1215,230,985
148399,2,1,1215,230,985
148405,1,999,2460,712,1748
148405,2,1,1091,412,679
148405,4,3,1369,300,1069
148487,1,999,8224,2739,5485
148487,2,1,4613,1604,3009
148487,4,3,3611,1135,2476
148496,1,999,4408,1235,3173
148496,2,1,2067,673,1394
148496,4,3,2341,562,1779
148511,1,999,2175,542,1633
148511,2,1,93,34,59
148511,4,3,2082,508,1574
148575,1,999,612,64,548
148575,2,1,423,50,373
148575,4,3,189,14,175
148584,1,999,4344,1063,3281
148584,2,1,2001,564,1437
148584,4,3,2343,499,1844
148593,1,999,147,13,134
148593,2,1,147,13,134
148627,1,999,5805,1643,4162
148627,2,1,3467,1060,2407
148627,4,3,2338,583,1755
148654,1,999,6269,2932,3337
148654,2,1,3693,1732,1961
148654,4,3,2576,1200,1376
148672,1,999,4661,1822,2839
148672,2,1,4661,1822,2839
148724,1,999,60,28,32
148724,4,3,60,28,32
148821,1,999,7312,3353,3959
148821,2,1,7312,3353,3959
148849,1,999,120,61,59
148849,2,1,120,61,59
148876,1,999,2095,502,1593
148876,2,1,2095,502,1593
148885,1,999,220,209,11
148885,4,3,220,209,11
148937,1,999,6494,3146,3348
148937,2,1,6494,3146,3348
148955,1,999,169,12,157
148955,2,1,169,12,157
148982,1,999,342,89,253
148982,4,3,342,89,253
148991,1,999,4135,1976,2159
148991,2,1,4135,1976,2159
149019,1,999,203,47,156
149019,2,1,203,47,156
149028,1,999,292,20,272
149028,2,1,240,18,222
149028,4,3,52,2,50
149204,1,999,96,3,93
149204,2,1,96,3,93
149222,1,999,22814,12678,10136
149222,2,1,17653,10078,7575
149222,4,3,5161,2600,2561
149231,1,999,16484,7471,9013
149231,2,1,12712,5991,6721
149231,4,3,3772,1480,2292
149310,1,999,745,399,346
149310,2,1,745,399,346
149329,1,999,77,77,0
149329,2,1,60,60,0
149329,4,3,17,17,0
149365,1,999,15724,4903,10821
149365,2,1,15724,4903,10821
149499,1,999,40,2,38
149499,2,1,40,2,38
149505,1,999,1631,568,1063
149505,2,1,1631,568,1063
149514,1,999,3633,2236,1397
149514,2,1,1418,671,747
149514,4,3,2215,1565,650
149532,1,999,23343,10388,12955
149532,2,1,23343,10388,12955
149550,1,999,370,12,358
149550,2,1,370,12,358
149639,1,999,1236,498,738
149639,2,1,189,90,99
149639,4,3,1047,408,639
149727,1,999,19233,8404,10829
149727,2,1,19233,8404,10829
149763,1,999,353,54,299
149763,2,1,305,48,257
149763,4,3,48,6,42
149772,1,999,14649,7413,7236
149772,2,1,11842,6289,5553
149772,4,3,2807,1124,1683
149781,1,999,3354,1635,1719
149781,2,1,2502,1231,1271
149781,4,3,852,404,448
149842,1,999,28292,12593,15699
149842,2,1,28292,12593,15699
150048,1,999,705,219,486
150048,2,1,705,219,486
150066,1,999,3047,1368,1679
150066,2,1,2191,955,1236
150066,4,3,856,413,443
150075,1,999,22,2,20
150075,2,1,22,2,20
150136,1,999,25777,11540,14237
150136,2,1,20010,9537,10473
150136,4,3,5767,2003,3764
150145,1,999,2547,900,1647
150145,2,1,2172,732,1440
150145,4,3,375,168,207
150163,1,999,4983,2039,2944
150163,2,1,3968,1629,2339
150163,4,3,1015,410,605
150172,1,999,1452,735,717
150172,2,1,1179,606,573
150172,4,3,273,129,144
150215,1,999,245,90,155
150215,4,3,245,90,155
150251,1,999,347,17,330
150251,2,1,347,17,330
150288,1,999,448,393,55
150288,4,3,448,393,55
150303,1,999,127,6,121
150303,2,1,127,6,121
150400,1,999,2416,1042,1374
150400,2,1,2416,1042,1374
150428,1,999,110,2,108
150428,2,1,110,2,108
150437,1,999,103,1,102
150437,2,1,103,1,102
150455,1,999,1353,600,753
150455,2,1,1201,542,659
150455,4,3,152,58,94
150534,1,999,3109,1237,1872
150534,2,1,2912,1182,1730
150534,4,3,197,55,142
150604,1,999,1149,567,582
150604,2,1,1149,567,582
150640,1,999,21,5,16
150640,2,1,21,5,16
150668,1,999,1106,429,677
150668,2,1,1053,422,631
150668,4,3,53,7,46
150677,1,999,2055,1203,852
150677,2,1,1648,923,725
150677,4,3,407,280,127
150695,1,999,143,4,139
150695,2,1,143,4,139
150710,1,999,180,65,115
150710,2,1,180,65,115
150756,1,999,1015,445,570
150756,2,1,1015,445,570
150765,1,999,116,3,113
150765,2,1,116,3,113
150774,1,999,496,320,176
150774,2,1,496,320,176
150853,1,999,294,12,282
150853,2,1,294,12,282
150941,1,999,1372,641,731
150941,2,1,1224,565,659
150941,4,3,148,76,72
150978,1,999,12912,5417,7495
150978,2,1,12912,5417,7495
150987,1,999,35187,15241,19946
150987,2,1,35187,15241,19946
150996,1,999,10073,3733,6340
150996,2,1,10073,3733,6340
151005,1,999,13077,5002,8075
151005,2,1,13077,5002,8075
151014,1,999,8007,3053,4954
151014,2,1,8007,3053,4954
151023,1,999,12787,5970,6817
151023,2,1,12787,5970,6817
151032,1,999,17071,7369,9702
151032,2,1,17071,7369,9702
151041,1,999,8501,3752,4749
151041,2,1,8501,3752,4749
151050,1,999,10883,5380,5503
151050,2,1,10883,5380,5503
151069,1,999,9226,3843,5383
151069,2,1,9226,3843,5383
151078,1,999,6216,2371,3845
151078,2,1,6216,2371,3845
151087,1,999,16054,6974,9080
151087,2,1,16054,6974,9080
151096,1,999,5379,1986,3393
151096,2,1,5379,1986,3393
151102,1,999,17023,7563,9460
151102,2,1,15788,7071,8717
151102,4,3,1235,492,743
151111,1,999,38249,16358,21891
151111,2,1,28114,12060,16054
151111,4,3,10135,4298,5837
151157,1,999,470,88,382
151157,2,1,470,88,382
151166,1,999,4735,1136,3599
151166,2,1,4735,1136,3599
151193,1,999,428,48,380
151193,2,1,428,48,380
151209,1,999,372,87,285
151209,2,1,372,87,285
151236,1,999,520,105,415
151236,2,1,520,105,415
151245,1,999,495,74,421
151245,2,1,495,74,421
151263,1,999,6412,1998,4414
151263,2,1,4815,1537,3278
151263,4,3,1597,461,1136
151290,1,999,6195,2635,3560
151290,2,1,5596,2364,3232
151290,4,3,599,271,328
151306,1,999,13542,5338,8204
151306,2,1,12464,5090,7374
151306,4,3,1078,248,830
151324,1,999,15240,7197,8043
151324,2,1,12215,6087,6128
151324,4,3,3025,1110,1915
151333,1,999,3966,1380,2586
151333,2,1,3758,1289,2469
151333,4,3,208,91,117
151342,1,999,10666,4229,6437
151342,2,1,9606,3883,5723
151342,4,3,1060,346,714
151351,1,999,47743,23969,23774
151351,2,1,35946,17994,17952
151351,4,3,11797,5975,5822
151360,1,999,7830,2527,5303
151360,2,1,6891,2217,4674
151360,4,3,939,310,629
151379,1,999,9000,3638,5362
151379,2,1,7747,3238,4509
151379,4,3,1253,400,853
151388,1,999,4325,1449,2876
151388,2,1,4164,1416,2748
151388,4,3,161,33,128
151458,1,999,621,201,420
151458,2,1,621,201,420
151467,1,999,530,119,411
151467,2,1,530,119,411
151494,1,999,1576,1239,337
151494,2,1,1576,1239,337
151500,1,999,1243,774,469
151500,2,1,1243,774,469
151519,1,999,17914,10571,7343
151519,2,1,17582,10369,7213
151519,4,3,332,202,130
151537,1,999,93,11,82
151537,2,1,93,11,82
151564,1,999,63,1,62
151564,2,1,63,1,62
151607,1,999,134,5,129
151607,2,1,134,5,129
151616,1,999,1417,187,1230
151616,2,1,1417,187,1230
151625,1,999,888,181,707
151625,2,1,888,181,707
151652,1,999,421,25,396
151652,2,1,421,25,396
151661,1,999,3085,2951,134
151661,2,1,3085,2951,134
151777,1,999,1334,635,699
151777,2,1,1312,629,683
151777,4,3,22,6,16
151786,1,999,2983,1057,1926
151786,2,1,2566,910,1656
151786,4,3,417,147,270
151801,1,999,24215,8488,15727
151801,2,1,16280,5657,10623
151801,4,3,7935,2831,5104
151810,1,999,1407,489,918
151810,2,1,1311,465,846
151810,4,3,96,24,72
151829,1,999,180,11,169
151829,2,1,180,11,169
151865,1,999,181,79,102
151865,4,3,181,79,102
151874,1,999,188,79,109
151874,2,1,188,79,109
151944,1,999,2147,401,1746
151944,2,1,2147,401,1746
151962,1,999,182,93,89
151962,2,1,182,93,89
152044,1,999,165,71,94
152044,2,1,165,71,94
152080,1,999,12910,7178,5732
152080,2,1,8729,4679,4050
152080,4,3,4181,2499,1682
152099,1,999,3362,1493,1869
152099,2,1,3109,1370,1739
152099,4,3,253,123,130
152150,1,999,83,5,78
152150,2,1,83,5,78
152220,1,999,920,58,862
152220,2,1,920,58,862
152248,1,999,12386,5424,6962
152248,2,1,10745,4814,5931
152248,4,3,1641,610,1031
152266,1,999,6012,2621,3391
152266,2,1,5900,2575,3325
152266,4,3,112,46,66
152275,1,999,367,113,254
152275,2,1,367,113,254
152309,1,999,135,15,120
152309,2,1,135,15,120
152318,1,999,2047,1634,413
152318,2,1,1920,1533,387
152318,4,3,127,101,26
152327,1,999,104,10,94
152327,2,1,104,10,94
152336,1,999,2581,736,1845
152336,2,1,2131,641,1490
152336,4,3,450,95,355
152363,1,999,1120,462,658
152363,2,1,1099,456,643
152363,4,3,21,6,15
152381,1,999,1928,134,1794
152381,2,1,1661,100,1561
152381,4,3,267,34,233
152390,1,999,1608,7,1601
152390,2,1,1608,7,1601
152415,1,999,916,144,772
152415,2,1,916,144,772
152424,1,999,375,55,320
152424,2,1,375,55,320
152451,1,999,274,205,69
152451,4,3,274,205,69
152497,1,999,273,14,259
152497,2,1,273,14,259
152530,1,999,3137,1376,1761
152530,2,1,2959,1282,1677
152530,4,3,178,94,84
152567,1,999,1743,1184,559
152567,2,1,1736,1178,558
152567,4,3,7,6,1
152600,1,999,4495,2102,2393
152600,2,1,3133,1453,1680
152600,4,3,1362,649,713
152628,1,999,147,7,140
152628,2,1,147,7,140
152637,1,999,23958,13722,10236
152637,2,1,23958,13722,10236
152673,1,999,876,876,0
152673,2,1,876,876,0
152798,1,999,700,47,653
152798,2,1,508,40,468
152798,4,3,192,7,185
152822,1,999,1217,399,818
152822,2,1,1217,399,818
152992,1,999,1385,550,835
152992,2,1,1268,534,734
152992,4,3,117,16,101
153001,1,999,3860,1243,2617
153001,2,1,3707,1211,2496
153001,4,3,153,32,121
153074,1,999,296,9,287
153074,2,1,296,9,287
153083,1,999,350,8,342
153083,2,1,350,8,342
153092,1,999,27,21,6
153092,2,1,27,21,6
153108,1,999,1807,824,983
153108,2,1,1807,824,983
153126,1,999,1344,437,907
153126,2,1,1045,363,682
153126,4,3,299,74,225
153144,1,999,1494,704,790
153144,2,1,1466,687,779
153144,4,3,28,17,11
153162,1,999,1193,552,641
153162,2,1,1193,552,641
153171,1,999,47,2,45
153171,2,1,47,2,45
153214,1,999,38099,17443,20656
153214,2,1,38099,17443,20656
153241,1,999,124,85,39
153241,2,1,124,85,39
153250,1,999,1455,737,718
153250,2,1,1407,725,682
153250,4,3,48,12,36
153269,1,999,15179,5450,9729
153269,2,1,5307,2264,3043
153269,4,3,9872,3186,6686
153278,1,999,2257,1237,1020
153278,2,1,1811,1005,806
153278,4,3,446,232,214
153296,1,999,1320,673,647
153296,2,1,1320,673,647
153302,1,999,251,110,141
153302,2,1,251,110,141
153311,1,999,14423,6085,8338
153311,2,1,14423,6085,8338
153320,1,999,422,216,206
153320,2,1,344,144,200
153320,4,3,78,72,6
153339,1,999,52,2,50
153339,2,1,52,2,50
153366,1,999,3367,1068,2299
153366,2,1,2278,872,1406
153366,4,3,1089,196,893
153375,1,999,2368,930,1438
153375,2,1,2334,921,1413
153375,4,3,34,9,25
153384,1,999,1692,769,923
153384,2,1,1692,769,923
153409,1,999,556,152,404
153409,2,1,538,149,389
153409,4,3,18,3,15
153418,1,999,1117,297,820
153418,2,1,1091,293,798
153418,4,3,26,4,22
153427,1,999,573,315,258
153427,2,1,573,315,258
153445,1,999,9791,4321,5470
153445,2,1,9791,4321,5470
153463,1,999,59,5,54
153463,2,1,59,5,54
153472,1,999,8106,3311,4795
153472,2,1,8106,3311,4795
153524,1,999,9159,4329,4830
153524,2,1,9159,4329,4830
153533,1,999,4784,2164,2620
153533,2,1,4784,2164,2620
153542,1,999,19,6,13
153542,2,1,19,6,13
153588,1,999,40,24,16
153588,2,1,40,24,16
153597,1,999,324,16,308
153597,2,1,324,16,308
153603,1,999,31501,17528,13973
153603,2,1,25117,14069,11048
153603,4,3,6384,3459,2925
153621,1,999,871,349,522
153621,2,1,871,349,522
153630,1,999,9034,3881,5153
153630,2,1,9034,3881,5153
153658,1,999,33952,16409,17543
153658,2,1,23192,11159,12033
153658,4,3,10760,5250,5510
153737,1,999,26112,12195,13917
153737,2,1,26112,12195,13917
153746,1,999,163,10,153
153746,2,1,163,10,153
153764,1,999,298,11,287
153764,2,1,298,11,287
153773,1,999,132,9,123
153773,2,1,132,9,123
153782,1,999,231,4,227
153782,2,1,231,4,227
153825,1,999,1702,837,865
153825,2,1,1601,811,790
153825,4,3,101,26,75
153834,1,999,2547,1100,1447
153834,2,1,2547,1100,1447
153861,1,999,1574,1090,484
153861,2,1,477,260,217
153861,4,3,1097,830,267
153922,1,999,3008,1201,1807
153922,2,1,3008,1201,1807
153977,1,999,1032,164,868
153977,2,1,1032,164,868
154004,1,999,2859,948,1911
154004,2,1,1411,669,742
154004,4,3,1448,279,1169
154013,1,999,1996,613,1383
154013,2,1,1705,520,1185
154013,4,3,291,93,198
154022,1,999,157752,50045,107707
154022,2,1,143673,45928,97745
154022,4,3,14079,4117,9962
154059,1,999,4994,2195,2799
154059,2,1,4994,2195,2799
154095,1,999,16210,6465,9745
154095,2,1,13018,5552,7466
154095,4,3,3192,913,2279
154101,1,999,1282,525,757
154101,2,1,1282,525,757
154110,1,999,7490,2947,4543
154110,2,1,7490,2947,4543
154129,1,999,2476,1060,1416
154129,2,1,2476,1060,1416
154156,1,999,1955,851,1104
154156,4,3,1955,851,1104
154165,1,999,107,4,103
154165,2,1,107,4,103
154174,1,999,2745,1749,996
154174,2,1,77,41,36
154174,4,3,2668,1708,960
154208,1,999,118,7,111
154208,2,1,118,7,111
154235,1,999,3954,1521,2433
154235,2,1,3000,1195,1805
154235,4,3,954,326,628
154262,1,999,212,19,193
154262,2,1,212,19,193
154332,1,999,110,9,101
154332,2,1,110,9,101
154341,1,999,172,9,163
154341,2,1,172,9,163
154350,1,999,2290,1018,1272
154350,2,1,2209,990,1219
154350,4,3,81,28,53
154378,1,999,5004,1971,3033
154378,2,1,5004,1971,3033
154396,1,999,2335,909,1426
154396,2,1,2335,909,1426
154448,1,999,289,8,281
154448,2,1,289,8,281
154457,1,999,87,2,85
154457,2,1,87,2,85
154466,1,999,92,2,90
154466,2,1,92,2,90
154493,1,999,8638,3383,5255
154493,2,1,7738,3071,4667
154493,4,3,900,312,588
154518,1,999,1047,662,385
154518,2,1,1047,662,385
154527,1,999,1862,875,987
154527,2,1,1862,875,987
154536,1,999,171,83,88
154536,4,3,171,83,88
154545,1,999,79,15,64
154545,2,1,79,15,64
154572,1,999,8802,3624,5178
154572,2,1,8802,3624,5178
154590,1,999,2298,1057,1241
154590,2,1,1999,964,1035
154590,4,3,299,93,206
154642,1,999,4888,1703,3185
154642,2,1,4888,1703,3185
154651,1,999,64,54,10
154651,2,1,64,54,10
154688,1,999,5029,2019,3010
154688,2,1,2814,1230,1584
154688,4,3,2215,789,1426
154697,1,999,13683,8156,5527
154697,2,1,13683,8156,5527
154712,1,999,2256,1018,1238
154712,2,1,2180,977,1203
154712,4,3,76,41,35
154721,1,999,636,321,315
154721,2,1,636,321,315
154749,1,999,544,276,268
154749,2,1,544,276,268
154767,1,999,1124,156,968
154767,2,1,1124,156,968
154776,1,999,1006,228,778
154776,2,1,1006,228,778
154794,1,999,291,72,219
154794,2,1,291,72,219
154800,1,999,14403,6016,8387
154800,2,1,14403,6016,8387
154837,1,999,137,72,65
154837,2,1,10,8,2
154837,4,3,127,64,63
154855,1,999,560,292,268
154855,2,1,560,292,268
154907,1,999,4477,1762,2715
154907,2,1,4477,1762,2715
154925,1,999,2887,1296,1591
154925,2,1,2887,1296,1591
154934,1,999,2073,710,1363
154934,2,1,2073,710,1363
154943,1,999,327,7,320
154943,2,1,327,7,320
154952,1,999,6548,2494,4054
154952,2,1,6548,2494,4054
154970,1,999,194,10,184
154970,2,1,194,10,184
154998,1,999,2798,1174,1624
154998,2,1,2798,1174,1624
155007,1,999,982,315,667
155007,2,1,982,315,667
155025,1,999,7771,2753,5018
155025,2,1,4498,1751,2747
155025,4,3,3273,1002,2271
155052,1,999,1054,527,527
155052,2,1,1054,527,527
155061,1,999,14698,6145,8553
155061,2,1,12138,5259,6879
155061,4,3,2560,886,1674
155070,1,999,261,129,132
155070,2,1,261,129,132
155089,1,999,3847,1608,2239
155089,2,1,2808,1210,1598
155089,4,3,1039,398,641
155098,1,999,3408,1749,1659
155098,2,1,3408,1749,1659
155104,1,999,3172,1571,1601
155104,2,1,3172,1571,1601
155140,1,999,1159,581,578
155140,2,1,1159,581,578
155159,1,999,116,5,111
155159,2,1,116,5,111
155177,1,999,489,203,286
155177,2,1,489,203,286
155186,1,999,5801,2193,3608
155186,2,1,5801,2193,3608
155195,1,999,9643,4063,5580
155195,2,1,9643,4063,5580
155201,1,999,1802,737,1065
155201,2,1,1802,737,1065
155210,1,999,32597,15430,17167
155210,2,1,32597,15430,17167
155283,1,999,829,73,756
155283,2,1,829,73,756
155292,1,999,11017,4306,6711
155292,2,1,11017,4306,6711
155317,1,999,32343,15723,16620
155317,2,1,22369,11409,10960
155317,4,3,9974,4314,5660
155335,1,999,3957,1354,2603
155335,2,1,2823,1024,1799
155335,4,3,1134,330,804
155353,1,999,94,83,11
155353,2,1,94,83,11
155399,1,999,26649,13320,13329
155399,2,1,21077,10919,10158
155399,4,3,5572,2401,3171
155414,1,999,1004,442,562
155414,2,1,934,404,530
155414,4,3,70,38,32
155423,1,999,1303,625,678
155423,2,1,1303,625,678
155441,1,999,120,6,114
155441,2,1,120,6,114
155450,1,999,3566,1356,2210
155450,2,1,3566,1356,2210
155487,1,999,872,409,463
155487,2,1,872,409,463
155496,1,999,489,277,212
155496,2,1,489,277,212
155511,1,999,791,454,337
155511,2,1,791,454,337
155520,1,999,2766,1025,1741
155520,2,1,1702,716,986
155520,4,3,1064,309,755
155566,1,999,3836,1257,2579
155566,2,1,3836,1257,2579
155593,1,999,1104,661,443
155593,2,1,1104,661,443
155618,1,999,445,304,141
155618,2,1,445,304,141
155627,1,999,607,343,264
155627,2,1,596,336,260
155627,4,3,11,7,4
155636,1,999,1371,384,987
155636,2,1,501,164,337
155636,4,3,870,220,650
155681,1,999,8900,4381,4519
155681,2,1,6794,3660,3134
155681,4,3,2106,721,1385
155715,1,999,2719,1191,1528
155715,2,1,2719,1191,1528
155812,1,999,1427,480,947
155812,2,1,979,361,618
155812,4,3,448,119,329
155830,1,999,1083,559,524
155830,2,1,1083,559,524
155858,1,999,2582,1030,1552
155858,2,1,2582,1030,1552
155867,1,999,118,4,114
155867,2,1,118,4,114
155900,1,999,3342,1845,1497
155900,2,1,2675,1563,1112
155900,4,3,667,282,385
155937,1,999,780,427,353
155937,2,1,780,427,353
155973,1,999,789,406,383
155973,2,1,763,395,368
155973,4,3,26,11,15
156082,1,999,8593,3461,5132
156082,2,1,7511,2996,4515
156082,4,3,1082,465,617
156107,1,999,3778,1558,2220
156107,2,1,3778,1558,2220
156125,1,999,18656,8437,10219
156125,2,1,14787,6780,8007
156125,4,3,3869,1657,2212
156134,1,999,2810,1496,1314
156134,2,1,2810,1496,1314
156189,1,999,630,307,323
156189,2,1,630,307,323
156213,1,999,1799,660,1139
156213,2,1,1601,614,987
156213,4,3,198,46,152
156222,1,999,1896,1239,657
156222,4,3,1896,1239,657
156231,1,999,6175,2851,3324
156231,2,1,6175,2851,3324
156277,1,999,115,11,104
156277,2,1,115,11,104
156286,1,999,3889,1334,2555
156286,2,1,2901,989,1912
156286,4,3,988,345,643
156295,1,999,1678,703,975
156295,2,1,1678,703,975
156310,1,999,845,39,806
156310,2,1,845,39,806
156338,1,999,7567,4379,3188
156338,2,1,7567,4379,3188
156356,1,999,810,315,495
156356,2,1,762,294,468
156356,4,3,48,21,27
156365,1,999,4154,1747,2407
156365,2,1,3468,1468,2000
156365,4,3,686,279,407
156392,1,999,19628,8150,11478
156392,2,1,19628,8150,11478
156408,1,999,1261,589,672
156408,2,1,1261,589,672
156417,1,999,198,156,42
156417,2,1,198,156,42
156426,1,999,252,23,229
156426,2,1,252,23,229
156444,1,999,26,4,22
156444,2,1,26,4,22
156471,1,999,1503,282,1221
156471,2,1,1503,282,1221
156541,1,999,4209,1634,2575
156541,2,1,1777,883,894
156541,4,3,2432,751,1681
156620,1,999,19299,8232,11067
156620,2,1,16311,7144,9167
156620,4,3,2988,1088,1900
156648,1,999,11430,5145,6285
156648,2,1,11430,5145,6285
156675,1,999,80,2,78
156675,2,1,80,2,78
156727,1,999,1393,73,1320
156727,4,3,1393,73,1320
156745,1,999,2188,792,1396
156745,2,1,1381,615,766
156745,4,3,807,177,630
156754,1,999,131,6,125
156754,2,1,131,6,125
156790,1,999,6062,3091,2971
156790,2,1,6062,3091,2971
156842,1,999,376,30,346
156842,2,1,376,30,346
156851,1,999,3417,1447,1970
156851,2,1,3417,1447,1970
156860,1,999,5511,1706,3805
156860,2,1,5511,1706,3805
156903,1,999,532,112,420
156903,2,1,532,112,420
156921,1,999,22004,9833,12171
156921,2,1,22004,9833,12171
156949,1,999,26,2,24
156949,2,1,26,2,24
156967,1,999,182,17,165
156967,2,1,182,17,165
157021,1,999,4063,928,3135
157021,2,1,4063,928,3135
157030,1,999,102,51,51
157030,2,1,102,51,51
157058,1,999,3462,1459,2003
157058,2,1,3147,1305,1842
157058,4,3,315,154,161
157076,1,999,836,433,403
157076,2,1,836,433,403
157085,1,999,29633,14393,15240
157085,2,1,21549,10935,10614
157085,4,3,8084,3458,4626
157100,1,999,645,344,301
157100,2,1,588,302,286
157100,4,3,57,42,15
157207,1,999,86,40,46
157207,4,3,86,40,46
157216,1,999,2983,1057,1926
157216,2,1,2302,916,1386
157216,4,3,681,141,540
157270,1,999,1016,716,300
157270,2,1,1016,716,300
157289,1,999,24366,11628,12738
157289,2,1,17897,8753,9144
157289,4,3,6469,2875,3594
157298,1,999,249,107,142
157298,4,3,249,107,142
157304,1,999,6823,3410,3413
157304,2,1,6823,3410,3413
157331,1,999,6752,2993,3759
157331,2,1,6752,2993,3759
157359,1,999,2593,997,1596
157359,2,1,2487,958,1529
157359,4,3,106,39,67
157377,1,999,2149,417,1732
157377,2,1,2023,361,1662
157377,4,3,126,56,70
157386,1,999,10789,4024,6765
157386,2,1,8530,3223,5307
157386,4,3,2259,801,1458
157395,1,999,45,1,44
157395,2,1,45,1,44
157401,1,999,12158,4889,7269
157401,2,1,9441,3973,5468
157401,4,3,2717,916,1801
157438,1,999,6743,3197,3546
157438,2,1,6743,3197,3546
157447,1,999,18347,7922,10425
157447,2,1,15530,6878,8652
157447,4,3,2817,1044,1773
157456,1,999,37,0,37
157456,2,1,37,0,37
157465,1,999,654,122,532
157465,2,1,654,122,532
157483,1,999,10706,5383,5323
157483,2,1,10706,5383,5323
157508,1,999,106,2,104
157508,2,1,106,2,104
157535,1,999,1452,794,658
157535,2,1,1148,632,516
157535,4,3,304,162,142
157553,1,999,7690,4028,3662
157553,2,1,7690,4028,3662
157599,1,999,4002,1017,2985
157599,2,1,4002,1017,2985
157614,1,999,250,13,237
157614,2,1,250,13,237
157632,1,999,952,298,654
157632,2,1,952,298,654
157650,1,999,343,10,333
157650,2,1,343,10,333
157669,1,999,263,18,245
157669,2,1,263,18,245
157678,1,999,298,11,287
157678,2,1,298,11,287
157696,1,999,1580,390,1190
157696,2,1,1580,390,1190
157711,1,999,12445,5110,7335
157711,2,1,12445,5110,7335
157739,1,999,7142,4157,2985
157739,2,1,7142,4157,2985
157748,1,999,4061,3140,921
157748,2,1,901,409,492
157748,4,3,3160,2731,429
157757,1,999,2596,644,1952
157757,2,1,1473,392,1081
157757,4,3,1123,252,871
157766,1,999,1804,238,1566
157766,2,1,1804,238,1566
157793,1,999,6849,2822,4027
157793,2,1,5648,2235,3413
157793,4,3,1201,587,614
157809,1,999,2263,1067,1196
157809,2,1,2065,963,1102
157809,4,3,198,104,94
157818,1,999,1125,452,673
157818,2,1,1125,452,673
157827,1,999,132,19,113
157827,2,1,132,19,113
157863,1,999,1874,806,1068
157863,2,1,953,508,445
157863,4,3,921,298,623
157951,1,999,25273,10220,15053
157951,2,1,21007,8888,12119
157951,4,3,4266,1332,2934
158088,1,999,4719,2697,2022
158088,2,1,4719,2697,2022
158158,1,999,113,56,57
158158,2,1,113,56,57
158246,1,999,565,173,392
158246,2,1,565,173,392
158325,1,999,113,22,91
158325,2,1,113,22,91
158334,1,999,11,3,8
158334,2,1,11,3,8
158343,1,999,73,40,33
158343,2,1,73,40,33
158352,1,999,5978,3317,2661
158352,2,1,5978,3317,2661
158431,1,999,9510,3342,6168
158431,2,1,9510,3342,6168
158440,1,999,173,6,167
158440,2,1,173,6,167
158477,1,999,937,390,547
158477,2,1,808,349,459
158477,4,3,129,41,88
158538,1,999,62,3,59
158538,2,1,62,3,59
158617,1,999,2812,1283,1529
158617,2,1,2812,1283,1529
158644,1,999,122,3,119
158644,2,1,122,3,119
158662,1,999,26924,9609,17315
158662,2,1,26924,9609,17315
158723,1,999,593,60,533
158723,2,1,593,60,533
158769,1,999,3026,1356,1670
158769,2,1,3026,1356,1670
158778,1,999,69,1,68
158778,2,1,69,1,68
158787,1,999,138,1,137
158787,2,1,138,1,137
158802,1,999,1383,385,998
158802,2,1,1383,385,998
158884,1,999,3446,1155,2291
158884,2,1,3446,1155,2291
159009,1,999,5759,2229,3530
159009,2,1,5019,2038,2981
159009,4,3,740,191,549
159027,1,999,88,5,83
159027,2,1,88,5,83
159197,1,999,752,641,111
159197,2,1,752,641,111
159319,1,999,55,6,49
159319,2,1,55,6,49
159328,1,999,186,8,178
159328,2,1,186,8,178
159373,1,999,3051,1025,2026
159373,2,1,1010,158,852
159373,4,3,2041,867,1174
159382,1,999,3309,941,2368
159382,2,1,3309,941,2368
159391,1,999,32013,15722,16291
159391,2,1,25435,12507,12928
159391,4,3,6578,3215,3363
159407,1,999,4330,1382,2948
159407,2,1,4330,1382,2948
159416,1,999,5678,2197,3481
159416,2,1,5062,1969,3093
159416,4,3,616,228,388
159443,1,999,6219,2870,3349
159443,2,1,6219,2870,3349
159513,1,999,123,4,119
159513,2,1,123,4,119
159522,1,999,99,4,95
159522,2,1,99,4,95
159531,1,999,84,2,82
159531,2,1,84,2,82
159568,1,999,2118,887,1231
159568,2,1,1202,599,603
159568,4,3,916,288,628
159601,1,999,47,7,40
159601,2,1,47,7,40
159647,1,999,13866,6482,7384
159647,2,1,10614,5418,5196
159647,4,3,3252,1064,2188
159656,1,999,5545,2137,3408
159656,2,1,3319,1424,1895
159656,4,3,2226,713,1513
159717,1,999,10410,3986,6424
159717,2,1,8956,3563,5393
159717,4,3,1454,423,1031
159939,1,999,13832,6464,7368
159939,2,1,10185,5013,5172
159939,4,3,3647,1451,2196
159948,1,999,2996,2328,668
159948,2,1,1220,959,261
159948,4,3,1776,1369,407
159966,1,999,8538,3072,5466
159966,2,1,7444,2795,4649
159966,4,3,1094,277,817
159993,1,999,10548,3790,6758
159993,2,1,8680,3206,5474
159993,4,3,1868,584,1284
160010,1,999,4622,2371,2251
160010,2,1,4622,2371,2251
160029,1,999,145,120,25
160029,4,3,145,120,25
160038,1,999,11688,3526,8162
160038,2,1,9962,3170,6792
160038,4,3,1726,356,1370
160065,1,999,1609,282,1327
160065,2,1,1181,197,984
160065,4,3,428,85,343
160074,1,999,2270,383,1887
160074,2,1,2101,325,1776
160074,4,3,169,58,111
160117,1,999,55,4,51
160117,2,1,55,4,51
160126,1,999,38,4,34
160126,2,1,38,4,34
160135,1,999,63,3,60
160135,2,1,63,3,60
160199,1,999,98,7,91
160199,2,1,98,7,91
160320,1,999,694,28,666
160320,2,1,694,28,666
160409,1,999,77,75,2
160409,2,1,77,75,2
160445,1,999,214,14,200
160445,2,1,214,14,200
160472,1,999,84,9,75
160472,2,1,84,9,75
160481,1,999,4314,2164,2150
160481,2,1,4314,2164,2150
160524,1,999,731,166,565
160524,2,1,731,166,565
160579,1,999,3650,2050,1600
160579,2,1,3650,2050,1600
160597,1,999,160,68,92
160597,2,1,160,68,92
160612,1,999,18497,6987,11510
160612,2,1,16443,6491,9952
160612,4,3,2054,496,1558
160621,1,999,8557,3155,5402
160621,2,1,7052,2745,4307
160621,4,3,1505,410,1095
160630,1,999,3977,1052,2925
160630,2,1,3279,919,2360
160630,4,3,698,133,565
160649,1,999,3993,1056,2937
160649,2,1,3993,1056,2937
160658,1,999,18914,8025,10889
160658,2,1,17125,7219,9906
160658,4,3,1789,806,983
160667,1,999,4706,2534,2172
160667,2,1,4706,2534,2172
160755,1,999,14037,6417,7620
160755,2,1,8701,3732,4969
160755,4,3,5336,2685,2651
160904,1,999,3725,1062,2663
160904,2,1,2951,847,2104
160904,4,3,774,215,559
160913,1,999,7532,5186,2346
160913,2,1,7532,5186,2346
160940,1,999,1775,371,1404
160940,2,1,1775,371,1404
160959,1,999,479,146,333
160959,2,1,403,121,282
160959,4,3,76,25,51
160968,1,999,114,27,87
160968,2,1,3,1,2
160968,4,3,111,26,85
160977,1,999,1862,856,1006
160977,2,1,1862,856,1006
160995,1,999,837,181,656
160995,2,1,837,181,656
161004,1,999,1910,938,972
161004,2,1,1910,938,972
161022,1,999,270,45,225
161022,2,1,270,45,225
161077,1,999,3739,1737,2002
161077,2,1,3739,1737,2002
161086,1,999,2002,905,1097
161086,2,1,2002,905,1097
161138,1,999,3252,1706,1546
161138,2,1,3252,1706,1546
161165,1,999,3516,1397,2119
161165,2,1,2811,1160,1651
161165,4,3,705,237,468
161192,1,999,3746,1347,2399
161192,2,1,3746,1347,2399
161208,1,999,69,66,3
161208,2,1,69,66,3
161217,1,999,6693,1883,4810
161217,2,1,6669,1875,4794
161217,4,3,24,8,16
161226,1,999,2550,879,1671
161226,2,1,2462,869,1593
161226,4,3,88,10,78
161235,1,999,1701,533,1168
161235,2,1,1701,533,1168
161244,1,999,1414,397,1017
161244,2,1,1414,397,1017
161253,1,999,13369,6224,7145
161253,2,1,10509,5243,5266
161253,4,3,2860,981,1879
161299,1,999,1079,896,183
161299,2,1,1059,882,177
161299,4,3,20,14,6
161341,1,999,2089,684,1405
161341,2,1,2089,684,1405
161457,1,999,7469,2200,5269
161457,2,1,4312,1380,2932
161457,4,3,3157,820,2337
161484,1,999,1548,811,737
161484,2,1,1548,811,737
161493,1,999,645,34,611
161493,2,1,645,34,611
161509,1,999,370,113,257
161509,2,1,321,100,221
161509,4,3,49,13,36
161518,1,999,3724,1052,2672
161518,2,1,2167,658,1509
161518,4,3,1557,394,1163
161527,1,999,216,7,209
161527,2,1,216,7,209
161545,1,999,9354,4674,4680
161545,2,1,9354,4674,4680
161554,1,999,12553,4945,7608
161554,2,1,9574,4080,5494
161554,4,3,2979,865,2114
161563,1,999,1221,547,674
161563,2,1,973,460,513
161563,4,3,248,87,161
161572,1,999,611,296,315
161572,2,1,611,296,315
161581,1,999,687,296,391
161581,2,1,687,296,391
161615,1,999,84,2,82
161615,2,1,84,2,82
161651,1,999,76,4,72
161651,2,1,76,4,72
161688,1,999,5004,1680,3324
161688,2,1,5004,1680,3324
161767,1,999,25941,9956,15985
161767,2,1,25941,9956,15985
161776,1,999,790,198,592
161776,2,1,790,198,592
161800,1,999,345,15,330
161800,2,1,345,15,330
161855,1,999,124,7,117
161855,2,1,124,7,117
161864,1,999,10373,3136,7237
161864,2,1,10373,3136,7237
161873,1,999,7581,3261,4320
161873,2,1,3778,1650,2128
161873,4,3,3803,1611,2192
161882,1,999,710,346,364
161882,2,1,684,333,351
161882,4,3,26,13,13
162007,1,999,6220,2297,3923
162007,2,1,4890,1883,3007
162007,4,3,1330,414,916
162061,1,999,1035,821,214
162061,2,1,425,338,87
162061,4,3,610,483,127
162104,1,999,3275,1228,2047
162104,2,1,3275,1228,2047
162122,1,999,12035,4480,7555
162122,2,1,12035,4480,7555
162168,1,999,3956,1301,2655
162168,2,1,3956,1301,2655
162210,1,999,1491,464,1027
162210,2,1,1285,414,871
162210,4,3,206,50,156
162283,1,999,4760,1150,3610
162283,2,1,4005,985,3020
162283,4,3,755,165,590
162335,1,999,134,4,130
162335,2,1,134,4,130
162371,1,999,1076,1063,13
162371,2,1,1076,1063,13
162557,1,999,9095,3700,5395
162557,2,1,9095,3700,5395
162584,1,999,6244,3055,3189
162584,2,1,5385,2752,2633
162584,4,3,859,303,556
162609,1,999,999,468,531
162609,2,1,999,468,531
162654,1,999,3090,887,2203
162654,2,1,1560,497,1063
162654,4,3,1530,390,1140
162681,1,999,1568,437,1131
162681,2,1,1568,437,1131
162690,1,999,6850,2720,4130
162690,2,1,6850,2720,4130
162706,1,999,9529,3753,5776
162706,2,1,9529,3753,5776
162760,1,999,2828,918,1910
162760,2,1,1590,535,1055
162760,4,3,1238,383,855
162779,1,999,12594,5390,7204
162779,2,1,12594,5390,7204
162830,1,999,85,2,83
162830,2,1,85,2,83
162928,1,999,25376,12182,13194
162928,2,1,6585,3237,3348
162928,4,3,18791,8945,9846
162982,1,999,288,121,167
162982,2,1,288,121,167
163028,1,999,2200,2005,195
163028,2,1,2200,2005,195
163046,1,999,6748,2592,4156
163046,2,1,3906,1585,2321
163046,4,3,2842,1007,1835
163107,1,999,44,2,42
163107,2,1,44,2,42
163204,1,999,59200,27280,31920
163204,2,1,39062,18260,20802
163204,4,3,20138,9020,11118
163259,1,999,7025,1965,5060
163259,2,1,922,149,773
163259,4,3,6103,1816,4287
163268,1,999,14756,7808,6948
163268,2,1,11382,6235,5147
163268,4,3,3374,1573,1801
163286,1,999,43316,22747,20569
163286,2,1,31252,16371,14881
163286,4,3,12064,6376,5688
163295,1,999,2639,788,1851
163295,2,1,2400,706,1694
163295,4,3,239,82,157
163338,1,999,5090,2193,2897
163338,2,1,4372,1911,2461
163338,4,3,718,282,436
163347,1,999,1840,122,1718
163347,2,1,1840,122,1718
163408,1,999,256,9,247
163408,2,1,256,9,247
163426,1,999,37390,17040,20350
163426,2,1,37390,17040,20350
163453,1,999,8761,3816,4945
163453,2,1,7364,3268,4096
163453,4,3,1397,548,849
163462,1,999,2376,1133,1243
163462,2,1,1754,758,996
163462,4,3,622,375,247
163532,1,999,710,710,0
163532,2,1,433,433,0
163532,4,3,277,277,0
163541,1,999,733,15,718
163541,2,1,733,15,718
163578,1,999,3815,571,3244
163578,2,1,1512,101,1411
163578,4,3,2303,470,1833
163657,1,999,21141,7828,13313
163657,2,1,21141,7828,13313
163736,1,999,1418,579,839
163736,2,1,1418,579,839
163754,1,999,141,4,137
163754,2,1,141,4,137
163815,1,999,130,7,123
163815,2,1,130,7,123
163842,1,999,277,162,115
163842,2,1,6,6,0
163842,4,3,271,156,115
163851,1,999,9383,4011,5372
163851,2,1,8487,3726,4761
163851,4,3,896,285,611
163912,1,999,2113,870,1243
163912,2,1,2076,857,1219
163912,4,3,37,13,24
163921,1,999,2022,231,1791
163921,2,1,1934,212,1722
163921,4,3,88,19,69
163976,1,999,589,325,264
163976,2,1,476,252,224
163976,4,3,113,73,40
164058,1,999,1090,624,466
164058,2,1,1090,624,466
164076,1,999,25648,9742,15906
164076,2,1,19934,8136,11798
164076,4,3,5714,1606,4108
164085,1,999,617,94,523
164085,4,3,617,94,523
164100,1,999,137,34,103
164100,2,1,137,34,103
164155,1,999,5885,4705,1180
164155,2,1,5885,4705,1180
164173,1,999,4519,1441,3078
164173,2,1,4016,1306,2710
164173,4,3,503,135,368
164207,1,999,678,366,312
164207,2,1,358,192,166
164207,4,3,320,174,146
164216,1,999,1549,651,898
164216,2,1,1477,621,856
164216,4,3,72,30,42
164243,1,999,250,162,88
164243,4,3,250,162,88
164270,1,999,4784,1535,3249
164270,2,1,2015,900,1115
164270,4,3,2769,635,2134
164313,1,999,5539,2022,3517
164313,2,1,5539,2022,3517
164438,1,999,1212,356,856
164438,2,1,1062,296,766
164438,4,3,150,60,90
164447,1,999,4309,1341,2968
164447,2,1,1910,810,1100
164447,4,3,2399,531,1868
164465,1,999,1905,934,971
164465,2,1,1905,934,971
164474,1,999,366,131,235
164474,4,3,366,131,235
164492,1,999,1767,874,893
164492,2,1,1194,598,596
164492,4,3,573,276,297
164535,1,999,42,2,40
164535,2,1,42,2,40
164562,1,999,3078,1127,1951
164562,2,1,2452,979,1473
164562,4,3,626,148,478
164580,1,999,3959,2526,1433
164580,2,1,2000,1153,847
164580,4,3,1959,1373,586
164599,1,999,102,11,91
164599,2,1,102,11,91
164614,1,999,141,68,73
164614,2,1,141,68,73
164632,1,999,2561,94,2467
164632,2,1,1693,0,1693
164632,4,3,868,94,774
164641,1,999,1481,429,1052
164641,2,1,1481,429,1052
164678,1,999,436,429,7
164678,2,1,436,429,7
164720,1,999,2081,690,1391
164720,2,1,2081,690,1391
164739,1,999,6092,3497,2595
164739,2,1,4367,2596,1771
164739,4,3,1725,901,824
164748,1,999,4670,3290,1380
164748,2,1,4670,3290,1380
164775,1,999,3497,1371,2126
164775,2,1,3497,1371,2126
164845,1,999,452,43,409
164845,2,1,452,43,409
164872,1,999,1721,926,795
164872,2,1,1166,621,545
164872,4,3,555,305,250
164915,1,999,180,56,124
164915,4,3,180,56,124
164924,1,999,16674,7599,9075
164924,2,1,10407,5050,5357
164924,4,3,6267,2549,3718
164933,1,999,713,288,425
164933,2,1,516,217,299
164933,4,3,197,71,126
164988,1,999,40968,17744,23224
164988,2,1,23544,9780,13764
164988,4,3,17424,7964,9460
165015,1,999,6271,2943,3328
165015,2,1,3608,1570,2038
165015,4,3,2663,1373,1290
165024,1,999,13561,5121,8440
165024,2,1,10592,4347,6245
165024,4,3,2969,774,2195
165033,1,999,12123,4668,7455
165033,2,1,12123,4668,7455
165060,1,999,351,31,320
165060,2,1,351,31,320
165112,1,999,17853,7801,10052
165112,2,1,17853,7801,10052
165167,1,999,6008,1675,4333
165167,2,1,1752,582,1170
165167,4,3,4256,1093,3163
165194,1,999,6530,2599,3931
165194,2,1,6530,2599,3931
165255,1,999,343,2,341
165255,2,1,343,2,341
165264,1,999,826,81,745
165264,2,1,826,81,745
165334,1,999,3869,1630,2239
165334,2,1,2498,1003,1495
165334,4,3,1371,627,744
165495,1,999,18,4,14
165495,4,3,18,4,14
165529,1,999,3458,1377,2081
165529,2,1,3053,1230,1823
165529,4,3,405,147,258
165556,1,999,1221,398,823
165556,2,1,1221,398,823
165574,1,999,1643,795,848
165574,2,1,1643,795,848
165608,1,999,86,11,75
165608,2,1,86,11,75
165635,1,999,338,322,16
165635,2,1,338,322,16
165644,1,999,1257,467,790
165644,2,1,1022,409,613
165644,4,3,235,58,177
165662,1,999,4804,1734,3070
165662,2,1,3857,1489,2368
165662,4,3,947,245,702
165671,1,999,2920,717,2203
165671,2,1,2519,619,1900
165671,4,3,401,98,303
165699,1,999,8003,2124,5879
165699,2,1,2662,1181,1481
165699,4,3,5341,943,4398
165705,1,999,104,30,74
165705,4,3,104,30,74
165750,1,999,175,71,104
165750,2,1,175,71,104
165802,1,999,2716,654,2062
165802,2,1,2716,654,2062
165820,1,999,11784,3790,7994
165820,2,1,4965,2286,2679
165820,4,3,6819,1504,5315
165866,1,999,10410,2766,7644
165866,2,1,4978,1848,3130
165866,4,3,5432,918,4514
165884,1,999,773,641,132
165884,2,1,773,641,132
165936,1,999,2095,727,1368
165936,2,1,1604,623,981
165936,4,3,491,104,387
165945,1,999,2417,1729,688
165945,4,3,2417,1729,688
165981,1,999,3309,1318,1991
165981,2,1,3309,1318,1991
166009,1,999,161,44,117
166009,2,1,161,44,117
166018,1,999,1600,653,947
166018,2,1,1600,653,947
166027,1,999,34342,17271,17071
166027,2,1,14148,6785,7363
166027,4,3,20194,10486,9708
166045,1,999,301,98,203
166045,2,1,12,6,6
166045,4,3,289,92,197
166054,1,999,243,191,52
166054,2,1,84,47,37
166054,4,3,159,144,15
166063,1,999,75,3,72
166063,2,1,75,3,72
166124,1,999,2991,1378,1613
166124,2,1,2991,1378,1613
166133,1,999,9741,3690,6051
166133,2,1,9741,3690,6051
166276,1,999,567,130,437
166276,2,1,567,130,437
166294,1,999,109,4,105
166294,2,1,109,4,105
166319,1,999,103,1,102
166319,2,1,103,1,102
166328,1,999,66,5,61
166328,2,1,66,5,61
166391,1,999,1943,667,1276
166391,2,1,1677,586,1091
166391,4,3,266,81,185
166407,1,999,358,49,309
166407,2,1,358,49,309
166452,1,999,8566,1462,7104
166452,2,1,2329,571,1758
166452,4,3,6237,891,5346
166489,1,999,262,94,168
166489,2,1,51,24,27
166489,4,3,211,70,141
166498,1,999,137,9,128
166498,2,1,137,9,128
166513,1,999,18354,10465,7889
166513,2,1,13854,8270,5584
166513,4,3,4500,2195,2305
166586,1,999,77,9,68
166586,2,1,77,9,68
166595,1,999,125,3,122
166595,2,1,125,3,122
166601,1,999,284,75,209
166601,2,1,284,75,209
166629,1,999,31417,15617,15800
166629,2,1,24274,12046,12228
166629,4,3,7143,3571,3572
166638,1,999,20210,8019,12191
166638,2,1,15023,6476,8547
166638,4,3,5187,1543,3644
166647,1,999,8207,3367,4840
166647,2,1,8207,3367,4840
166656,1,999,5025,1593,3432
166656,2,1,1812,451,1361
166656,4,3,3213,1142,2071
166674,1,999,3292,1080,2212
166674,2,1,3038,995,2043
166674,4,3,254,85,169
166683,1,999,11271,7165,4106
166683,2,1,4386,2404,1982
166683,4,3,6885,4761,2124
166692,1,999,1417,1261,156
166692,2,1,1319,1185,134
166692,4,3,98,76,22
166708,1,999,1185,461,724
166708,4,3,1185,461,724
166717,1,999,554,119,435
166717,4,3,554,119,435
166805,1,999,158,130,28
166805,2,1,158,130,28
166823,1,999,11685,5032,6653
166823,2,1,11685,5032,6653
166850,1,999,2657,1272,1385
166850,2,1,2476,1247,1229
166850,4,3,181,25,156
166869,1,999,1907,279,1628
166869,2,1,643,90,553
166869,4,3,1264,189,1075
166887,1,999,13267,5616,7651
166887,2,1,13267,5616,7651
166911,1,999,368,95,273
166911,2,1,368,95,273
166939,1,999,2554,8,2546
166939,2,1,2460,4,2456
166939,4,3,94,4,90
166948,1,999,1555,529,1026
166948,2,1,1534,523,1011
166948,4,3,21,6,15
166957,1,999,6923,2527,4396
166957,2,1,6923,2527,4396
166975,1,999,422,100,322
166975,2,1,422,100,322
166984,1,999,790,245,545
166984,2,1,640,203,437
166984,4,3,150,42,108
167020,1,999,1005,99,906
167020,2,1,1005,99,906
167039,1,999,34,2,32
167039,2,1,34,2,32
167057,1,999,810,417,393
167057,2,1,414,223,191
167057,4,3,396,194,202
167093,1,999,482,121,361
167093,4,3,482,121,361
167181,1,999,203,45,158
167181,4,3,203,45,158
167215,1,999,1140,493,647
167215,4,3,1140,493,647
167224,1,999,121,41,80
167224,2,1,121,41,80
167251,1,999,1129,450,679
167251,2,1,1129,450,679
167260,1,999,1879,1053,826
167260,2,1,1477,864,613
167260,4,3,402,189,213
167288,1,999,2574,1014,1560
167288,2,1,2028,808,1220
167288,4,3,546,206,340
167297,1,999,165,124,41
167297,2,1,165,124,41
167312,1,999,11184,4522,6662
167312,2,1,11184,4522,6662
167321,1,999,2041,1303,738
167321,2,1,2041,1303,738
167358,1,999,36462,17587,18875
167358,2,1,22693,11209,11484
167358,4,3,13769,6378,7391
167376,1,999,9978,3845,6133
167376,2,1,9978,3845,6133
167394,1,999,1727,349,1378
167394,2,1,1244,296,948
167394,4,3,483,53,430
167455,1,999,505,8,497
167455,2,1,455,0,455
167455,4,3,50,8,42
167464,1,999,66,66,0
167464,4,3,66,66,0
167525,1,999,7594,2508,5086
167525,2,1,7594,2508,5086
167534,1,999,11864,5100,6764
167534,2,1,11864,5100,6764
167543,1,999,936,905,31
167543,2,1,936,905,31
167598,1,999,2274,367,1907
167598,2,1,1430,278,1152
167598,4,3,844,89,755
167631,1,999,3861,1305,2556
167631,2,1,3861,1305,2556
167677,1,999,187,128,59
167677,2,1,37,37,0
167677,4,3,150,91,59
167729,1,999,14149,4816,9333
167729,2,1,9606,3761,5845
167729,4,3,4543,1055,3488
167738,1,999,1502,272,1230
167738,2,1,1502,272,1230
167783,1,999,5721,506,5215
167783,2,1,2077,2,2075
167783,4,3,3644,504,3140
167792,1,999,408,150,258
167792,2,1,408,150,258
167835,1,999,3269,75,3194
167835,2,1,2702,2,2700
167835,4,3,567,73,494
167871,1,999,125,20,105
167871,2,1,125,20,105
167899,1,999,3425,1387,2038
167899,2,1,2165,1098,1067
167899,4,3,1260,289,971
167905,1,999,9235,3950,5285
167905,2,1,9235,3950,5285
167987,1,999,10663,5396,5267
167987,2,1,8595,4483,4112
167987,4,3,2068,913,1155
167996,1,999,2590,999,1591
167996,2,1,2590,999,1591
168005,1,999,10433,4738,5695
168005,2,1,6399,2855,3544
168005,4,3,4034,1883,2151
168032,1,999,86,3,83
168032,2,1,86,3,83
168148,1,999,11451,5186,6265
168148,2,1,5627,2748,2879
168148,4,3,5824,2438,3386
168218,1,999,2636,97,2539
168218,2,1,2636,97,2539
168227,1,999,4003,3248,755
168227,2,1,3877,3157,720
168227,4,3,126,91,35
168254,1,999,4138,2283,1855
168254,2,1,2853,1695,1158
168254,4,3,1285,588,697
168263,1,999,6881,3196,3685
168263,2,1,5804,2819,2985
168263,4,3,1077,377,700
168281,1,999,1655,639,1016
168281,2,1,1655,639,1016
168290,1,999,1533,159,1374
168290,2,1,1017,121,896
168290,4,3,516,38,478
168342,1,999,2252,1076,1176
168342,2,1,2199,1055,1144
168342,4,3,53,21,32
168421,1,999,5724,4116,1608
168421,2,1,3714,2599,1115
168421,4,3,2010,1517,493
168430,1,999,9251,3181,6070
168430,2,1,6420,2644,3776
168430,4,3,2831,537,2294
168519,1,999,28,0,28
168519,2,1,28,0,28
168528,1,999,1729,891,838
168528,2,1,1729,891,838
168546,1,999,1629,786,843
168546,2,1,1629,786,843
168555,1,999,97,0,97
168555,2,1,97,0,97
168573,1,999,941,922,19
168573,2,1,941,922,19
168591,1,999,1445,637,808
168591,2,1,1445,637,808
168607,1,999,2678,1176,1502
168607,2,1,2678,1176,1502
168740,1,999,4573,2525,2048
168740,2,1,2303,1053,1250
168740,4,3,2270,1472,798
168786,1,999,2502,936,1566
168786,2,1,2141,835,1306
168786,4,3,361,101,260
168838,1,999,4569,1730,2839
168838,2,1,4553,1726,2827
168838,4,3,16,4,12
168847,1,999,10211,3535,6676
168847,2,1,10173,3516,6657
168847,4,3,38,19,19
168883,1,999,3215,1292,1923
168883,2,1,3215,1292,1923
168892,1,999,99,5,94
168892,2,1,99,5,94
169080,1,999,4336,1986,2350
169080,2,1,4140,1919,2221
169080,4,3,196,67,129
169099,1,999,310,255,55
169099,4,3,310,255,55
169187,1,999,451,69,382
169187,2,1,451,69,382
169220,1,999,143,33,110
169220,4,3,143,33,110
169248,1,999,33352,14142,19210
169248,2,1,23534,10586,12948
169248,4,3,9818,3556,6262
169275,1,999,17133,7010,10123
169275,2,1,17133,7010,10123
169284,1,999,869,101,768
169284,2,1,869,101,768
169327,1,999,962,397,565
169327,2,1,818,326,492
169327,4,3,144,71,73
169363,1,999,905,384,521
169363,2,1,508,252,256
169363,4,3,397,132,265
169424,1,999,163,74,89
169424,4,3,163,74,89
169442,1,999,1414,747,667
169442,2,1,1370,721,649
169442,4,3,44,26,18
169479,1,999,16031,5665,10366
169479,2,1,13186,4436,8750
169479,4,3,2845,1229,1616
169503,1,999,394,24,370
169503,2,1,394,24,370
169521,1,999,16944,7777,9167
169521,2,1,16944,7777,9167
169576,1,999,180,9,171
169576,2,1,180,9,171
169628,1,999,941,551,390
169628,4,3,941,551,390
169655,1,999,1539,1472,67
169655,2,1,1539,1472,67
169716,1,999,6311,2513,3798
169716,2,1,3552,1219,2333
169716,4,3,2759,1294,1465
169734,1,999,522,68,454
169734,2,1,522,68,454
169761,1,999,591,62,529
169761,2,1,591,62,529
169798,1,999,28511,11697,16814
169798,2,1,21609,9220,12389
169798,4,3,6902,2477,4425
169910,1,999,16908,8228,8680
169910,2,1,15343,7557,7786
169910,4,3,1565,671,894
169947,1,999,79,71,8
169947,2,1,79,71,8
169974,1,999,2026,778,1248
169974,2,1,2026,778,1248
169983,1,999,2638,2107,531
169983,2,1,2080,1703,377
169983,4,3,558,404,154
169992,1,999,1568,643,925
169992,2,1,1568,643,925
170000,1,999,299,170,129
170000,2,1,299,170,129
170037,1,999,3581,1494,2087
170037,2,1,2645,1039,1606
170037,4,3,936,455,481
170046,1,999,1343,161,1182
170046,2,1,1343,161,1182
170055,1,999,25605,12257,13348
170055,2,1,25605,12257,13348
170082,1,999,28824,11612,17212
170082,2,1,23229,9788,13441
170082,4,3,5595,1824,3771
170091,1,999,267,153,114
170091,2,1,267,153,114
170240,1,999,26724,11511,15213
170240,2,1,26724,11511,15213
170301,1,999,3464,1363,2101
170301,2,1,3464,1363,2101
170417,1,999,1543,1152,391
170417,2,1,1543,1152,391
170444,1,999,10637,4158,6479
170444,2,1,10637,4158,6479
170514,1,999,145,8,137
170514,2,1,145,8,137
170532,1,999,1380,600,780
170532,2,1,1380,600,780
170541,1,999,17572,8590,8982
170541,2,1,17572,8590,8982
170550,1,999,13152,5809,7343
170550,2,1,13152,5809,7343
170587,1,999,2741,1102,1639
170587,2,1,2741,1102,1639
170611,1,999,292,5,287
170611,2,1,292,5,287
170620,1,999,6927,2783,4144
170620,2,1,6927,2783,4144
170639,1,999,3099,1462,1637
170639,2,1,2994,1438,1556
170639,4,3,105,24,81
170657,1,999,31462,14452,17010
170657,2,1,31462,14452,17010
170675,1,999,5111,3635,1476
170675,2,1,3405,2556,849
170675,4,3,1706,1079,627
170736,1,999,110,5,105
170736,2,1,110,5,105
170790,1,999,35631,17217,18414
170790,2,1,35631,17217,18414
170806,1,999,6383,1437,4946
170806,2,1,4082,1006,3076
170806,4,3,2301,431,1870
170842,1,999,3407,723,2684
170842,2,1,1126,278,848
170842,4,3,2281,445,1836
170967,1,999,1270,519,751
170967,2,1,1246,504,742
170967,4,3,24,15,9
170976,1,999,44453,23262,21191
170976,2,1,28294,14431,13863
170976,4,3,16159,8831,7328
171012,1,999,328,291,37
171012,2,1,328,291,37
171100,1,999,52567,24607,27960
171100,2,1,39282,18899,20383
171100,4,3,13285,5708,7577
171128,1,999,7605,5573,2032
171128,2,1,6068,4512,1556
171128,4,3,1537,1061,476
171137,1,999,10546,5150,5396
171137,2,1,8419,4006,4413
171137,4,3,2127,1144,983
171146,1,999,9827,3781,6046
171146,2,1,8141,3194,4947
171146,4,3,1686,587,1099
171155,1,999,7585,3173,4412
171155,2,1,7585,3173,4412
171225,1,999,6464,2637,3827
171225,2,1,6464,2637,3827
171234,1,999,2980,1023,1957
171234,2,1,2980,1023,1957
171261,1,999,191,15,176
171261,2,1,191,15,176
171298,1,999,7481,2394,5087
171298,2,1,7451,2390,5061
171298,4,3,30,4,26
171304,1,999,7344,3288,4056
171304,2,1,7344,3288,4056
171313,1,999,1668,203,1465
171313,2,1,1668,203,1465
171322,1,999,2011,395,1616
171322,2,1,2011,395,1616
171395,1,999,4454,1637,2817
171395,2,1,4454,1637,2817
171456,1,999,11185,5420,5765
171456,2,1,9969,4988,4981
171456,4,3,1216,432,784
171465,1,999,71,1,70
171465,2,1,71,1,70
171483,1,999,6645,3051,3594
171483,2,1,6645,3051,3594
171492,1,999,4279,2362,1917
171492,2,1,3829,2112,1717
171492,4,3,450,250,200
171535,1,999,46181,19915,26266
171535,2,1,46181,19915,26266
171571,1,999,23557,8919,14638
171571,2,1,18903,7414,11489
171571,4,3,4654,1505,3149
171599,1,999,1314,692,622
171599,2,1,1241,672,569
171599,4,3,73,20,53
171775,1,999,110,10,100
171775,2,1,110,10,100
171881,1,999,354,162,192
171881,2,1,350,161,189
171881,4,3,4,1,3
171988,1,999,298,21,277
171988,2,1,298,21,277
171997,1,999,296,21,275
171997,2,1,296,21,275
172015,1,999,434,26,408
172015,2,1,434,26,408
172033,1,999,578,359,219
172033,2,1,364,207,157
172033,4,3,214,152,62
172051,1,999,13001,5110,7891
172051,2,1,10776,4515,6261
172051,4,3,2225,595,1630
172200,1,999,21129,9262,11867
172200,2,1,21129,9262,11867
172264,1,999,3207,1271,1936
172264,2,1,2772,1161,1611
172264,4,3,435,110,325
172291,1,999,6944,2943,4001
172291,2,1,6944,2943,4001
172307,1,999,4402,1757,2645
172307,2,1,4402,1757,2645
172325,1,999,1448,941,507
172325,2,1,1448,941,507
172334,1,999,6332,1699,4633
172334,2,1,3692,1130,2562
172334,4,3,2640,569,2071
172422,1,999,536,420,116
172422,2,1,536,420,116
172440,1,999,736,285,451
172440,2,1,736,285,451
172477,1,999,5046,2631,2415
172477,4,3,5046,2631,2415
172495,1,999,239,11,228
172495,2,1,239,11,228
172608,1,999,4585,2299,2286
172608,2,1,1471,733,738
172608,4,3,3114,1566,1548
172617,1,999,22632,11312,11320
172617,2,1,22632,11312,11320
172635,1,999,34698,10440,24258
172635,2,1,34698,10440,24258
172644,1,999,36749,15237,21512
172644,2,1,23991,10120,13871
172644,4,3,12758,5117,7641
172671,1,999,2115,825,1290
172671,2,1,2115,825,1290
172699,1,999,28517,13881,14636
172699,2,1,21788,11134,10654
172699,4,3,6729,2747,3982
172705,1,999,259,162,97
172705,4,3,259,162,97
172802,1,999,65,3,62
172802,2,1,65,3,62
172866,1,999,327,196,131
172866,2,1,327,196,131
172918,1,999,4201,2131,2070
172918,2,1,4201,2131,2070
172927,1,999,179,36,143
172927,2,1,179,36,143
172954,1,999,3531,1322,2209
172954,2,1,3531,1322,2209
172963,1,999,12538,4840,7698
172963,2,1,12538,4840,7698
172972,1,999,80,40,40
172972,2,1,80,40,40
173045,1,999,4935,2007,2928
173045,2,1,3690,1643,2047
173045,4,3,1245,364,881
173063,1,999,5190,2400,2790
173063,2,1,5190,2400,2790
173115,1,999,2360,717,1643
173115,2,1,2360,717,1643
173124,1,999,6870,3107,3763
173124,2,1,6083,2823,3260
173124,4,3,787,284,503
173142,1,999,639,286,353
173142,2,1,639,286,353
173160,1,999,5178,1925,3253
173160,2,1,3978,1501,2477
173160,4,3,1200,424,776
173179,1,999,817,521,296
173179,4,3,817,521,296
173203,1,999,6242,2685,3557
173203,2,1,6242,2685,3557
173258,1,999,2048,996,1052
173258,2,1,2048,996,1052
173300,1,999,2926,1148,1778
173300,2,1,2879,1142,1737
173300,4,3,47,6,41
173328,1,999,3644,1308,2336
173328,2,1,2184,897,1287
173328,4,3,1460,411,1049
173416,1,999,5915,3752,2163
173416,2,1,5915,3752,2163
173452,1,999,1239,560,679
173452,2,1,1166,511,655
173452,4,3,73,49,24
173461,1,999,8606,3983,4623
173461,2,1,8606,3983,4623
173470,1,999,78,3,75
173470,2,1,78,3,75
173489,1,999,558,111,447
173489,2,1,558,111,447
173559,1,999,9208,3712,5496
173559,2,1,9208,3712,5496
173629,1,999,2281,668,1613
173629,2,1,2189,631,1558
173629,4,3,92,37,55
173638,1,999,5343,2442,2901
173638,2,1,5343,2442,2901
173647,1,999,2507,1107,1400
173647,2,1,2507,1107,1400
173665,1,999,8902,2934,5968
173665,2,1,2266,1002,1264
173665,4,3,6636,1932,4704
173683,1,999,165,71,94
173683,4,3,165,71,94
173708,1,999,9751,5637,4114
173708,2,1,9751,5637,4114
173726,1,999,60,4,56
173726,2,1,60,4,56
173735,1,999,2210,1049,1161
173735,2,1,2210,1049,1161
173744,1,999,611,21,590
173744,2,1,611,21,590
173799,1,999,9875,4093,5782
173799,2,1,9875,4093,5782
173805,1,999,1615,850,765
173805,2,1,1615,850,765
173887,1,999,2657,1152,1505
173887,2,1,2657,1152,1505
173896,1,999,915,478,437
173896,4,3,915,478,437
173902,1,999,2161,887,1274
173902,2,1,2161,887,1274
173911,1,999,6148,2961,3187
173911,2,1,6148,2961,3187
173920,1,999,17968,8375,9593
173920,2,1,15117,7312,7805
173920,4,3,2851,1063,1788
173939,1,999,233,7,226
173939,2,1,233,7,226
173957,1,999,282,149,133
173957,4,3,282,149,133
173966,1,999,361,95,266
173966,2,1,159,38,121
173966,4,3,202,57,145
173984,1,999,3453,740,2713
173984,2,1,2444,464,1980
173984,4,3,1009,276,733
173993,1,999,2334,1330,1004
173993,2,1,2334,1330,1004
174020,1,999,10930,4626,6304
174020,2,1,9703,4205,5498
174020,4,3,1227,421,806
174066,1,999,64349,30101,34248
174066,2,1,43476,20384,23092
174066,4,3,20873,9717,11156
174075,1,999,2955,1439,1516
174075,2,1,2955,1439,1516
174118,1,999,413,121,292
174118,2,1,413,121,292
174127,1,999,782,322,460
174127,2,1,720,297,423
174127,4,3,62,25,37
174136,1,999,14573,6801,7772
174136,2,1,14573,6801,7772
174154,1,999,588,49,539
174154,2,1,588,49,539
174190,1,999,340,13,327
174190,2,1,340,13,327
174206,1,999,178,86,92
174206,2,1,178,86,92
174233,1,999,12722,6495,6227
174233,2,1,11442,5969,5473
174233,4,3,1280,526,754
174251,1,999,1972,869,1103
174251,2,1,1972,869,1103
174279,1,999,2655,958,1697
174279,2,1,2501,887,1614
174279,4,3,154,71,83
174321,1,999,186,6,180
174321,2,1,186,6,180
174358,1,999,8917,3679,5238
174358,2,1,8082,3474,4608
174358,4,3,835,205,630
174376,1,999,10717,4596,6121
174376,2,1,10717,4596,6121
174385,1,999,824,212,612
174385,2,1,824,212,612
174394,1,999,1365,827,538
174394,2,1,1365,827,538
174428,1,999,15180,6813,8367
174428,2,1,15180,6813,8367
174437,1,999,1471,656,815
174437,2,1,1471,656,815
174473,1,999,5485,2286,3199
174473,2,1,5485,2286,3199
174482,1,999,78,62,16
174482,2,1,78,62,16
174491,1,999,3661,1500,2161
174491,2,1,3521,1425,2096
174491,4,3,140,75,65
174507,1,999,1150,487,663
174507,2,1,310,99,211
174507,4,3,840,388,452
174525,1,999,147,72,75
174525,2,1,147,72,75
174534,1,999,242,7,235
174534,2,1,242,7,235
174570,1,999,1415,464,951
174570,2,1,1415,464,951
174604,1,999,460,187,273
174604,2,1,460,187,273
174738,1,999,8282,3284,4998
174738,2,1,8282,3284,4998
174747,1,999,2166,0,2166
174747,2,1,2166,0,2166
174756,1,999,6300,3012,3288
174756,2,1,6300,3012,3288
174765,1,999,163,7,156
174765,2,1,163,7,156
174783,1,999,22025,10391,11634
174783,2,1,19247,9345,9902
174783,4,3,2778,1046,1732
174792,1,999,2145,2068,77
174792,2,1,1986,1986,0
174792,4,3,159,82,77
174817,1,999,8656,3091,5565
174817,2,1,2455,1157,1298
174817,4,3,6201,1934,4267
174844,1,999,3233,1465,1768
174844,2,1,3233,1465,1768
174862,1,999,1319,599,720
174862,2,1,1074,466,608
174862,4,3,245,133,112
174899,1,999,4710,1443,3267
174899,2,1,3208,1023,2185
174899,4,3,1502,420,1082
174914,1,999,12164,6022,6142
174914,2,1,6659,3540,3119
174914,4,3,5505,2482,3023
174932,1,999,222,66,156
174932,2,1,222,66,156
174978,1,999,325,16,309
174978,2,1,325,16,309
175005,1,999,6124,289,5835
175005,2,1,4442,130,4312
175005,4,3,1682,159,1523
175014,1,999,10938,2693,8245
175014,2,1,10938,2693,8245
175041,1,999,9558,4372,5186
175041,2,1,9558,4372,5186
175078,1,999,7732,3237,4495
175078,2,1,7110,3028,4082
175078,4,3,622,209,413
175120,1,999,534,356,178
175120,2,1,534,356,178
175139,1,999,180,62,118
175139,4,3,180,62,118
175157,1,999,961,644,317
175157,2,1,961,644,317
175227,1,999,1978,1746,232
175227,2,1,1978,1746,232
175236,1,999,5909,2837,3072
175236,2,1,5909,2837,3072
175263,1,999,3327,1266,2061
175263,2,1,3327,1266,2061
175272,1,999,9691,3782,5909
175272,2,1,8909,3561,5348
175272,4,3,782,221,561
175281,1,999,1104,542,562
175281,4,3,1104,542,562
175315,1,999,15219,6916,8303
175315,2,1,15219,6916,8303
175342,1,999,4385,1386,2999
175342,2,1,3511,1168,2343
175342,4,3,874,218,656
175421,1,999,4340,1488,2852
175421,2,1,3223,1167,2056
175421,4,3,1117,321,796
175430,1,999,662,241,421
175430,2,1,635,241,394
175430,4,3,27,0,27
175494,1,999,198,18,180
175494,2,1,198,18,180
175519,1,999,3539,1257,2282
175519,2,1,3539,1257,2282
175528,1,999,1177,194,983
175528,2,1,1177,194,983
175573,1,999,5290,1872,3418
175573,2,1,5290,1872,3418
175591,1,999,100,0,100
175591,2,1,100,0,100
175607,1,999,101,12,89
175607,2,1,101,12,89
175616,1,999,5270,1874,3396
175616,2,1,3438,1339,2099
175616,4,3,1832,535,1297
175643,1,999,3622,1324,2298
175643,2,1,3622,1324,2298
175652,1,999,9116,3536,5580
175652,2,1,9116,3536,5580
175698,1,999,38,28,10
175698,2,1,38,28,10
175722,1,999,49,0,49
175722,2,1,49,0,49
175786,1,999,18180,6550,11630
175786,2,1,18180,6550,11630
175810,1,999,10033,3499,6534
175810,2,1,10033,3499,6534
175829,1,999,11112,4050,7062
175829,2,1,11112,4050,7062
175856,1,999,9565,3373,6192
175856,2,1,6856,2626,4230
175856,4,3,2709,747,1962
175883,1,999,6956,2904,4052
175883,2,1,6956,2904,4052
175935,1,999,5300,1731,3569
175935,2,1,5300,1731,3569
175980,1,999,1176,603,573
175980,2,1,1024,508,516
175980,4,3,152,95,57
176008,1,999,4926,1742,3184
176008,2,1,4926,1742,3184
176017,1,999,19911,9231,10680
176017,2,1,16405,7690,8715
176017,4,3,3506,1541,1965
176026,1,999,2890,1071,1819
176026,2,1,796,127,669
176026,4,3,2094,944,1150
176035,1,999,3199,561,2638
176035,2,1,2928,522,2406
176035,4,3,271,39,232
176044,1,999,3102,1121,1981
176044,2,1,2631,1001,1630
176044,4,3,471,120,351
176053,1,999,5789,2315,3474
176053,2,1,3510,1398,2112
176053,4,3,2279,917,1362
176062,1,999,128,5,123
176062,2,1,128,5,123
176071,1,999,14193,5721,8472
176071,2,1,14193,5721,8472
176080,1,999,22335,11522,10813
176080,2,1,17131,8916,8215
176080,4,3,5204,2606,2598
176169,1,999,4419,1747,2672
176169,2,1,4419,1747,2672
176178,1,999,11781,4428,7353
176178,2,1,11781,4428,7353
176239,1,999,8184,3453,4731
176239,2,1,8184,3453,4731
176318,1,999,1185,465,720
176318,2,1,1185,465,720
176336,1,999,132,77,55
176336,2,1,132,77,55
176354,1,999,2767,992,1775
176354,2,1,2767,992,1775
176372,1,999,19040,7221,11819
176372,2,1,15176,5888,9288
176372,4,3,3864,1333,2531
176390,1,999,268,3,265
176390,2,1,268,3,265
176406,1,999,1012,385,627
176406,2,1,1012,385,627
176451,1,999,162,124,38
176451,4,3,162,124,38
176479,1,999,5704,1533,4171
176479,2,1,3482,965,2517
176479,4,3,2222,568,1654
176549,1,999,546,90,456
176549,2,1,546,90,456
176600,1,999,222,108,114
176600,4,3,222,108,114
176619,1,999,561,387,174
176619,4,3,561,387,174
176628,1,999,2262,773,1489
176628,2,1,1387,504,883
176628,4,3,875,269,606
176637,1,999,1803,1358,445
176637,2,1,1803,1358,445
176664,1,999,601,365,236
176664,2,1,512,296,216
176664,4,3,89,69,20
176716,1,999,196,8,188
176716,2,1,196,8,188
176734,1,999,27,1,26
176734,2,1,27,1,26
176770,1,999,911,111,800
176770,2,1,876,110,766
176770,4,3,35,1,34
176789,1,999,402,201,201
176789,2,1,337,157,180
176789,4,3,65,44,21
176798,1,999,201,70,131
176798,2,1,201,70,131
176910,1,999,378,222,156
176910,2,1,378,222,156
176938,1,999,755,441,314
176938,2,1,755,441,314
176947,1,999,1292,627,665
176947,2,1,1292,627,665
176965,1,999,14322,6270,8052
176965,2,1,11240,5083,6157
176965,4,3,3082,1187,1895
176983,1,999,100,83,17
176983,2,1,100,83,17
176992,1,999,27,1,26
176992,2,1,27,1,26
177038,1,999,700,445,255
177038,2,1,161,97,64
177038,4,3,539,348,191
177056,1,999,98,21,77
177056,2,1,98,21,77
177065,1,999,30588,13140,17448
177065,2,1,29320,12645,16675
177065,4,3,1268,495,773
177083,1,999,123,123,0
177083,2,1,117,117,0
177083,4,3,6,6,0
177092,1,999,561,544,17
177092,4,3,561,544,17
177117,1,999,313,0,313
177117,2,1,313,0,313
177126,1,999,876,641,235
177126,4,3,876,641,235
177135,1,999,6098,2293,3805
177135,2,1,6098,2293,3805
177144,1,999,902,394,508
177144,2,1,902,394,508
177162,1,999,2273,1456,817
177162,2,1,2273,1456,817
177214,1,999,7817,2909,4908
177214,2,1,7099,2707,4392
177214,4,3,718,202,516
177250,1,999,6206,2513,3693
177250,2,1,6206,2513,3693
177278,1,999,210,85,125
177278,4,3,210,85,125
177287,1,999,368,7,361
177287,2,1,368,7,361
177302,1,999,2179,1135,1044
177302,2,1,2179,1135,1044
177339,1,999,2230,925,1305
177339,2,1,1866,827,1039
177339,4,3,364,98,266
177418,1,999,3197,893,2304
177418,2,1,1946,617,1329
177418,4,3,1251,276,975
177427,1,999,315,96,219
177427,4,3,315,96,219
177436,1,999,38,6,32
177436,2,1,38,6,32
177472,1,999,19054,8058,10996
177472,2,1,19054,8058,10996
177542,1,999,1419,496,923
177542,2,1,1392,495,897
177542,4,3,27,1,26
177551,1,999,2010,681,1329
177551,2,1,2010,681,1329
177579,1,999,556,112,444
177579,2,1,556,112,444
177588,1,999,108,12,96
177588,2,1,108,12,96
177603,1,999,143,7,136
177603,2,1,143,7,136
177676,1,999,8114,3369,4745
177676,2,1,8114,3369,4745
177685,1,999,77,3,74
177685,2,1,77,3,74
177719,1,999,970,104,866
177719,2,1,794,87,707
177719,4,3,176,17,159
177746,1,999,880,328,552
177746,2,1,880,328,552
177807,1,999,46,5,41
177807,2,1,46,5,41
177816,1,999,125,125,0
177816,2,1,47,47,0
177816,4,3,78,78,0
177834,1,999,4244,1644,2600
177834,4,3,4244,1644,2600
177870,1,999,16,16,0
177870,2,1,16,16,0
177931,1,999,49,3,46
177931,2,1,49,3,46
177940,1,999,4152,1653,2499
177940,2,1,3910,1570,2340
177940,4,3,242,83,159
177968,1,999,17309,5925,11384
177968,2,1,9269,4040,5229
177968,4,3,8040,1885,6155
177977,1,999,1326,1168,158
177977,2,1,1326,1168,158
177986,1,999,1242,784,458
177986,2,1,81,49,32
177986,4,3,1161,735,426
177995,1,999,10374,4438,5936
177995,2,1,10374,4438,5936
178004,1,999,212,21,191
178004,2,1,212,21,191
178022,1,999,8747,3549,5198
178022,2,1,8747,3549,5198
178059,1,999,4444,1088,3356
178059,2,1,3520,855,2665
178059,4,3,924,233,691
178077,1,999,245,9,236
178077,2,1,245,9,236
178110,1,999,271,23,248
178110,2,1,271,23,248
178183,1,999,434,81,353
178183,2,1,434,81,353
178208,1,999,1369,1067,302
178208,2,1,409,265,144
178208,4,3,960,802,158
178217,1,999,6053,2585,3468
178217,2,1,6053,2585,3468
178226,1,999,1297,697,600
178226,2,1,1297,697,600
178244,1,999,5914,2135,3779
178244,2,1,4008,1598,2410
178244,4,3,1906,537,1369
178262,1,999,234,11,223
178262,2,1,234,11,223
178305,1,999,2103,211,1892
178305,2,1,2103,211,1892
178314,1,999,28,23,5
178314,2,1,28,23,5
178341,1,999,6980,2950,4030
178341,2,1,6861,2914,3947
178341,4,3,119,36,83
178350,1,999,155,141,14
178350,2,1,155,141,14
178369,1,999,1941,1028,913
178369,2,1,1941,1028,913
178387,1,999,7503,3270,4233
178387,2,1,7267,3219,4048
178387,4,3,236,51,185
178396,1,999,35788,16592,19196
178396,2,1,26625,12849,13776
178396,4,3,9163,3743,5420
178402,1,999,20512,8727,11785
178402,2,1,13879,5827,8052
178402,4,3,6633,2900,3733
178411,1,999,8086,6229,1857
178411,2,1,5795,4417,1378
178411,4,3,2291,1812,479
178420,1,999,21177,8254,12923
178420,2,1,16446,6701,9745
178420,4,3,4731,1553,3178
178448,1,999,7803,3165,4638
178448,2,1,7803,3165,4638
178466,1,999,152,55,97
178466,2,1,152,55,97
178484,1,999,490,20,470
178484,2,1,490,20,470
178518,1,999,367,268,99
178518,4,3,367,268,99
178527,1,999,95,3,92
178527,2,1,95,3,92
178563,1,999,108,18,90
178563,2,1,108,18,90
178606,1,999,21,13,8
178606,2,1,21,13,8
178615,1,999,6801,2759,4042
178615,2,1,5898,2452,3446
178615,4,3,903,307,596
178624,1,999,8322,3623,4699
178624,2,1,6792,3032,3760
178624,4,3,1530,591,939
178679,1,999,726,403,323
178679,2,1,726,403,323
178697,1,999,1544,664,880
178697,2,1,1544,664,880
178721,1,999,22678,12074,10604
178721,2,1,21449,11582,9867
178721,4,3,1229,492,737
178767,1,999,267,21,246
178767,2,1,267,21,246
178785,1,999,8532,2642,5890
178785,2,1,8532,2642,5890
178828,1,999,79,25,54
178828,2,1,79,25,54
178891,1,999,2671,2584,87
178891,2,1,2671,2584,87
178989,1,999,692,68,624
178989,2,1,508,51,457
178989,4,3,184,17,167
179043,1,999,3425,1306,2119
179043,2,1,2287,848,1439
179043,4,3,1138,458,680
179052,1,999,213,91,122
179052,2,1,213,91,122
179070,1,999,837,178,659
179070,2,1,837,178,659
179159,1,999,20461,8355,12106
179159,2,1,14472,5911,8561
179159,4,3,5989,2444,3545
179195,1,999,61,1,60
179195,2,1,61,1,60
179201,1,999,2237,509,1728
179201,2,1,2237,509,1728
179229,1,999,83,6,77
179229,2,1,83,6,77
179238,1,999,58,5,53
179238,2,1,58,5,53
179256,1,999,384,223,161
179256,2,1,384,223,161
179265,1,999,1262,535,727
179265,2,1,706,289,417
179265,4,3,556,246,310
179308,1,999,45588,18030,27558
179308,2,1,45588,18030,27558
179317,1,999,276,148,128
179317,4,3,276,148,128
179326,1,999,4499,1504,2995
179326,2,1,3293,1142,2151
179326,4,3,1206,362,844
179344,1,999,2822,1180,1642
179344,2,1,2822,1180,1642
179399,1,999,29,5,24
179399,2,1,29,5,24
179450,1,999,127,15,112
179450,2,1,127,15,112
179511,1,999,499,43,456
179511,2,1,499,43,456
179539,1,999,6800,2623,4177
179539,2,1,6800,2623,4177
179548,1,999,1306,76,1230
179548,2,1,974,38,936
179548,4,3,332,38,294
179557,1,999,13426,5352,8074
179557,2,1,11583,4802,6781
179557,4,3,1843,550,1293
179566,1,999,23399,10283,13116
179566,2,1,19094,8555,10539
179566,4,3,4305,1728,2577
179645,1,999,5274,1829,3445
179645,2,1,5274,1829,3445
179715,1,999,2399,664,1735
179715,2,1,2399,664,1735
179724,1,999,41,14,27
179724,2,1,41,14,27
179742,1,999,57,19,38
179742,4,3,57,19,38
179812,1,999,1085,579,506
179812,4,3,1085,579,506
179867,1,999,15185,7395,7790
179867,2,1,7954,3840,4114
179867,4,3,7231,3555,3676
179894,1,999,26006,11024,14982
179894,2,1,4472,1845,2627
179894,4,3,21534,9179,12355
179919,1,999,1228,535,693
179919,2,1,1228,535,693
179946,1,999,1171,660,511
179946,2,1,1171,660,511
179955,1,999,1181,458,723
179955,2,1,1181,458,723
179964,1,999,3470,1150,2320
179964,2,1,1378,364,1014
179964,4,3,2092,786,1306
179991,1,999,49,1,48
179991,2,1,49,1,48
180054,1,999,732,328,404
180054,2,1,732,328,404
180063,1,999,68,1,67
180063,2,1,68,1,67
180081,1,999,776,380,396
180081,2,1,776,380,396
180090,1,999,113,5,108
180090,2,1,113,5,108
180106,1,999,1525,633,892
180106,2,1,1525,633,892
180151,1,999,1304,558,746
180151,2,1,1304,558,746
180160,1,999,555,226,329
180160,2,1,555,226,329
180179,1,999,6651,2511,4140
180179,2,1,5777,2265,3512
180179,4,3,874,246,628
180197,1,999,4077,1687,2390
180197,2,1,4077,1687,2390
180203,1,999,231,101,130
180203,2,1,231,101,130
180212,1,999,787,287,500
180212,2,1,787,287,500
180249,1,999,2737,824,1913
180249,2,1,2737,824,1913
180258,1,999,1263,429,834
180258,2,1,1167,404,763
180258,4,3,96,25,71
180276,1,999,2004,880,1124
180276,2,1,2004,880,1124
180328,1,999,869,298,571
180328,2,1,869,298,571
180373,1,999,732,257,475
180373,2,1,732,257,475
180391,1,999,60,1,59
180391,2,1,60,1,59
180416,1,999,2752,1666,1086
180416,2,1,2557,1549,1008
180416,4,3,195,117,78
180461,1,999,15427,8129,7298
180461,2,1,12764,6963,5801
180461,4,3,2663,1166,1497
180489,1,999,18472,8568,9904
180489,2,1,15589,7390,8199
180489,4,3,2883,1178,1705
180522,1,999,1658,796,862
180522,2,1,1528,761,767
180522,4,3,130,35,95
180595,1,999,1086,544,542
180595,2,1,996,502,494
180595,4,3,90,42,48
180647,1,999,1566,613,953
180647,2,1,1566,613,953
180692,1,999,1901,745,1156
180692,2,1,1901,745,1156
180771,1,999,79,4,75
180771,2,1,79,4,75
180814,1,999,15251,7703,7548
180814,2,1,10788,5600,5188
180814,4,3,4463,2103,2360
180832,1,999,1312,161,1151
180832,2,1,924,119,805
180832,4,3,388,42,346
180878,1,999,633,86,547
180878,2,1,553,65,488
180878,4,3,80,21,59
180902,1,999,13419,5874,7545
180902,2,1,13419,5874,7545
180948,1,999,3771,1495,2276
180948,2,1,2829,1147,1682
180948,4,3,942,348,594
180957,1,999,225,42,183
180957,2,1,225,42,183
180984,1,999,2367,886,1481
180984,2,1,1474,698,776
180984,4,3,893,188,705
181002,1,999,8826,3932,4894
181002,2,1,4723,1923,2800
181002,4,3,4103,2009,2094
181020,1,999,1084,537,547
181020,2,1,1084,537,547
181093,1,999,579,244,335
181093,2,1,463,198,265
181093,4,3,116,46,70
181127,1,999,1434,652,782
181127,2,1,1192,618,574
181127,4,3,242,34,208
181136,1,999,61,4,57
181136,2,1,61,4,57
181145,1,999,22,6,16
181145,2,1,22,6,16
181190,1,999,609,100,509
181190,2,1,609,100,509
181215,1,999,8245,3465,4780
181215,2,1,5708,2656,3052
181215,4,3,2537,809,1728
181242,1,999,877,222,655
181242,2,1,863,219,644
181242,4,3,14,3,11
181297,1,999,934,97,837
181297,2,1,814,81,733
181297,4,3,120,16,104
181303,1,999,32650,14049,18601
181303,2,1,32650,14049,18601
181312,1,999,5390,2894,2496
181312,2,1,5390,2894,2496
181330,1,999,1151,546,605
181330,2,1,1126,539,587
181330,4,3,25,7,18
181376,1,999,156,90,66
181376,2,1,156,90,66
181394,1,999,17617,8296,9321
181394,2,1,13916,6781,7135
181394,4,3,3701,1515,2186
181400,1,999,1366,279,1087
181400,2,1,1341,276,1065
181400,4,3,25,3,22
181419,1,999,261,103,158
181419,2,1,261,103,158
181428,1,999,3748,1240,2508
181428,2,1,1083,140,943
181428,4,3,2665,1100,1565
181446,1,999,3737,1395,2342
181446,2,1,3329,1304,2025
181446,4,3,408,91,317
181464,1,999,27443,14487,12956
181464,2,1,20681,11217,9464
181464,4,3,6762,3270,3492
181491,1,999,7717,3785,3932
181491,2,1,7717,3785,3932
181534,1,999,3392,1346,2046
181534,2,1,2879,1186,1693
181534,4,3,513,160,353
181543,1,999,59,31,28
181543,2,1,59,31,28
181604,1,999,1227,39,1188
181604,2,1,935,17,918
181604,4,3,292,22,270
181640,1,999,19401,9914,9487
181640,2,1,19401,9914,9487
181738,1,999,1076,426,650
181738,2,1,1003,399,604
181738,4,3,73,27,46
181756,1,999,1004,324,680
181756,2,1,1004,324,680
181765,1,999,397,169,228
181765,2,1,397,169,228
181783,1,999,4377,1827,2550
181783,2,1,3277,1464,1813
181783,4,3,1100,363,737
181792,1,999,16,5,11
181792,2,1,16,5,11
181817,1,999,8758,4275,4483
181817,2,1,8758,4275,4483
181853,1,999,507,278,229
181853,2,1,507,278,229
181880,1,999,270,11,259
181880,2,1,270,11,259
181941,1,999,1066,355,711
181941,2,1,1066,355,711
182005,1,999,61662,29867,31795
182005,2,1,61662,29867,31795
182111,1,999,1780,983,797
182111,2,1,1780,983,797
182148,1,999,1930,255,1675
182148,2,1,1930,255,1675
182209,1,999,592,43,549
182209,2,1,592,43,549
182281,1,999,36235,15778,20457
182281,2,1,27657,12391,15266
182281,4,3,8578,3387,5191
182290,1,999,21029,9635,11394
182290,2,1,16325,7653,8672
182290,4,3,4704,1982,2722
182306,1,999,5195,1901,3294
182306,2,1,5195,1901,3294
182397,1,999,393,14,379
182397,2,1,393,14,379
182430,1,999,442,237,205
182430,2,1,374,202,172
182430,4,3,68,35,33
182458,1,999,1275,509,766
182458,2,1,518,307,211
182458,4,3,757,202,555
182500,1,999,18405,8126,10279
182500,2,1,18405,8126,10279
182564,1,999,7851,3281,4570
182564,2,1,7851,3281,4570
182634,1,999,1247,413,834
182634,2,1,1247,413,834
182652,1,999,119,7,112
182652,2,1,119,7,112
182661,1,999,847,643,204
182661,2,1,770,588,182
182661,4,3,77,55,22
182670,1,999,6580,3489,3091
182670,2,1,4684,2376,2308
182670,4,3,1896,1113,783
182704,1,999,183,5,178
182704,2,1,183,5,178
182722,1,999,187,18,169
182722,2,1,187,18,169
182795,1,999,2866,1228,1638
182795,2,1,2078,940,1138
182795,4,3,788,288,500
182829,1,999,495,287,208
182829,4,3,495,287,208
182865,1,999,5185,1582,3603
182865,2,1,5185,1582,3603
182883,1,999,28,0,28
182883,2,1,28,0,28
182892,1,999,87,0,87
182892,2,1,87,0,87
182908,1,999,369,138,231
182908,2,1,369,138,231
182917,1,999,56,26,30
182917,2,1,56,26,30
182953,1,999,220,12,208
182953,2,1,220,12,208
182980,1,999,2532,1071,1461
182980,2,1,1068,567,501
182980,4,3,1464,504,960
182999,1,999,95,2,93
182999,2,1,95,2,93
183026,1,999,13324,5812,7512
183026,2,1,8329,3538,4791
183026,4,3,4995,2274,2721
183035,1,999,64,5,59
183035,2,1,64,5,59
183044,1,999,16798,7448,9350
183044,2,1,13570,6160,7410
183044,4,3,3228,1288,1940
183062,1,999,5942,2585,3357
183062,2,1,5663,2518,3145
183062,4,3,279,67,212
183071,1,999,2233,1036,1197
183071,2,1,1549,782,767
183071,4,3,684,254,430
183080,1,999,7538,3410,4128
183080,2,1,4830,2634,2196
183080,4,3,2708,776,1932
183099,1,999,6152,2893,3259
183099,2,1,6152,2893,3259
183105,1,999,1544,587,957
183105,2,1,1544,587,957
183114,1,999,1885,659,1226
183114,2,1,1885,659,1226
183123,1,999,2395,1378,1017
183123,2,1,2395,1378,1017
183132,1,999,4588,2008,2580
183132,2,1,4588,2008,2580
183141,1,999,3410,1585,1825
183141,2,1,3410,1585,1825
183150,1,999,2909,1145,1764
183150,2,1,2909,1145,1764
183202,1,999,53,6,47
183202,2,1,53,6,47
183211,1,999,3027,659,2368
183211,2,1,1786,360,1426
183211,4,3,1241,299,942
183239,1,999,2015,900,1115
183239,2,1,2015,900,1115
183248,1,999,177,9,168
183248,2,1,177,9,168
183257,1,999,2802,773,2029
183257,2,1,2437,715,1722
183257,4,3,365,58,307
183275,1,999,78,43,35
183275,2,1,78,43,35
183345,1,999,169,60,109
183345,2,1,169,60,109
183488,1,999,783,94,689
183488,2,1,783,94,689
183600,1,999,52,0,52
183600,2,1,52,0,52
183655,1,999,11219,4596,6623
183655,2,1,11219,4596,6623
183725,1,999,904,195,709
183725,2,1,904,195,709
183743,1,999,23777,11512,12265
183743,2,1,23777,11512,12265
183789,1,999,4938,1499,3439
183789,2,1,4938,1499,3439
183804,1,999,7031,7031,0
183804,2,1,3063,3063,0
183804,4,3,3968,3968,0
183822,1,999,2542,889,1653
183822,2,1,2527,884,1643
183822,4,3,15,5,10
183859,1,999,22446,10348,12098
183859,2,1,22446,10348,12098
183877,1,999,17479,7496,9983
183877,2,1,17479,7496,9983
183910,1,999,2692,819,1873
183910,2,1,1858,642,1216
183910,4,3,834,177,657
183938,1,999,23052,9293,13759
183938,2,1,23052,9293,13759
183974,1,999,3387,1334,2053
183974,2,1,2337,971,1366
183974,4,3,1050,363,687
183983,1,999,164,139,25
183983,2,1,164,139,25
184047,1,999,572,270,302
184047,2,1,572,270,302
184056,1,999,1745,330,1415
184056,2,1,1745,330,1415
184092,1,999,1001,167,834
184092,2,1,1001,167,834
184135,1,999,2295,471,1824
184135,2,1,2295,471,1824
184144,1,999,223,39,184
184144,2,1,223,39,184
184153,1,999,63,13,50
184153,2,1,56,9,47
184153,4,3,7,4,3
184180,1,999,13936,6889,7047
184180,2,1,13936,6889,7047
184205,1,999,5486,1999,3487
184205,2,1,5486,1999,3487
184269,1,999,3068,2191,877
184269,2,1,3068,2191,877
184278,1,999,235,232,3
184278,2,1,235,232,3
184320,1,999,2393,955,1438
184320,2,1,2393,955,1438
184348,1,999,3102,1289,1813
184348,2,1,2058,819,1239
184348,4,3,1044,470,574
184357,1,999,74,39,35
184357,2,1,74,39,35
184427,1,999,446,443,3
184427,2,1,446,443,3
184481,1,999,17414,7188,10226
184481,2,1,17414,7188,10226
184506,1,999,224,28,196
184506,2,1,224,28,196
184603,1,999,10746,4562,6184
184603,2,1,7402,3165,4237
184603,4,3,3344,1397,1947
184612,1,999,2580,617,1963
184612,2,1,2121,526,1595
184612,4,3,459,91,368
184694,1,999,3614,1674,1940
184694,2,1,2606,1214,1392
184694,4,3,1008,460,548
184746,1,999,261,258,3
184746,2,1,261,258,3
184773,1,999,3280,449,2831
184773,2,1,2166,261,1905
184773,4,3,1114,188,926
184782,1,999,13176,5891,7285
184782,2,1,11266,5318,5948
184782,4,3,1910,573,1337
184791,1,999,10152,4138,6014
184791,2,1,10152,4138,6014
184816,1,999,363,82,281
184816,2,1,363,82,281
184870,1,999,650,92,558
184870,2,1,650,92,558
184959,1,999,2003,318,1685
184959,2,1,2003,318,1685
184968,1,999,132,26,106
184968,2,1,132,26,106
184995,1,999,12608,5069,7539
184995,2,1,12608,5069,7539
185129,1,999,10605,3927,6678
185129,2,1,7817,3121,4696
185129,4,3,2788,806,1982
185174,1,999,78,66,12
185174,2,1,78,66,12
185262,1,999,18956,6688,12268
185262,2,1,14982,5762,9220
185262,4,3,3974,926,3048
185332,1,999,587,80,507
185332,2,1,587,80,507
185396,1,999,2524,2360,164
185396,2,1,2524,2360,164
185466,1,999,363,26,337
185466,2,1,363,26,337
185509,1,999,13803,6475,7328
185509,2,1,13803,6475,7328
185536,1,999,19505,9141,10364
185536,2,1,19505,9141,10364
185572,1,999,7407,2756,4651
185572,2,1,5086,2157,2929
185572,4,3,2321,599,1722
185590,1,999,21834,8050,13784
185590,2,1,16654,6622,10032
185590,4,3,5180,1428,3752
185624,1,999,55,6,49
185624,2,1,55,6,49
185651,1,999,164,59,105
185651,2,1,164,59,105
185679,1,999,582,73,509
185679,2,1,582,73,509
185721,1,999,738,244,494
185721,2,1,738,244,494
185730,1,999,138,22,116
185730,2,1,138,22,116
185758,1,999,234,117,117
185758,4,3,234,117,117
185767,1,999,360,29,331
185767,2,1,360,29,331
185828,1,999,10622,7956,2666
185828,2,1,7041,5470,1571
185828,4,3,3581,2486,1095
185873,1,999,16387,6858,9529
185873,2,1,16387,6858,9529
185916,1,999,316,57,259
185916,2,1,316,57,259
185970,1,999,308,23,285
185970,2,1,308,23,285
186016,1,999,506,35,471
186016,2,1,506,35,471
186034,1,999,13446,5150,8296
186034,2,1,13446,5150,8296
186052,1,999,1230,1067,163
186052,2,1,1230,1067,163
186122,1,999,551,336,215
186122,4,3,551,336,215
186131,1,999,8004,4404,3600
186131,2,1,5216,2666,2550
186131,4,3,2788,1738,1050
186186,1,999,284,284,0
186186,2,1,284,284,0
186201,1,999,7016,2855,4161
186201,2,1,6694,2773,3921
186201,4,3,322,82,240
186274,1,999,307,49,258
186274,2,1,307,49,258
186283,1,999,6747,2615,4132
186283,2,1,5292,2133,3159
186283,4,3,1455,482,973
186335,1,999,152,34,118
186335,2,1,152,34,118
186371,1,999,7276,3498,3778
186371,2,1,5451,2490,2961
186371,4,3,1825,1008,817
186380,1,999,43885,21194,22691
186380,2,1,34171,17587,16584
186380,4,3,9714,3607,6107
186399,1,999,14275,6948,7327
186399,2,1,9354,4302,5052
186399,4,3,4921,2646,2275
186405,1,999,14,3,11
186405,2,1,14,3,11
186423,1,999,87,8,79
186423,2,1,87,8,79
186432,1,999,3743,1559,2184
186432,2,1,2875,1208,1667
186432,4,3,868,351,517
186469,1,999,1970,775,1195
186469,2,1,1970,775,1195
186584,1,999,11114,4781,6333
186584,2,1,5819,2451,3368
186584,4,3,5295,2330,2965
186593,1,999,266,39,227
186593,2,1,266,39,227
186618,1,999,2279,283,1996
186618,2,1,1324,134,1190
186618,4,3,955,149,806
186645,1,999,12227,5608,6619
186645,2,1,12227,5608,6619
186867,1,999,7208,5429,1779
186867,2,1,2483,1825,658
186867,4,3,4725,3604,1121
186876,1,999,9102,3669,5433
186876,2,1,8038,3385,4653
186876,4,3,1064,284,780
186900,1,999,64,64,0
186900,2,1,64,64,0
187000,1,999,233,229,4
187000,2,1,233,229,4
187046,1,999,20251,11580,8671
187046,2,1,19140,11221,7919
187046,4,3,1111,359,752
187134,1,999,8486,3312,5174
187134,2,1,6958,2985,3973
187134,4,3,1528,327,1201
187161,1,999,2249,297,1952
187161,2,1,2249,297,1952
187198,1,999,17486,6804,10682
187198,2,1,17486,6804,10682
187222,1,999,7887,2545,5342
187222,2,1,1585,267,1318
187222,4,3,6302,2278,4024
187444,1,999,13616,5736,7880
187444,2,1,11560,5229,6331
187444,4,3,2056,507,1549
187505,1,999,2301,145,2156
187505,2,1,2301,145,2156
187532,1,999,43062,19195,23867
187532,2,1,43062,19195,23867
187596,1,999,1143,493,650
187596,2,1,1143,493,650
187602,1,999,194,42,152
187602,2,1,194,42,152
187620,1,999,13358,5896,7462
187620,2,1,13358,5896,7462
187639,1,999,6854,2542,4312
187639,2,1,6854,2542,4312
187648,1,999,6868,2767,4101
187648,2,1,5399,2353,3046
187648,4,3,1469,414,1055
187666,1,999,6761,3350,3411
187666,2,1,6761,3350,3411
187745,1,999,391,170,221
187745,2,1,391,170,221
187897,1,999,4814,1741,3073
187897,2,1,2726,1101,1625
187897,4,3,2088,640,1448
187903,1,999,5368,2221,3147
187903,2,1,5368,2221,3147
187912,1,999,519,427,92
187912,2,1,519,427,92
187958,1,999,3999,1424,2575
187958,2,1,3999,1424,2575
187967,1,999,2291,1459,832
187967,2,1,1580,1040,540
187967,4,3,711,419,292
187976,1,999,1442,615,827
187976,2,1,1442,615,827
187985,1,999,33304,14590,18714
187985,2,1,23919,10710,13209
187985,4,3,9385,3880,5505
187994,1,999,6107,2219,3888
187994,2,1,6107,2219,3888
188003,1,999,3169,1180,1989
188003,2,1,3169,1180,1989
188021,1,999,2869,961,1908
188021,2,1,2869,961,1908
188030,1,999,21692,9682,12010
188030,2,1,17036,7675,9361
188030,4,3,4656,2007,2649
188049,1,999,3474,1291,2183
188049,2,1,3474,1291,2183
188058,1,999,3259,1258,2001
188058,2,1,3192,1239,1953
188058,4,3,67,19,48
188100,1,999,11826,5768,6058
188100,2,1,11826,5768,6058
188137,1,999,7555,2890,4665
188137,2,1,7555,2890,4665
188146,1,999,562,278,284
188146,2,1,556,277,279
188146,4,3,6,1,5
188182,1,999,667,225,442
188182,2,1,342,153,189
188182,4,3,325,72,253
188207,1,999,141,13,128
188207,4,3,141,13,128
188216,1,999,995,451,544
188216,2,1,995,451,544
188225,1,999,2272,867,1405
188225,2,1,2272,867,1405
188261,1,999,1685,940,745
188261,2,1,1685,940,745
188304,1,999,4611,1747,2864
188304,2,1,3735,1457,2278
188304,4,3,876,290,586
188340,1,999,1923,1679,244
188340,2,1,1896,1659,237
188340,4,3,27,20,7
188429,1,999,10175,2612,7563
188429,2,1,5549,1668,3881
188429,4,3,4626,944,3682
188438,1,999,5285,2149,3136
188438,2,1,5285,2149,3136
188465,1,999,835,553,282
188465,2,1,835,553,282
188517,1,999,1335,371,964
188517,2,1,1335,371,964
188526,1,999,1609,677,932
188526,2,1,1134,456,678
188526,4,3,475,221,254
188535,1,999,747,421,326
188535,4,3,747,421,326
188580,1,999,834,385,449
188580,4,3,834,385,449
188641,1,999,2543,1153,1390
188641,2,1,1957,976,981
188641,4,3,586,177,409
188650,1,999,1150,111,1039
188650,2,1,1150,111,1039
188669,1,999,96,22,74
188669,2,1,96,22,74
188678,1,999,250,92,158
188678,2,1,250,92,158
188687,1,999,540,254,286
188687,2,1,540,254,286
188696,1,999,148,19,129
188696,2,1,148,19,129
188854,1,999,1460,538,922
188854,2,1,1460,538,922
188890,1,999,3064,3013,51
188890,2,1,3064,3013,51
188915,1,999,70,7,63
188915,2,1,70,7,63
188942,1,999,110,0,110
188942,2,1,110,0,110
188988,1,999,629,176,453
188988,2,1,629,176,453
189015,1,999,1428,191,1237
189015,4,3,1428,191,1237
189088,1,999,3065,1350,1715
189088,2,1,2735,1219,1516
189088,4,3,330,131,199
189097,1,999,2519,0,2519
189097,2,1,2519,0,2519
189219,1,999,227,210,17
189219,2,1,227,210,17
189228,1,999,7399,2489,4910
189228,2,1,7399,2489,4910
189264,1,999,72,72,0
189264,2,1,72,72,0
189273,1,999,44,44,0
189273,2,1,37,37,0
189273,4,3,7,7,0
189282,1,999,264,53,211
189282,2,1,264,53,211
189404,1,999,132,8,124
189404,2,1,132,8,124
189413,1,999,1547,325,1222
189413,2,1,1426,306,1120
189413,4,3,121,19,102
189422,1,999,1369,529,840
189422,2,1,1369,529,840
189459,1,999,2806,1326,1480
189459,2,1,2806,1326,1480
189468,1,999,300,13,287
189468,2,1,300,13,287
189477,1,999,380,11,369
189477,2,1,380,11,369
189501,1,999,1529,791,738
189501,4,3,1529,791,738
189547,1,999,10107,4371,5736
189547,2,1,10107,4371,5736
189556,1,999,921,257,664
189556,2,1,921,257,664
189565,1,999,1042,275,767
189565,2,1,1042,275,767
189574,1,999,1295,350,945
189574,2,1,1295,350,945
189583,1,999,1617,474,1143
189583,2,1,1617,474,1143
189592,1,999,685,163,522
189592,2,1,685,163,522
189653,1,999,141,12,129
189653,2,1,141,12,129
189705,1,999,6047,2868,3179
189705,2,1,3663,1864,1799
189705,4,3,2384,1004,1380
189714,1,999,359,9,350
189714,2,1,359,9,350
189811,1,999,415,82,333
189811,2,1,415,82,333
189839,1,999,7755,2929,4826
189839,2,1,7755,2929,4826
189848,1,999,1357,332,1025
189848,2,1,1357,332,1025
189857,1,999,695,695,0
189857,2,1,631,631,0
189857,4,3,64,64,0
189954,1,999,85,18,67
189954,2,1,85,18,67
189981,1,999,99,61,38
189981,4,3,99,61,38
190008,1,999,97,51,46
190008,2,1,97,51,46
190044,1,999,3456,2456,1000
190044,2,1,2918,2097,821
190044,4,3,538,359,179
190053,1,999,2935,1345,1590
190053,2,1,2935,1345,1590
190071,1,999,263,39,224
190071,2,1,263,39,224
190080,1,999,106,36,70
190080,4,3,106,36,70
190099,1,999,3038,1415,1623
190099,2,1,3018,1408,1610
190099,4,3,20,7,13
190114,1,999,1753,560,1193
190114,2,1,1124,356,768
190114,4,3,629,204,425
190150,1,999,27257,13502,13755
190150,2,1,8327,4233,4094
190150,4,3,18930,9269,9661
190169,1,999,2680,1009,1671
190169,2,1,2680,1009,1671
190239,1,999,448,24,424
190239,2,1,448,24,424
190248,1,999,975,325,650
190248,2,1,975,325,650
190293,1,999,176,7,169
190293,2,1,176,7,169
190309,1,999,75,3,72
190309,2,1,75,3,72
190318,1,999,587,25,562
190318,2,1,587,25,562
190372,1,999,1020,638,382
190372,2,1,929,567,362
190372,4,3,91,71,20
190415,1,999,21437,11300,10137
190415,2,1,14237,7188,7049
190415,4,3,7200,4112,3088
190424,1,999,1463,682,781
190424,4,3,1463,682,781
190442,1,999,6740,2849,3891
190442,2,1,6740,2849,3891
190451,1,999,339,42,297
190451,2,1,339,42,297
190503,1,999,4521,2480,2041
190503,2,1,4521,2480,2041
190512,1,999,21980,10857,11123
190512,2,1,16965,8402,8563
190512,4,3,5015,2455,2560
190521,1,999,30682,12560,18122
190521,2,1,30682,12560,18122
190530,1,999,14447,5998,8449
190530,2,1,14447,5998,8449
190549,1,999,21565,8133,13432
190549,2,1,16264,6540,9724
190549,4,3,5301,1593,3708
190558,1,999,17031,7100,9931
190558,2,1,15726,6779,8947
190558,4,3,1305,321,984
190567,1,999,19040,8881,10159
190567,2,1,14913,7204,7709
190567,4,3,4127,1677,2450
190576,1,999,7728,2950,4778
190576,2,1,1705,579,1126
190576,4,3,6023,2371,3652
190585,1,999,8994,2874,6120
190585,2,1,8994,2874,6120
190594,1,999,28392,8534,19858
190594,2,1,19974,6672,13302
190594,4,3,8418,1862,6556
190600,1,999,18040,7660,10380
190600,2,1,15602,6753,8849
190600,4,3,2438,907,1531
190619,1,999,25698,11315,14383
190619,2,1,25698,11315,14383
190628,1,999,23180,9619,13561
190628,2,1,23180,9619,13561
190637,1,999,16084,4710,11374
190637,2,1,12967,3977,8990
190637,4,3,3117,733,2384
190646,1,999,9079,2305,6774
190646,2,1,9079,2305,6774
190655,1,999,19937,10434,9503
190655,2,1,19937,10434,9503
190664,1,999,25743,10056,15687
190664,2,1,19977,8321,11656
190664,4,3,5766,1735,4031
190673,1,999,20479,9196,11283
190673,2,1,20479,9196,11283
190682,1,999,460,165,295
190682,4,3,460,165,295
190691,1,999,9999,3518,6481
190691,2,1,9951,3509,6442
190691,4,3,48,9,39
190707,1,999,26,5,21
190707,2,1,26,5,21
190716,1,999,3735,1051,2684
190716,2,1,2429,635,1794
190716,4,3,1306,416,890
190725,1,999,3479,798,2681
190725,2,1,2395,639,1756
190725,4,3,1084,159,925
190734,1,999,19,19,0
190734,2,1,11,11,0
190734,4,3,8,8,0
190761,1,999,2207,709,1498
190761,2,1,1773,566,1207
190761,4,3,434,143,291
190770,1,999,6256,2709,3547
190770,2,1,3643,1723,1920
190770,4,3,2613,986,1627
190840,1,999,13290,5968,7322
190840,2,1,13290,5968,7322
190956,1,999,143,22,121
190956,2,1,143,22,121
190974,1,999,1022,160,862
190974,2,1,1022,160,862
190983,1,999,2000,528,1472
190983,2,1,1622,441,1181
190983,4,3,378,87,291
191083,1,999,21660,10570,11090
191083,2,1,21660,10570,11090
191126,1,999,13578,2126,11452
191126,2,1,13320,2088,11232
191126,4,3,258,38,220
191199,1,999,9492,4147,5345
191199,2,1,9492,4147,5345
191205,1,999,1325,888,437
191205,2,1,1201,822,379
191205,4,3,124,66,58
191241,1,999,17437,7622,9815
191241,2,1,9157,4316,4841
191241,4,3,8280,3306,4974
191287,1,999,1419,623,796
191287,2,1,1419,623,796
191302,1,999,3512,1468,2044
191302,2,1,3512,1468,2044
191311,1,999,248,99,149
191311,2,1,248,99,149
191320,1,999,168,90,78
191320,4,3,168,90,78
191339,1,999,9406,3584,5822
191339,2,1,9406,3584,5822
191384,1,999,340,64,276
191384,2,1,340,64,276
191393,1,999,876,94,782
191393,2,1,876,94,782
191515,1,999,1998,939,1059
191515,2,1,1998,939,1059
191533,1,999,1600,666,934
191533,2,1,1600,666,934
191597,1,999,743,97,646
191597,2,1,743,97,646
191612,1,999,5542,2166,3376
191612,2,1,5542,2166,3376
191621,1,999,1151,493,658
191621,2,1,1151,493,658
191630,1,999,2179,976,1203
191630,2,1,2171,976,1195
191630,4,3,8,0,8
191649,1,999,13128,5799,7329
191649,2,1,8182,3887,4295
191649,4,3,4946,1912,3034
191676,1,999,1398,491,907
191676,2,1,1379,481,898
191676,4,3,19,10,9
191719,1,999,19325,9739,9586
191719,2,1,19325,9739,9586
191728,1,999,1515,320,1195
191728,2,1,1515,320,1195
191764,1,999,182,145,37
191764,2,1,182,145,37
191834,1,999,1181,1084,97
191834,2,1,1181,1084,97
191931,1,999,5797,2413,3384
191931,2,1,4093,1801,2292
191931,4,3,1704,612,1092
191940,1,999,90,10,80
191940,2,1,90,10,80
191959,1,999,165,141,24
191959,2,1,165,141,24
191968,1,999,7420,3165,4255
191968,2,1,6723,2937,3786
191968,4,3,697,228,469
191986,1,999,7312,3305,4007
191986,2,1,7312,3305,4007
192004,1,999,500,135,365
192004,2,1,500,135,365
192022,1,999,5606,2220,3386
192022,2,1,5606,2220,3386
192040,1,999,533,252,281
192040,2,1,183,85,98
192040,4,3,350,167,183
192110,1,999,1013,542,471
192110,2,1,672,356,316
192110,4,3,341,186,155
192156,1,999,988,309,679
192156,2,1,988,309,679
192165,1,999,117,117,0
192165,2,1,117,117,0
192192,1,999,2220,551,1669
192192,2,1,1922,467,1455
192192,4,3,298,84,214
192244,1,999,27,27,0
192244,2,1,25,25,0
192244,4,3,2,2,0
192271,1,999,1702,109,1593
192271,2,1,1625,101,1524
192271,4,3,77,8,69
192323,1,999,4292,1533,2759
192323,2,1,3320,1230,2090
192323,4,3,972,303,669
192439,1,999,9771,2819,6952
192439,2,1,5720,1607,4113
192439,4,3,4051,1212,2839
192448,1,999,12946,3871,9075
192448,2,1,8963,2763,6200
192448,4,3,3983,1108,2875
192475,1,999,253,37,216
192475,2,1,253,37,216
192484,1,999,205,4,201
192484,2,1,205,4,201
192509,1,999,1839,562,1277
192509,2,1,1839,562,1277
192536,1,999,36,23,13
192536,2,1,36,23,13
192554,1,999,621,152,469
192554,4,3,621,152,469
192563,1,999,609,73,536
192563,2,1,35,17,18
192563,4,3,574,56,518
192624,1,999,155,155,0
192624,2,1,155,155,0
192688,1,999,1393,176,1217
192688,2,1,1393,176,1217
192703,1,999,3538,1846,1692
192703,2,1,3086,1657,1429
192703,4,3,452,189,263
192712,1,999,940,444,496
192712,2,1,409,203,206
192712,4,3,531,241,290
192749,1,999,3417,1170,2247
192749,2,1,1781,613,1168
192749,4,3,1636,557,1079
192785,1,999,1089,137,952
192785,2,1,1089,137,952
192800,1,999,42,4,38
192800,2,1,42,4,38
192819,1,999,7278,3038,4240
192819,2,1,6083,2525,3558
192819,4,3,1195,513,682
192828,1,999,102,6,96
192828,2,1,102,6,96
192864,1,999,2328,583,1745
192864,2,1,2328,583,1745
192925,1,999,3227,1016,2211
192925,2,1,2044,716,1328
192925,4,3,1183,300,883
192961,1,999,129,15,114
192961,2,1,129,15,114
192970,1,999,15,6,9
192970,2,1,15,6,9
193016,1,999,13740,3590,10150
193016,2,1,8083,2519,5564
193016,4,3,5657,1071,4586
193052,1,999,233,233,0
193052,2,1,132,132,0
193052,4,3,101,101,0
193061,1,999,43,43,0
193061,2,1,38,38,0
193061,4,3,5,5,0
193070,1,999,86,86,0
193070,2,1,60,60,0
193070,4,3,26,26,0
193122,1,999,156,65,91
193122,2,1,156,65,91
193186,1,999,210,6,204
193186,2,1,210,6,204
193201,1,999,1452,279,1173
193201,2,1,1452,279,1173
193247,1,999,320,320,0
193247,2,1,249,249,0
193247,4,3,71,71,0
193265,1,999,120,117,3
193265,2,1,120,117,3
193283,1,999,9625,4420,5205
193283,2,1,9625,4420,5205
193292,1,999,7052,1965,5087
193292,2,1,5769,1715,4054
193292,4,3,1283,250,1033
193308,1,999,7007,1982,5025
193308,2,1,6704,1882,4822
193308,4,3,303,100,203
193317,1,999,2942,1083,1859
193317,2,1,2654,976,1678
193317,4,3,288,107,181
193326,1,999,34824,17410,17414
193326,2,1,34824,17410,17414
193353,1,999,3144,819,2325
193353,2,1,2562,677,1885
193353,4,3,582,142,440
193380,1,999,150,19,131
193380,2,1,150,19,131
193399,1,999,2268,576,1692
193399,2,1,1676,446,1230
193399,4,3,592,130,462
193405,1,999,1094,503,591
193405,4,3,1094,503,591
193478,1,999,34249,16413,17836
193478,2,1,34249,16413,17836
193584,1,999,3717,807,2910
193584,2,1,2333,579,1754
193584,4,3,1384,228,1156
193609,1,999,97,39,58
193609,2,1,97,39,58
193645,1,999,6196,615,5581
193645,2,1,4895,461,4434
193645,4,3,1301,154,1147
193654,1,999,12745,3888,8857
193654,2,1,8639,2368,6271
193654,4,3,4106,1520,2586
193672,1,999,131,89,42
193672,2,1,131,89,42
193751,1,999,886,492,394
193751,4,3,886,492,394
193760,1,999,1532,560,972
193760,2,1,1532,560,972
193788,1,999,1290,571,719
193788,2,1,1290,571,719
193821,1,999,2044,1001,1043
193821,4,3,2044,1001,1043
193830,1,999,1574,626,948
193830,4,3,1574,626,948
193858,1,999,461,23,438
193858,2,1,461,23,438
193894,1,999,466,256,210
193894,4,3,466,256,210
193900,1,999,50444,20641,29803
193900,2,1,25914,10173,15741
193900,4,3,24530,10468,14062
193946,1,999,9001,3913,5088
193946,2,1,9001,3913,5088
193973,1,999,4846,1839,3007
193973,2,1,3540,1379,2161
193973,4,3,1306,460,846
193991,1,999,90,7,83
193991,2,1,90,7,83
194028,1,999,2807,1176,1631
194028,2,1,2807,1176,1631
194073,1,999,383,211,172
194073,4,3,383,211,172
194091,1,999,11729,6967,4762
194091,2,1,7626,4929,2697
194091,4,3,4103,2038,2065
194116,1,999,918,96,822
194116,2,1,814,75,739
194116,4,3,104,21,83
194161,1,999,3984,1674,2310
194161,2,1,2514,1054,1460
194161,4,3,1470,620,850
194189,1,999,120,120,0
194189,2,1,120,120,0
194204,1,999,102,19,83
194204,2,1,102,19,83
194222,1,999,20141,9578,10563
194222,2,1,20141,9578,10563
194240,1,999,9612,4123,5489
194240,2,1,9612,4123,5489
194259,1,999,47,1,46
194259,2,1,47,1,46
194310,1,999,15402,6219,9183
194310,2,1,9956,4124,5832
194310,4,3,5446,2095,3351
194392,1,999,1089,725,364
194392,2,1,1089,725,364
194435,1,999,209,9,200
194435,2,1,209,9,200
194453,1,999,189,14,175
194453,2,1,189,14,175
194499,1,999,1387,277,1110
194499,2,1,1387,277,1110
194541,1,999,4853,3723,1130
194541,2,1,1854,1503,351
194541,4,3,2999,2220,779
194569,1,999,378,198,180
194569,2,1,378,198,180
194578,1,999,5163,1758,3405
194578,2,1,3174,1193,1981
194578,4,3,1989,565,1424
194611,1,999,1721,600,1121
194611,2,1,1721,600,1121
194657,1,999,272,272,0
194657,2,1,154,154,0
194657,4,3,118,118,0
194666,1,999,325,325,0
194666,2,1,278,278,0
194666,4,3,47,47,0
194675,1,999,49,49,0
194675,2,1,37,37,0
194675,4,3,12,12,0
194693,1,999,43,43,0
194693,2,1,43,43,0
194718,1,999,55,55,0
194718,2,1,52,52,0
194718,4,3,3,3,0
194736,1,999,121,121,0
194736,2,1,121,121,0
194763,1,999,496,496,0
194763,2,1,234,234,0
194763,4,3,262,262,0
194824,1,999,6744,4815,1929
194824,2,1,5452,3902,1550
194824,4,3,1292,913,379
194879,1,999,413,97,316
194879,2,1,413,97,316
194958,1,999,2077,586,1491
194958,2,1,1452,430,1022
194958,4,3,625,156,469
194967,1,999,2037,551,1486
194967,2,1,2037,551,1486
195003,1,999,18865,12837,6028
195003,2,1,15544,10678,4866
195003,4,3,3321,2159,1162
195030,1,999,10834,5157,5677
195030,2,1,6130,2879,3251
195030,4,3,4704,2278,2426
195049,1,999,193,103,90
195049,4,3,193,103,90
195058,1,999,11076,5047,6029
195058,2,1,11076,5047,6029
195067,1,999,1505,87,1418
195067,2,1,1505,87,1418
195128,1,999,3558,703,2855
195128,2,1,1864,411,1453
195128,4,3,1694,292,1402
195155,1,999,146,71,75
195155,4,3,146,71,75
195164,1,999,2760,1273,1487
195164,2,1,2100,1025,1075
195164,4,3,660,248,412
195173,1,999,2928,1315,1613
195173,2,1,2881,1292,1589
195173,4,3,47,23,24
195191,1,999,282,33,249
195191,2,1,282,33,249
195216,1,999,2615,1171,1444
195216,2,1,2452,1114,1338
195216,4,3,163,57,106
195234,1,999,6286,1812,4474
195234,2,1,3394,1049,2345
195234,4,3,2892,763,2129
195243,1,999,2841,1218,1623
195243,2,1,2476,1119,1357
195243,4,3,365,99,266
195289,1,999,177,31,146
195289,2,1,177,31,146
195304,1,999,1792,454,1338
195304,2,1,1383,396,987
195304,4,3,409,58,351
195322,1,999,8640,3913,4727
195322,2,1,8640,3913,4727
195429,1,999,157,96,61
195429,4,3,157,96,61
195438,1,999,224,224,0
195438,2,1,206,206,0
195438,4,3,18,18,0
195474,1,999,3629,1724,1905
195474,2,1,3588,1708,1880
195474,4,3,41,16,25
195492,1,999,34,16,18
195492,2,1,34,16,18
195526,1,999,3001,1138,1863
195526,2,1,2945,1123,1822
195526,4,3,56,15,41
195544,1,999,6706,1847,4859
195544,2,1,5760,1648,4112
195544,4,3,946,199,747
195571,1,999,139,91,48
195571,4,3,139,91,48
195580,1,999,65,59,6
195580,4,3,65,59,6
195623,1,999,44,27,17
195623,2,1,44,27,17
195669,1,999,42,15,27
195669,2,1,42,15,27
195687,1,999,248,32,216
195687,2,1,248,32,216
195702,1,999,30,7,23
195702,2,1,30,7,23
195720,1,999,4328,1663,2665
195720,2,1,3027,1253,1774
195720,4,3,1301,410,891
195784,1,999,481,83,398
195784,2,1,481,83,398
195793,1,999,26,5,21
195793,2,1,26,5,21
195809,1,999,23737,10078,13659
195809,2,1,17289,7669,9620
195809,4,3,6448,2409,4039
195845,1,999,1134,125,1009
195845,2,1,1134,125,1009
195924,1,999,671,150,521
195924,2,1,671,150,521
195933,1,999,1705,588,1117
195933,2,1,1705,588,1117
195988,1,999,2401,998,1403
195988,2,1,2401,998,1403
196006,1,999,4241,2558,1683
196006,2,1,4241,2558,1683
196015,1,999,4671,2207,2464
196015,2,1,4671,2207,2464
196024,1,999,3717,1855,1862
196024,2,1,3717,1855,1862
196033,1,999,2988,1493,1495
196033,2,1,2988,1493,1495
196042,1,999,9524,5329,4195
196042,2,1,9524,5329,4195
196051,1,999,4175,2122,2053
196051,2,1,4175,2122,2053
196060,1,999,20035,9491,10544
196060,2,1,14673,7399,7274
196060,4,3,5362,2092,3270
196079,1,999,16203,8557,7646
196079,2,1,12759,6792,5967
196079,4,3,3444,1765,1679
196088,1,999,32412,16763,15649
196088,2,1,21686,11684,10002
196088,4,3,10726,5079,5647
196097,1,999,29576,14246,15330
196097,2,1,19286,9909,9377
196097,4,3,10290,4337,5953
196103,1,999,2939,1602,1337
196103,2,1,2345,1310,1035
196103,4,3,594,292,302
196112,1,999,3349,1656,1693
196112,2,1,2477,1245,1232
196112,4,3,872,411,461
196121,1,999,9825,4163,5662
196121,2,1,8094,3571,4523
196121,4,3,1731,592,1139
196130,1,999,15142,5979,9163
196130,2,1,11286,4824,6462
196130,4,3,3856,1155,2701
196149,1,999,8448,3577,4871
196149,2,1,6866,2964,3902
196149,4,3,1582,613,969
196158,1,999,6254,2687,3567
196158,2,1,5727,2532,3195
196158,4,3,527,155,372
196167,1,999,6206,2603,3603
196167,2,1,5897,2550,3347
196167,4,3,309,53,256
196176,1,999,9137,3197,5940
196176,2,1,7292,2634,4658
196176,4,3,1845,563,1282
196185,1,999,6862,2885,3977
196185,2,1,6644,2839,3805
196185,4,3,218,46,172
196194,1,999,9770,4526,5244
196194,2,1,8394,4024,4370
196194,4,3,1376,502,874
196200,1,999,5031,2031,3000
196200,2,1,4326,1837,2489
196200,4,3,705,194,511
196219,1,999,5070,2226,2844
196219,2,1,4942,2169,2773
196219,4,3,128,57,71
196228,1,999,305,83,222
196228,4,3,305,83,222
196237,1,999,5405,2303,3102
196237,2,1,5200,2193,3007
196237,4,3,205,110,95
196246,1,999,7454,3269,4185
196246,2,1,6662,3030,3632
196246,4,3,792,239,553
196255,1,999,1880,637,1243
196255,2,1,441,78,363
196255,4,3,1439,559,880
196264,1,999,24904,9490,15414
196264,2,1,23459,8874,14585
196264,4,3,1445,616,829
196291,1,999,2089,1828,261
196291,2,1,1853,1649,204
196291,4,3,236,179,57
196307,1,999,1635,588,1047
196307,2,1,336,85,251
196307,4,3,1299,503,796
196389,1,999,805,245,560
196389,2,1,778,239,539
196389,4,3,27,6,21
196413,1,999,31780,13941,17839
196413,2,1,24399,10467,13932
196413,4,3,7381,3474,3907
196431,1,999,338,338,0
196431,2,1,338,338,0
196440,1,999,28,28,0
196440,2,1,21,21,0
196440,4,3,7,7,0
196468,1,999,6535,1602,4933
196468,4,3,6535,1602,4933
196477,1,999,6907,4374,2533
196477,2,1,6907,4374,2533
196565,1,999,8729,3930,4799
196565,2,1,8729,3930,4799
196583,1,999,209,209,0
196583,2,1,209,209,0
196592,1,999,19687,5601,14086
196592,2,1,9593,3209,6384
196592,4,3,10094,2392,7702
196653,1,999,1961,324,1637
196653,2,1,1961,324,1637
196680,1,999,39401,17670,21731
196680,2,1,37656,17120,20536
196680,4,3,1745,550,1195
196699,1,999,4994,2077,2917
196699,2,1,4994,2077,2917
196857,1,999,4090,401,3689
196857,2,1,4090,401,3689
196866,1,999,2260,1157,1103
196866,2,1,2260,1157,1103
196884,1,999,253,115,138
196884,4,3,253,115,138
197018,1,999,1665,1662,3
197018,2,1,1489,1486,3
197018,4,3,176,176,0
197027,1,999,1071,941,130
197027,2,1,1043,916,127
197027,4,3,28,25,3
197036,1,999,4728,3995,733
197036,2,1,4728,3995,733
197045,1,999,4385,1809,2576
197045,2,1,3126,1330,1796
197045,4,3,1259,479,780
197081,1,999,752,185,567
197081,2,1,752,185,567
197133,1,999,2672,1117,1555
197133,2,1,2672,1117,1555
197142,1,999,572,207,365
197142,2,1,572,207,365
197151,1,999,4669,1894,2775
197151,2,1,4033,1641,2392
197151,4,3,636,253,383
197197,1,999,2387,850,1537
197197,2,1,1905,685,1220
197197,4,3,482,165,317
197221,1,999,80,68,12
197221,2,1,80,68,12
197230,1,999,573,167,406
197230,2,1,573,167,406
197285,1,999,1824,848,976
197285,2,1,1824,848,976
197294,1,999,23080,10335,12745
197294,2,1,23080,10335,12745
197337,1,999,147,9,138
197337,2,1,147,9,138
197522,1,999,705,134,571
197522,2,1,705,134,571
197531,1,999,639,306,333
197531,2,1,639,306,333
197601,1,999,82,82,0
197601,2,1,82,82,0
197610,1,999,102,102,0
197610,2,1,91,91,0
197610,4,3,11,11,0
197647,1,999,178,178,0
197647,2,1,108,108,0
197647,4,3,70,70,0
197674,1,999,252,252,0
197674,2,1,227,227,0
197674,4,3,25,25,0
197692,1,999,94,94,0
197692,2,1,80,80,0
197692,4,3,14,14,0
197708,1,999,7084,3363,3721
197708,2,1,2932,1577,1355
197708,4,3,4152,1786,2366
197735,1,999,554,554,0
197735,2,1,406,406,0
197735,4,3,148,148,0
197744,1,999,250,250,0
197744,2,1,206,206,0
197744,4,3,44,44,0
197814,1,999,3869,1306,2563
197814,2,1,3869,1306,2563
197832,1,999,1642,646,996
197832,2,1,1642,646,996
197850,1,999,3767,1130,2637
197850,2,1,3767,1130,2637
197869,1,999,18911,8647,10264
197869,2,1,16338,7888,8450
197869,4,3,2573,759,1814
197887,1,999,11395,5092,6303
197887,2,1,11395,5092,6303
197911,1,999,1373,367,1006
197911,2,1,1333,364,969
197911,4,3,40,3,37
197966,1,999,2490,841,1649
197966,2,1,2490,841,1649
197984,1,999,1967,780,1187
197984,2,1,1967,780,1187
197993,1,999,816,0,816
197993,2,1,816,0,816
198011,1,999,2460,657,1803
198011,2,1,2460,657,1803
198039,1,999,3408,1453,1955
198039,2,1,3408,1453,1955
198066,1,999,678,390,288
198066,2,1,678,390,288
198075,1,999,402,40,362
198075,2,1,402,40,362
198084,1,999,2121,738,1383
198084,2,1,2121,738,1383
198109,1,999,520,56,464
198109,2,1,520,56,464
198118,1,999,6398,2870,3528
198118,2,1,6398,2870,3528
198136,1,999,7384,3685,3699
198136,2,1,5606,2954,2652
198136,4,3,1778,731,1047
198154,1,999,14123,6637,7486
198154,2,1,14123,6637,7486
198190,1,999,106,75,31
198190,2,1,106,75,31
198206,1,999,2561,836,1725
198206,2,1,2561,836,1725
198215,1,999,1418,633,785
198215,2,1,1382,632,750
198215,4,3,36,1,35
198233,1,999,7966,3359,4607
198233,2,1,7966,3359,4607
198242,1,999,501,126,375
198242,2,1,501,126,375
198251,1,999,7208,2587,4621
198251,2,1,7208,2587,4621
198260,1,999,31997,13690,18307
198260,2,1,31997,13690,18307
198303,1,999,1334,630,704
198303,2,1,1302,630,672
198303,4,3,32,0,32
198321,1,999,5279,2061,3218
198321,2,1,5279,2061,3218
198330,1,999,7974,2939,5035
198330,2,1,7974,2939,5035
198367,1,999,5090,1980,3110
198367,2,1,5090,1980,3110
198376,1,999,5944,2047,3897
198376,2,1,5944,2047,3897
198385,1,999,1901,933,968
198385,2,1,1901,933,968
198419,1,999,16638,8571,8067
198419,2,1,7277,3648,3629
198419,4,3,9361,4923,4438
198455,1,999,8625,3297,5328
198455,2,1,8625,3297,5328
198464,1,999,31334,12409,18925
198464,2,1,23870,9951,13919
198464,4,3,7464,2458,5006
198491,1,999,5191,1368,3823
198491,2,1,5191,1368,3823
198507,1,999,3801,1496,2305
198507,2,1,3697,1469,2228
198507,4,3,104,27,77
198516,1,999,6010,2501,3509
198516,2,1,5255,2173,3082
198516,4,3,755,328,427
198525,1,999,66,6,60
198525,2,1,66,6,60
198534,1,999,17395,6243,11152
198534,2,1,17395,6243,11152
198543,1,999,7206,2333,4873
198543,2,1,6184,2056,4128
198543,4,3,1022,277,745
198552,1,999,14180,5634,8546
198552,2,1,14180,5634,8546
198561,1,999,5552,1941,3611
198561,2,1,3544,1264,2280
198561,4,3,2008,677,1331
198570,1,999,9304,3265,6039
198570,2,1,9304,3265,6039
198598,1,999,1370,616,754
198598,2,1,1269,589,680
198598,4,3,101,27,74
198613,1,999,3234,1326,1908
198613,2,1,3234,1326,1908
198622,1,999,19442,8643,10799
198622,2,1,19442,8643,10799
198631,1,999,115,88,27
198631,2,1,115,88,27
198640,1,999,2482,914,1568
198640,2,1,2482,914,1568
198668,1,999,3756,1451,2305
198668,2,1,3756,1451,2305
198677,1,999,72,41,31
198677,2,1,72,41,31
198695,1,999,4330,1686,2644
198695,2,1,3900,1545,2355
198695,4,3,430,141,289
198710,1,999,3091,1224,1867
198710,2,1,3091,1224,1867
198729,1,999,2125,676,1449
198729,2,1,2125,676,1449
198747,1,999,837,494,343
198747,2,1,631,385,246
198747,4,3,206,109,97
198756,1,999,1655,677,978
198756,2,1,1655,677,978
198774,1,999,5800,2122,3678
198774,2,1,5800,2122,3678
198808,1,999,941,371,570
198808,2,1,941,371,570
198817,1,999,6060,2155,3905
198817,2,1,6060,2155,3905
198835,1,999,2047,725,1322
198835,2,1,1715,635,1080
198835,4,3,332,90,242
198844,1,999,184,14,170
198844,2,1,184,14,170
198862,1,999,1260,711,549
198862,2,1,1260,711,549
198871,1,999,804,565,239
198871,2,1,804,565,239
198899,1,999,1322,640,682
198899,2,1,1322,640,682
198905,1,999,1033,344,689
198905,2,1,1033,344,689
198914,1,999,2210,1005,1205
198914,2,1,2210,1005,1205
198923,1,999,2277,962,1315
198923,2,1,2277,962,1315
198941,1,999,205,35,170
198941,2,1,205,35,170
198950,1,999,2316,47,2269
198950,2,1,1954,4,1950
198950,4,3,362,43,319
198969,1,999,2840,1451,1389
198969,2,1,2615,1356,1259
198969,4,3,225,95,130
198978,1,999,2566,476,2090
198978,2,1,2566,476,2090
198987,1,999,5002,1764,3238
198987,2,1,5002,1764,3238
198996,1,999,11,2,9
198996,2,1,11,2,9
199005,1,999,23,0,23
199005,2,1,23,0,23
199014,1,999,46,8,38
199014,2,1,46,8,38
199023,1,999,1391,478,913
199023,2,1,1391,478,913
199032,1,999,1595,595,1000
199032,2,1,1248,492,756
199032,4,3,347,103,244
199069,1,999,5101,1701,3400
199069,2,1,5101,1701,3400
199078,1,999,84,5,79
199078,2,1,84,5,79
199087,1,999,4862,2082,2780
199087,2,1,4862,2082,2780
199102,1,999,12611,5800,6811
199102,2,1,10560,4975,5585
199102,4,3,2051,825,1226
199111,1,999,4645,2050,2595
199111,2,1,4578,2023,2555
199111,4,3,67,27,40
199120,1,999,32426,13365,19061
199120,2,1,19776,8166,11610
199120,4,3,12650,5199,7451
199139,1,999,29290,13767,15523
199139,2,1,22637,11161,11476
199139,4,3,6653,2606,4047
199148,1,999,22740,7705,15035
199148,2,1,18109,6244,11865
199148,4,3,4631,1461,3170
199157,1,999,9967,3299,6668
199157,2,1,7499,2545,4954
199157,4,3,2468,754,1714
199184,1,999,886,517,369
199184,2,1,753,456,297
199184,4,3,133,61,72
199193,1,999,40165,22016,18149
199193,2,1,28917,16063,12854
199193,4,3,11248,5953,5295
199209,1,999,1767,679,1088
199209,2,1,1767,679,1088
199218,1,999,14964,5990,8974
199218,2,1,13415,5436,7979
199218,4,3,1549,554,995
199263,1,999,881,346,535
199263,2,1,881,346,535
199272,1,999,889,37,852
199272,2,1,889,37,852
199281,1,999,8189,2999,5190
199281,2,1,7221,2723,4498
199281,4,3,968,276,692
199306,1,999,2408,827,1581
199306,2,1,1181,508,673
199306,4,3,1227,319,908
199315,1,999,510,342,168
199315,2,1,374,222,152
199315,4,3,136,120,16
199324,1,999,3862,1621,2241
199324,2,1,3862,1621,2241
199333,1,999,11834,5020,6814
199333,2,1,11834,5020,6814
199412,1,999,3036,754,2282
199412,2,1,2332,535,1797
199412,4,3,704,219,485
199421,1,999,3735,1363,2372
199421,2,1,3735,1363,2372
199449,1,999,2976,963,2013
199449,2,1,2976,963,2013
199458,1,999,187,107,80
199458,2,1,187,107,80
199467,1,999,1245,489,756
199467,2,1,1245,489,756
199476,1,999,3907,1205,2702
199476,2,1,3907,1205,2702
199485,1,999,3333,1235,2098
199485,2,1,3333,1235,2098
199494,1,999,10601,4067,6534
199494,2,1,10601,4067,6534
199582,1,999,1640,854,786
199582,2,1,1640,854,786
199607,1,999,1201,83,1118
199607,2,1,931,49,882
199607,4,3,270,34,236
199625,1,999,2079,608,1471
199625,2,1,2079,608,1471
199634,1,999,6357,2226,4131
199634,2,1,6357,2226,4131
199643,1,999,3037,1223,1814
199643,2,1,2838,1127,1711
199643,4,3,199,96,103
199689,1,999,207,13,194
199689,2,1,207,13,194
199698,1,999,468,196,272
199698,2,1,468,196,272
199713,1,999,221,20,201
199713,2,1,221,20,201
199722,1,999,3174,979,2195
199722,2,1,3174,979,2195
199731,1,999,3608,1460,2148
199731,2,1,3608,1460,2148
199740,1,999,4840,1592,3248
199740,2,1,4840,1592,3248
199768,1,999,4906,1919,2987
199768,2,1,4906,1919,2987
199786,1,999,7628,2848,4780
199786,2,1,7628,2848,4780
199795,1,999,2026,764,1262
199795,2,1,2026,764,1262
199838,1,999,5788,2005,3783
199838,2,1,5788,2005,3783
199847,1,999,7657,3896,3761
199847,2,1,4867,2353,2514
199847,4,3,2790,1543,1247
199856,1,999,26315,11833,14482
199856,2,1,26315,11833,14482
199865,1,999,1084,400,684
199865,2,1,994,372,622
199865,4,3,90,28,62
199883,1,999,170,23,147
199883,2,1,170,23,147
199892,1,999,5396,2029,3367
199892,2,1,5396,2029,3367
199908,1,999,4335,1708,2627
199908,2,1,4335,1708,2627
199926,1,999,3871,1565,2306
199926,2,1,3871,1565,2306
199953,1,999,3353,1149,2204
199953,2,1,3353,1149,2204
199962,1,999,2599,1139,1460
199962,2,1,1739,796,943
199962,4,3,860,343,517
199971,1,999,62,28,34
199971,2,1,62,28,34
199980,1,999,82,76,6
199980,2,1,82,76,6
199999,1,999,7465,2111,5354
199999,2,1,6897,1973,4924
199999,4,3,568,138,430
200004,1,999,11379,4873,6506
200004,2,1,8834,4004,4830
200004,4,3,2545,869,1676
200013,1,999,2688,772,1916
200013,2,1,2688,772,1916
200022,1,999,5089,2846,2243
200022,2,1,5089,2846,2243
200059,1,999,2966,1146,1820
200059,2,1,2966,1146,1820
200086,1,999,335,103,232
200086,2,1,335,103,232
200110,1,999,111,1,110
200110,2,1,111,1,110
200129,1,999,104,5,99
200129,2,1,104,5,99
200156,1,999,1133,498,635
200156,2,1,1127,494,633
200156,4,3,6,4,2
200165,1,999,126,2,124
200165,2,1,126,2,124
200192,1,999,3220,1378,1842
200192,2,1,3220,1378,1842
200208,1,999,399,154,245
200208,2,1,399,154,245
200217,1,999,3934,1453,2481
200217,2,1,2535,1001,1534
200217,4,3,1399,452,947
200226,1,999,1318,540,778
200226,2,1,1318,540,778
200244,1,999,141,16,125
200244,2,1,141,16,125
200253,1,999,4810,1860,2950
200253,2,1,4337,1747,2590
200253,4,3,473,113,360
200262,1,999,18,7,11
200262,2,1,18,7,11
200280,1,999,16882,8867,8015
200280,2,1,13107,7389,5718
200280,4,3,3775,1478,2297
200305,1,999,3399,1848,1551
200305,2,1,3399,1848,1551
200314,1,999,1138,520,618
200314,2,1,1138,520,618
200332,1,999,17001,8992,8009
200332,2,1,13073,7283,5790
200332,4,3,3928,1709,2219
200341,1,999,1219,394,825
200341,2,1,1219,394,825
200387,1,999,109,5,104
200387,2,1,109,5,104
200466,1,999,416,155,261
200466,2,1,416,155,261
200484,1,999,317,185,132
200484,2,1,317,185,132
200527,1,999,1082,397,685
200527,2,1,1082,397,685
200554,1,999,1060,414,646
200554,2,1,1060,414,646
200572,1,999,1621,673,948
200572,2,1,1417,597,820
200572,4,3,204,76,128
200590,1,999,446,176,270
200590,2,1,446,176,270
200624,1,999,63,32,31
200624,2,1,63,32,31
200633,1,999,609,102,507
200633,2,1,609,102,507
200697,1,999,946,840,106
200697,4,3,946,840,106
200785,1,999,1491,397,1094
200785,2,1,1491,397,1094
200800,1,999,32183,15795,16388
200800,2,1,25976,13320,12656
200800,4,3,6207,2475,3732
200828,1,999,77,7,70
200828,2,1,77,7,70
200846,1,999,3018,1211,1807
200846,2,1,3018,1211,1807
200873,1,999,52,27,25
200873,2,1,52,27,25
201016,1,999,574,161,413
201016,2,1,574,161,413
201034,1,999,2166,960,1206
201034,2,1,2166,960,1206
201061,1,999,222,90,132
201061,2,1,212,83,129
201061,4,3,10,7,3
201098,1,999,152,65,87
201098,2,1,152,65,87
201104,1,999,8919,3751,5168
201104,2,1,3688,1761,1927
201104,4,3,5231,1990,3241
201131,1,999,211,76,135
201131,2,1,211,76,135
201140,1,999,266,186,80
201140,2,1,129,99,30
201140,4,3,137,87,50
201159,1,999,538,289,249
201159,2,1,538,289,249
201177,1,999,353,57,296
201177,2,1,353,57,296
201195,1,999,4948,2054,2894
201195,2,1,3952,1696,2256
201195,4,3,996,358,638
201283,1,999,3352,1335,2017
201283,2,1,3352,1335,2017
201371,1,999,1325,582,743
201371,2,1,1089,506,583
201371,4,3,236,76,160
201399,1,999,776,305,471
201399,2,1,776,305,471
201432,1,999,3114,1085,2029
201432,2,1,3114,1085,2029
201441,1,999,20442,9201,11241
201441,2,1,16389,7648,8741
201441,4,3,4053,1553,2500
201469,1,999,1398,279,1119
201469,2,1,1398,279,1119
201478,1,999,161,69,92
201478,2,1,161,69,92
201496,1,999,607,310,297
201496,2,1,607,310,297
201539,1,999,150,29,121
201539,2,1,150,29,121
201548,1,999,4223,1845,2378
201548,2,1,3168,1288,1880
201548,4,3,1055,557,498
201584,1,999,78,7,71
201584,2,1,78,7,71
201609,1,999,51,0,51
201609,2,1,51,0,51
201618,1,999,44,1,43
201618,2,1,44,1,43
201627,1,999,95,3,92
201627,2,1,95,3,92
201645,1,999,10586,5377,5209
201645,2,1,4419,2514,1905
201645,4,3,6167,2863,3304
201654,1,999,3460,1579,1881
201654,2,1,3319,1538,1781
201654,4,3,141,41,100
201672,1,999,7167,2188,4979
201672,2,1,7167,2188,4979
201681,1,999,179,19,160
201681,2,1,179,19,160
201690,1,999,2694,1379,1315
201690,2,1,2633,1350,1283
201690,4,3,61,29,32
201751,1,999,435,71,364
201751,2,1,435,71,364
201803,1,999,251,65,186
201803,2,1,251,65,186
201821,1,999,387,35,352
201821,2,1,387,35,352
201858,1,999,1230,739,491
201858,2,1,874,497,377
201858,4,3,356,242,114
201867,1,999,173,81,92
201867,2,1,173,81,92
201885,1,999,38041,17287,20754
201885,2,1,25583,12277,13306
201885,4,3,12458,5010,7448
201928,1,999,20561,9785,10776
201928,2,1,20561,9785,10776
201946,1,999,5524,2321,3203
201946,2,1,5493,2311,3182
201946,4,3,31,10,21
201955,1,999,6902,2653,4249
201955,2,1,6856,2640,4216
201955,4,3,46,13,33
201964,1,999,2017,871,1146
201964,2,1,1994,856,1138
201964,4,3,23,15,8
201973,1,999,8627,3159,5468
201973,2,1,8627,3159,5468
201982,1,999,95,3,92
201982,2,1,95,3,92
202046,1,999,546,244,302
202046,2,1,546,244,302
202055,1,999,417,24,393
202055,2,1,417,24,393
202073,1,999,471,211,260
202073,2,1,262,125,137
202073,4,3,209,86,123
202134,1,999,21717,9609,12108
202134,2,1,14142,6383,7759
202134,4,3,7575,3226,4349
202152,1,999,745,345,400
202152,2,1,745,345,400
202161,1,999,986,363,623
202161,2,1,986,363,623
202170,1,999,1645,631,1014
202170,2,1,1634,626,1008
202170,4,3,11,5,6
202189,1,999,813,191,622
202189,2,1,813,191,622
202222,1,999,49876,21639,28237
202222,2,1,49876,21639,28237
202268,1,999,98,16,82
202268,2,1,98,16,82
202356,1,999,46854,18417,28437
202356,2,1,46854,18417,28437
202435,1,999,778,133,645
202435,2,1,778,133,645
202453,1,999,92,82,10
202453,2,1,92,82,10
202480,1,999,12525,6088,6437
202480,2,1,8001,4050,3951
202480,4,3,4524,2038,2486
202514,1,999,1224,572,652
202514,2,1,1095,524,571
202514,4,3,129,48,81
202523,1,999,2309,1022,1287
202523,2,1,2309,1022,1287
202541,1,999,6794,3775,3019
202541,2,1,6794,3775,3019
202611,1,999,1066,399,667
202611,2,1,763,233,530
202611,4,3,303,166,137
202639,1,999,160,9,151
202639,2,1,160,9,151
202648,1,999,5043,1873,3170
202648,2,1,5038,1873,3165
202648,4,3,5,0,5
202657,1,999,683,267,416
202657,2,1,683,267,416
202684,1,999,1768,424,1344
202684,2,1,1768,424,1344
202736,1,999,205,9,196
202736,2,1,205,9,196
202763,1,999,6746,2603,4143
202763,2,1,4825,1903,2922
202763,4,3,1921,700,1221
202806,1,999,11707,4851,6856
202806,2,1,10391,4295,6096
202806,4,3,1316,556,760
202888,1,999,148,15,133
202888,2,1,148,15,133
202903,1,999,358,186,172
202903,2,1,358,186,172
202912,1,999,379,40,339
202912,2,1,379,40,339
202949,1,999,484,363,121
202949,2,1,484,363,121
202985,1,999,151,29,122
202985,2,1,151,29,122
203030,1,999,138,26,112
203030,2,1,138,26,112
203067,1,999,417,164,253
203067,4,3,417,164,253
203085,1,999,1741,792,949
203085,2,1,1349,686,663
203085,4,3,392,106,286
203128,1,999,1478,645,833
203128,2,1,1438,637,801
203128,4,3,40,8,32
203146,1,999,483,472,11
203146,2,1,483,472,11
203155,1,999,9877,5256,4621
203155,2,1,9877,5256,4621
203225,1,999,655,408,247
203225,2,1,655,408,247
203234,1,999,198,10,188
203234,2,1,198,10,188
203289,1,999,152,133,19
203289,2,1,152,133,19
203313,1,999,908,710,198
203313,2,1,908,710,198
203331,1,999,3220,1249,1971
203331,2,1,3220,1249,1971
203368,1,999,4236,1921,2315
203368,2,1,3124,1546,1578
203368,4,3,1112,375,737
203386,1,999,1411,215,1196
203386,2,1,1411,215,1196
203438,1,999,128,4,124
203438,2,1,128,4,124
203447,1,999,3509,1267,2242
203447,2,1,3490,1254,2236
203447,4,3,19,13,6
203456,1,999,2067,602,1465
203456,2,1,2064,602,1462
203456,4,3,3,0,3
203465,1,999,6819,2683,4136
203465,2,1,6687,2636,4051
203465,4,3,132,47,85
203474,1,999,4794,1765,3029
203474,2,1,4749,1746,3003
203474,4,3,45,19,26
203483,1,999,3502,1477,2025
203483,2,1,3469,1468,2001
203483,4,3,33,9,24
203492,1,999,2907,850,2057
203492,2,1,2902,847,2055
203492,4,3,5,3,2
203517,1,999,32075,12569,19506
203517,2,1,24620,10292,14328
203517,4,3,7455,2277,5178
203526,1,999,4079,1373,2706
203526,2,1,4042,1357,2685
203526,4,3,37,16,21
203535,1,999,1745,814,931
203535,2,1,1745,814,931
203544,1,999,1098,252,846
203544,2,1,966,212,754
203544,4,3,132,40,92
203580,1,999,1301,617,684
203580,2,1,1032,493,539
203580,4,3,269,124,145
203599,1,999,13777,5573,8204
203599,2,1,13777,5573,8204
203614,1,999,693,280,413
203614,2,1,693,280,413
203678,1,999,5721,1847,3874
203678,2,1,5721,1847,3874
203720,1,999,740,120,620
203720,2,1,740,120,620
203739,1,999,738,179,559
203739,2,1,738,179,559
203748,1,999,17961,6534,11427
203748,2,1,17961,6534,11427
203757,1,999,3072,653,2419
203757,2,1,2715,592,2123
203757,4,3,357,61,296
203775,1,999,3539,1247,2292
203775,2,1,2390,984,1406
203775,4,3,1149,263,886
203845,1,999,1797,843,954
203845,2,1,1553,797,756
203845,4,3,244,46,198
203881,1,999,3829,1688,2141
203881,2,1,3829,1688,2141
203942,1,999,208,80,128
203942,2,1,208,80,128
203960,1,999,1345,196,1149
203960,2,1,1345,196,1149
203997,1,999,268,107,161
203997,4,3,268,107,161
204006,1,999,4927,2194,2733
204006,2,1,4914,2192,2722
204006,4,3,13,2,11
204015,1,999,3058,1278,1780
204015,2,1,3051,1277,1774
204015,4,3,7,1,6
204024,1,999,20088,8679,11409
204024,2,1,15846,7489,8357
204024,4,3,4242,1190,3052
204060,1,999,1056,208,848
204060,2,1,1056,208,848
204121,1,999,92,2,90
204121,2,1,92,2,90
204158,1,999,600,156,444
204158,2,1,600,156,444
204176,1,999,1033,90,943
204176,2,1,892,81,811
204176,4,3,141,9,132
204185,1,999,2354,1202,1152
204185,2,1,2277,1184,1093
204185,4,3,77,18,59
204194,1,999,3028,1075,1953
204194,2,1,2173,817,1356
204194,4,3,855,258,597
204200,1,999,2947,971,1976
204200,2,1,2342,834,1508
204200,4,3,605,137,468
204255,1,999,4007,1710,2297
204255,2,1,4007,1710,2297
204264,1,999,3494,1330,2164
204264,2,1,2001,958,1043
204264,4,3,1493,372,1121
204307,1,999,1249,280,969
204307,2,1,1249,280,969
204316,1,999,2090,503,1587
204316,2,1,2090,503,1587
204334,1,999,197,8,189
204334,2,1,197,8,189
204422,1,999,4972,1835,3137
204422,2,1,4972,1835,3137
204431,1,999,39,8,31
204431,2,1,39,8,31
204440,1,999,8494,5189,3305
204440,2,1,8494,5189,3305
204459,1,999,211,73,138
204459,2,1,211,73,138
204468,1,999,2552,1010,1542
204468,2,1,2088,896,1192
204468,4,3,464,114,350
204477,1,999,767,386,381
204477,4,3,767,386,381
204486,1,999,5487,4365,1122
204486,2,1,5425,4343,1082
204486,4,3,62,22,40
204501,1,999,3111,1401,1710
204501,2,1,3084,1389,1695
204501,4,3,27,12,15
204547,1,999,458,282,176
204547,4,3,458,282,176
204592,1,999,124,20,104
204592,2,1,124,20,104
204608,1,999,1471,1411,60
204608,2,1,1471,1411,60
204617,1,999,3726,1380,2346
204617,2,1,2550,990,1560
204617,4,3,1176,390,786
204626,1,999,1096,390,706
204626,2,1,1096,390,706
204635,1,999,3686,1854,1832
204635,2,1,2652,1367,1285
204635,4,3,1034,487,547
204662,1,999,802,491,311
204662,2,1,802,491,311
204671,1,999,1822,810,1012
204671,2,1,1665,787,878
204671,4,3,157,23,134
204680,1,999,1761,749,1012
204680,2,1,1666,739,927
204680,4,3,95,10,85
204699,1,999,2143,965,1178
204699,2,1,2059,946,1113
204699,4,3,84,19,65
204705,1,999,3076,1502,1574
204705,2,1,2946,1485,1461
204705,4,3,130,17,113
204714,1,999,275,10,265
204714,2,1,275,10,265
204723,1,999,228,206,22
204723,2,1,228,206,22
204741,1,999,70,33,37
204741,2,1,70,33,37
204769,1,999,105,11,94
204769,2,1,105,11,94
204778,1,999,105,27,78
204778,2,1,105,27,78
204796,1,999,64425,32765,31660
204796,2,1,47539,25133,22406
204796,4,3,16886,7632,9254
204802,1,999,1347,503,844
204802,2,1,1347,503,844
204820,1,999,3514,1275,2239
204820,2,1,3514,1275,2239
204839,1,999,3223,1123,2100
204839,2,1,3223,1123,2100
204848,1,999,3568,1390,2178
204848,2,1,3568,1390,2178
204857,1,999,31129,13138,17991
204857,2,1,25318,10690,14628
204857,4,3,5811,2448,3363
204866,1,999,3535,1073,2462
204866,2,1,3535,1073,2462
204884,1,999,344,55,289
204884,2,1,344,55,289
204893,1,999,85,10,75
204893,2,1,85,10,75
204909,1,999,1921,855,1066
204909,2,1,1921,855,1066
204936,1,999,3516,1233,2283
204936,2,1,2894,1103,1791
204936,4,3,622,130,492
204945,1,999,28080,15020,13060
204945,2,1,28080,15020,13060
204963,1,999,164,13,151
204963,2,1,164,13,151
204981,1,999,150,16,134
204981,2,1,150,16,134
204990,1,999,183,87,96
204990,4,3,183,87,96
205027,1,999,159,157,2
205027,2,1,87,87,0
205027,4,3,72,70,2
205054,1,999,541,110,431
205054,2,1,541,110,431
205090,1,999,99,15,84
205090,2,1,99,15,84
205124,1,999,83,83,0
205124,2,1,61,61,0
205124,4,3,22,22,0
205142,1,999,216,42,174
205142,2,1,216,42,174
205179,1,999,4151,988,3163
205179,2,1,4151,988,3163
205203,1,999,3028,1184,1844
205203,2,1,2900,1134,1766
205203,4,3,128,50,78
205391,1,999,118,35,83
205391,2,1,118,35,83
205443,1,999,5450,2333,3117
205443,2,1,5346,2324,3022
205443,4,3,104,9,95
205470,1,999,36470,16135,20335
205470,2,1,36470,16135,20335
205513,1,999,227,54,173
205513,2,1,227,54,173
205522,1,999,293,75,218
205522,2,1,293,75,218
205531,1,999,222,52,170
205531,2,1,222,52,170
205559,1,999,306,61,245
205559,2,1,306,61,245
205568,1,999,338,77,261
205568,2,1,338,77,261
205610,1,999,4312,1273,3039
205610,2,1,4312,1273,3039
205647,1,999,2316,417,1899
205647,2,1,2316,417,1899
205692,1,999,617,127,490
205692,2,1,617,127,490
205708,1,999,1964,323,1641
205708,2,1,1964,323,1641
205717,1,999,1714,357,1357
205717,2,1,1714,357,1357
205726,1,999,1737,393,1344
205726,2,1,1737,393,1344
205841,1,999,19169,8440,10729
205841,2,1,19169,8440,10729
205887,1,999,1581,210,1371
205887,2,1,1581,210,1371
205957,1,999,3436,1389,2047
205957,2,1,2374,943,1431
205957,4,3,1062,446,616
205966,1,999,5085,1554,3531
205966,2,1,5085,1554,3531
206002,1,999,65,51,14
206002,2,1,65,51,14
206011,1,999,4631,2046,2585
206011,2,1,4631,2046,2585
206039,1,999,108,0,108
206039,2,1,108,0,108
206048,1,999,7815,3126,4689
206048,2,1,6144,2458,3686
206048,4,3,1671,668,1003
206084,1,999,25597,12762,12835
206084,2,1,19587,10182,9405
206084,4,3,6010,2580,3430
206093,1,999,914,516,398
206093,2,1,914,516,398
206154,1,999,64,42,22
206154,2,1,64,42,22
206172,1,999,253,26,227
206172,2,1,253,26,227
206181,1,999,246,66,180
206181,2,1,246,66,180
206215,1,999,199,108,91
206215,4,3,199,108,91
206224,1,999,603,117,486
206224,2,1,603,117,486
206279,1,999,2434,942,1492
206279,2,1,1878,811,1067
206279,4,3,556,131,425
206288,1,999,496,293,203
206288,4,3,496,293,203
206321,1,999,1213,724,489
206321,2,1,1213,724,489
206330,1,999,2286,1071,1215
206330,2,1,1990,967,1023
206330,4,3,296,104,192
206349,1,999,1800,217,1583
206349,2,1,1158,110,1048
206349,4,3,642,107,535
206358,1,999,63,5,58
206358,2,1,63,5,58
206394,1,999,361,97,264
206394,2,1,361,97,264
206419,1,999,156,8,148
206419,2,1,156,8,148
206428,1,999,78,5,73
206428,2,1,78,5,73
206437,1,999,3500,1257,2243
206437,2,1,2557,958,1599
206437,4,3,943,299,644
206446,1,999,3389,2071,1318
206446,2,1,3389,2071,1318
206482,1,999,351,20,331
206482,2,1,351,20,331
206491,1,999,757,307,450
206491,2,1,748,303,445
206491,4,3,9,4,5
206507,1,999,1819,822,997
206507,2,1,1725,806,919
206507,4,3,94,16,78
206516,1,999,117,82,35
206516,4,3,117,82,35
206525,1,999,2120,908,1212
206525,2,1,1997,897,1100
206525,4,3,123,11,112
206589,1,999,2001,908,1093
206589,2,1,2001,908,1093
206604,1,999,22378,10032,12346
206604,2,1,16556,7564,8992
206604,4,3,5822,2468,3354
206613,1,999,2255,884,1371
206613,2,1,2023,825,1198
206613,4,3,232,59,173
206622,1,999,8695,3853,4842
206622,2,1,4990,2305,2685
206622,4,3,3705,1548,2157
206631,1,999,1282,834,448
206631,2,1,1282,834,448
206695,1,999,18058,8300,9758
206695,2,1,16184,7624,8560
206695,4,3,1874,676,1198
206783,1,999,62,47,15
206783,2,1,62,47,15
206817,1,999,1403,678,725
206817,2,1,1403,678,725
206835,1,999,1822,709,1113
206835,2,1,1697,646,1051
206835,4,3,125,63,62
206862,1,999,2873,1331,1542
206862,2,1,2070,1018,1052
206862,4,3,803,313,490
206880,1,999,190,8,182
206880,2,1,190,8,182
206905,1,999,305,132,173
206905,2,1,305,132,173
206914,1,999,8227,3378,4849
206914,2,1,7587,3147,4440
206914,4,3,640,231,409
206923,1,999,3540,1186,2354
206923,2,1,3540,1186,2354
206932,1,999,235,10,225
206932,2,1,235,10,225
206941,1,999,20435,8531,11904
206941,2,1,18059,7884,10175
206941,4,3,2376,647,1729
206969,1,999,25,0,25
206969,2,1,25,0,25
206996,1,999,3647,1184,2463
206996,2,1,3647,1184,2463
207041,1,999,6140,2385,3755
207041,2,1,4687,1941,2746
207041,4,3,1453,444,1009
207050,1,999,2824,952,1872
207050,2,1,2824,952,1872
207069,1,999,3670,1333,2337
207069,2,1,3670,1333,2337
207087,1,999,82,6,76
207087,2,1,82,6,76
207102,1,999,147,13,134
207102,2,1,147,13,134
207157,1,999,259,164,95
207157,2,1,247,153,94
207157,4,3,12,11,1
207166,1,999,22,1,21
207166,2,1,22,1,21
207209,1,999,3510,1386,2124
207209,2,1,2812,1196,1616
207209,4,3,698,190,508
207236,1,999,3776,1141,2635
207236,2,1,3776,1141,2635
207254,1,999,1554,1440,114
207254,2,1,1554,1440,114
207263,1,999,11675,4483,7192
207263,2,1,10135,4041,6094
207263,4,3,1540,442,1098
207272,1,999,55,3,52
207272,2,1,55,3,52
207281,1,999,7483,2997,4486
207281,2,1,7483,2997,4486
207290,1,999,3267,1457,1810
207290,2,1,3267,1457,1810
207306,1,999,2629,1151,1478
207306,2,1,2385,1077,1308
207306,4,3,244,74,170
207315,1,999,438,217,221
207315,4,3,438,217,221
207324,1,999,2502,1361,1141
207324,2,1,2035,1053,982
207324,4,3,467,308,159
207342,1,999,4483,1430,3053
207342,2,1,1350,210,1140
207342,4,3,3133,1220,1913
207351,1,999,1651,797,854
207351,2,1,1651,797,854
207388,1,999,26807,13794,13013
207388,2,1,20400,10387,10013
207388,4,3,6407,3407,3000
207397,1,999,15332,6405,8927
207397,2,1,15332,6405,8927
207403,1,999,1993,826,1167
207403,2,1,1905,807,1098
207403,4,3,88,19,69
207449,1,999,22522,9604,12918
207449,2,1,22522,9604,12918
207458,1,999,4454,1916,2538
207458,2,1,2728,1020,1708
207458,4,3,1726,896,830
207500,1,999,30642,15463,15179
207500,2,1,22228,11176,11052
207500,4,3,8414,4287,4127
207537,1,999,75,13,62
207537,2,1,75,13,62
207564,1,999,5368,3336,2032
207564,2,1,5368,3336,2032
207582,1,999,3406,1482,1924
207582,2,1,2751,1144,1607
207582,4,3,655,338,317
207607,1,999,649,303,346
207607,2,1,649,303,346
207625,1,999,264,22,242
207625,2,1,264,22,242
207661,1,999,5753,2184,3569
207661,2,1,5753,2184,3569
207670,1,999,13831,5776,8055
207670,2,1,13831,5776,8055
207689,1,999,940,385,555
207689,2,1,861,351,510
207689,4,3,79,34,45
207704,1,999,210,11,199
207704,2,1,210,11,199
207722,1,999,1259,468,791
207722,2,1,1259,468,791
207740,1,999,3233,1057,2176
207740,2,1,3233,1057,2176
207786,1,999,36,1,35
207786,2,1,36,1,35
207847,1,999,5237,2330,2907
207847,2,1,4698,2057,2641
207847,4,3,539,273,266
207856,1,999,501,251,250
207856,2,1,431,205,226
207856,4,3,70,46,24
207865,1,999,6303,2652,3651
207865,2,1,5150,2168,2982
207865,4,3,1153,484,669
207935,1,999,30473,12051,18422
207935,2,1,30473,12051,18422
207962,1,999,1853,1771,82
207962,2,1,1853,1771,82
207971,1,999,4596,2553,2043
207971,2,1,3384,1879,1505
207971,4,3,1212,674,538
208017,1,999,55,6,49
208017,2,1,55,6,49
208026,1,999,306,191,115
208026,2,1,306,191,115
208035,1,999,7056,4427,2629
208035,2,1,7056,4427,2629
208044,1,999,33,1,32
208044,2,1,33,1,32
208053,1,999,280,155,125
208053,2,1,280,155,125
208080,1,999,95,26,69
208080,2,1,95,26,69
208123,1,999,185,38,147
208123,2,1,185,38,147
208239,1,999,2365,1159,1206
208239,2,1,2365,1159,1206
208248,1,999,285,75,210
208248,2,1,285,75,210
208275,1,999,4410,1787,2623
208275,2,1,4410,1787,2623
208318,1,999,10843,5079,5764
208318,2,1,10843,5079,5764
208390,1,999,22782,9993,12789
208390,2,1,22782,9993,12789
208406,1,999,17054,8487,8567
208406,2,1,17054,8487,8567
208415,1,999,2912,1700,1212
208415,2,1,2912,1700,1212
208433,1,999,114,3,111
208433,2,1,114,3,111
208479,1,999,932,124,808
208479,2,1,932,124,808
208488,1,999,2945,953,1992
208488,2,1,1412,519,893
208488,4,3,1533,434,1099
208512,1,999,374,110,264
208512,2,1,374,110,264
208637,1,999,435,107,328
208637,2,1,435,107,328
208646,1,999,6021,2246,3775
208646,2,1,5058,1962,3096
208646,4,3,963,284,679
208655,1,999,247,33,214
208655,2,1,247,33,214
208725,1,999,125,74,51
208725,2,1,125,74,51
208822,1,999,4237,1812,2425
208822,2,1,2295,946,1349
208822,4,3,1942,866,1076
208859,1,999,90,4,86
208859,2,1,90,4,86
208965,1,999,1629,1241,388
208965,2,1,1629,1241,388
209038,1,999,18949,9223,9726
209038,2,1,18949,9223,9726
209056,1,999,4361,1682,2679
209056,2,1,2116,859,1257
209056,4,3,2245,823,1422
209065,1,999,1773,733,1040
209065,2,1,1773,733,1040
209074,1,999,13407,6300,7107
209074,2,1,13407,6300,7107
209083,1,999,98,10,88
209083,2,1,98,10,88
209108,1,999,2673,961,1712
209108,2,1,1296,370,926
209108,4,3,1377,591,786
209153,1,999,116,8,108
209153,2,1,116,8,108
209205,1,999,234,28,206
209205,2,1,234,28,206
209241,1,999,205,197,8
209241,2,1,104,104,0
209241,4,3,101,93,8
209250,1,999,17017,8009,9008
209250,2,1,17017,8009,9008
209287,1,999,1116,633,483
209287,2,1,718,388,330
209287,4,3,398,245,153
209296,1,999,574,124,450
209296,4,3,574,124,450
209348,1,999,38,0,38
209348,2,1,38,0,38
209409,1,999,667,243,424
209409,2,1,522,197,325
209409,4,3,145,46,99
209490,1,999,3141,1153,1988
209490,2,1,847,129,718
209490,4,3,2294,1024,1270
209506,1,999,4987,2544,2443
209506,2,1,4952,2515,2437
209506,4,3,35,29,6
209533,1,999,157,40,117
209533,2,1,145,38,107
209533,4,3,12,2,10
209542,1,999,28188,14404,13784
209542,2,1,22637,11815,10822
209542,4,3,5551,2589,2962
209551,1,999,27078,13194,13884
209551,2,1,22020,10980,11040
209551,4,3,5058,2214,2844
209603,1,999,683,257,426
209603,2,1,626,234,392
209603,4,3,57,23,34
209612,1,999,3904,1333,2571
209612,2,1,1710,668,1042
209612,4,3,2194,665,1529
209667,1,999,106,6,100
209667,2,1,106,6,100
209676,1,999,234,14,220
209676,2,1,234,14,220
209694,1,999,110,24,86
209694,2,1,110,24,86
209700,1,999,167,16,151
209700,2,1,167,16,151
209719,1,999,57,5,52
209719,2,1,57,5,52
209746,1,999,53172,25186,27986
209746,2,1,53172,25186,27986
209807,1,999,41896,17819,24077
209807,2,1,29331,13631,15700
209807,4,3,12565,4188,8377
209825,1,999,4532,1746,2786
209825,2,1,3611,1409,2202
209825,4,3,921,337,584
209922,1,999,1536,679,857
209922,2,1,1499,663,836
209922,4,3,37,16,21
209940,1,999,11459,5060,6399
209940,2,1,11459,5060,6399
209986,1,999,63,2,61
209986,2,1,63,2,61
210076,1,999,2282,630,1652
210076,2,1,2282,630,1652
210100,1,999,139,3,136
210100,2,1,139,3,136
210146,1,999,8664,3494,5170
210146,2,1,6880,2881,3999
210146,4,3,1784,613,1171
210155,1,999,2352,1064,1288
210155,2,1,2352,1064,1288
210234,1,999,5006,2194,2812
210234,2,1,5006,2194,2812
210270,1,999,5037,2203,2834
210270,2,1,5037,2203,2834
210304,1,999,2196,771,1425
210304,2,1,1931,671,1260
210304,4,3,265,100,165
210331,1,999,1326,521,805
210331,2,1,1057,412,645
210331,4,3,269,109,160
210340,1,999,108,7,101
210340,2,1,108,7,101
210359,1,999,1198,306,892
210359,2,1,1198,306,892
210368,1,999,871,572,299
210368,4,3,871,572,299
210401,1,999,3099,1417,1682
210401,2,1,2109,910,1199
210401,4,3,990,507,483
210429,1,999,8384,3200,5184
210429,2,1,5974,2568,3406
210429,4,3,2410,632,1778
210438,1,999,639,404,235
210438,2,1,82,23,59
210438,4,3,557,381,176
210456,1,999,307,64,243
210456,2,1,307,64,243
210474,1,999,86,6,80
210474,2,1,86,6,80
210483,1,999,679,158,521
210483,2,1,679,158,521
210492,1,999,234,118,116
210492,2,1,216,106,110
210492,4,3,18,12,6
210508,1,999,29,17,12
210508,4,3,29,17,12
210571,1,999,2678,1111,1567
210571,2,1,2580,1082,1498
210571,4,3,98,29,69
210599,1,999,825,779,46
210599,2,1,825,779,46
210605,1,999,31869,13538,18331
210605,2,1,31869,13538,18331
210669,1,999,2224,999,1225
210669,2,1,2224,999,1225
210711,1,999,270,21,249
210711,2,1,270,21,249
210739,1,999,3975,1577,2398
210739,2,1,2803,1142,1661
210739,4,3,1172,435,737
210748,1,999,174,10,164
210748,2,1,174,10,164
210775,1,999,4052,1314,2738
210775,2,1,3020,979,2041
210775,4,3,1032,335,697
210784,1,999,365,17,348
210784,2,1,365,17,348
210809,1,999,743,550,193
210809,4,3,743,550,193
210890,1,999,216,53,163
210890,2,1,216,53,163
210906,1,999,878,392,486
210906,2,1,878,392,486
210942,1,999,4794,2151,2643
210942,2,1,4794,2151,2643
210951,1,999,165,9,156
210951,2,1,165,9,156
210960,1,999,3242,1703,1539
210960,2,1,3242,1703,1539
211006,1,999,559,534,25
211006,2,1,559,534,25
211024,1,999,1080,629,451
211024,2,1,671,319,352
211024,4,3,409,310,99
211079,1,999,4743,1987,2756
211079,2,1,4743,1987,2756
211088,1,999,4983,1303,3680
211088,2,1,2360,677,1683
211088,4,3,2623,626,1997
211130,1,999,358,249,109
211130,4,3,358,249,109
211149,1,999,326,121,205
211149,2,1,326,121,205
211158,1,999,11644,4828,6816
211158,2,1,10202,4376,5826
211158,4,3,1442,452,990
211200,1,999,630,172,458
211200,2,1,630,172,458
211273,1,999,1859,89,1770
211273,2,1,1390,0,1390
211273,4,3,469,89,380
211291,1,999,3819,1822,1997
211291,2,1,3667,1761,1906
211291,4,3,152,61,91
211307,1,999,16575,7076,9499
211307,2,1,16575,7076,9499
211316,1,999,107,2,105
211316,2,1,107,2,105
211334,1,999,103,6,97
211334,2,1,103,6,97
211343,1,999,6104,2452,3652
211343,2,1,6104,2452,3652
211352,1,999,4600,1302,3298
211352,2,1,1560,567,993
211352,4,3,3040,735,2305
211361,1,999,11506,5319,6187
211361,2,1,8314,3993,4321
211361,4,3,3192,1326,1866
211370,1,999,121,113,8
211370,4,3,121,113,8
211398,1,999,266,72,194
211398,2,1,266,72,194
211431,1,999,3483,525,2958
211431,2,1,2290,375,1915
211431,4,3,1193,150,1043
211440,1,999,12175,7715,4460
211440,2,1,6174,3587,2587
211440,4,3,6001,4128,1873
211468,1,999,1987,120,1867
211468,2,1,1738,95,1643
211468,4,3,249,25,224
211477,1,999,2169,785,1384
211477,2,1,2169,785,1384
211556,1,999,2735,412,2323
211556,2,1,1249,95,1154
211556,4,3,1486,317,1169
211583,1,999,2691,703,1988
211583,2,1,1709,495,1214
211583,4,3,982,208,774
211608,1,999,1783,822,961
211608,2,1,1689,791,898
211608,4,3,94,31,63
211617,1,999,1439,658,781
211617,2,1,1439,658,781
211635,1,999,191,24,167
211635,2,1,191,24,167
211644,1,999,8544,3034,5510
211644,2,1,6934,2695,4239
211644,4,3,1610,339,1271
211750,1,999,475,99,376
211750,2,1,475,99,376
211802,1,999,168,42,126
211802,2,1,168,42,126
211820,1,999,224,20,204
211820,2,1,224,20,204
211893,1,999,163,80,83
211893,2,1,123,60,63
211893,4,3,40,20,20
211909,1,999,153,150,3
211909,2,1,153,150,3
211927,1,999,18860,8150,10710
211927,2,1,18860,8150,10710
211981,1,999,2689,1115,1574
211981,2,1,2301,955,1346
211981,4,3,388,160,228
212009,1,999,2477,1120,1357
212009,2,1,2477,1120,1357
212018,1,999,287,144,143
212018,4,3,287,144,143
212045,1,999,523,169,354
212045,2,1,523,169,354
212054,1,999,28374,13346,15028
212054,2,1,16209,8499,7710
212054,4,3,12165,4847,7318
212072,1,999,340,84,256
212072,2,1,340,84,256
212090,1,999,1355,273,1082
212090,2,1,1355,273,1082
212106,1,999,11746,4977,6769
212106,2,1,6208,2695,3513
212106,4,3,5538,2282,3256
212115,1,999,8726,3739,4987
212115,2,1,7113,3260,3853
212115,4,3,1613,479,1134
212133,1,999,5319,1697,3622
212133,2,1,3291,973,2318
212133,4,3,2028,724,1304
212160,1,999,9901,3749,6152
212160,2,1,7392,3130,4262
212160,4,3,2509,619,1890
212197,1,999,2606,961,1645
212197,2,1,2543,954,1589
212197,4,3,63,7,56
212212,1,999,61,3,58
212212,2,1,61,3,58
212230,1,999,95,9,86
212230,2,1,95,9,86
212267,1,999,317,18,299
212267,2,1,317,18,299
212276,1,999,277,19,258
212276,2,1,277,19,258
212285,1,999,107,4,103
212285,2,1,107,4,103
212294,1,999,126,10,116
212294,2,1,126,10,116
212300,1,999,91,5,86
212300,2,1,91,5,86
212328,1,999,326,24,302
212328,2,1,326,24,302
212337,1,999,286,24,262
212337,2,1,286,24,262
212355,1,999,326,18,308
212355,2,1,326,18,308
212373,1,999,164,19,145
212373,2,1,164,19,145
212382,1,999,336,33,303
212382,2,1,336,33,303
212391,1,999,262,16,246
212391,2,1,262,16,246
212425,1,999,549,175,374
212425,2,1,549,175,374
212434,1,999,490,448,42
212434,2,1,490,448,42
212443,1,999,172,111,61
212443,4,3,172,111,61
212568,1,999,227,45,182
212568,2,1,227,45,182
212577,1,999,2548,1195,1353
212577,2,1,2548,1195,1353
212601,1,999,4996,2027,2969
212601,2,1,3164,1322,1842
212601,4,3,1832,705,1127
212656,1,999,2529,1148,1381
212656,2,1,2139,999,1140
212656,4,3,390,149,241
212674,1,999,2678,1254,1424
212674,2,1,2678,1254,1424
212683,1,999,220,15,205
212683,2,1,220,15,205
212708,1,999,262,50,212
212708,2,1,262,50,212
212753,1,999,411,36,375
212753,2,1,411,36,375
212771,1,999,2645,486,2159
212771,2,1,161,51,110
212771,4,3,2484,435,2049
212805,1,999,2531,1269,1262
212805,2,1,2531,1269,1262
212832,1,999,3235,838,2397
212832,2,1,2598,680,1918
212832,4,3,637,158,479
212869,1,999,1760,282,1478
212869,2,1,1760,282,1478
212878,1,999,32758,12385,20373
212878,2,1,32758,12385,20373
212911,1,999,1253,577,676
212911,2,1,1253,577,676
212975,1,999,496,338,158
212975,2,1,496,338,158
212984,1,999,3829,987,2842
212984,2,1,2332,642,1690
212984,4,3,1497,345,1152
212993,1,999,151,93,58
212993,2,1,151,93,58
213002,1,999,1471,658,813
213002,2,1,1471,658,813
213011,1,999,5941,1420,4521
213011,2,1,3856,907,2949
213011,4,3,2085,513,1572
213020,1,999,17018,7367,9651
213020,2,1,14051,6210,7841
213020,4,3,2967,1157,1810
213057,1,999,733,229,504
213057,2,1,733,229,504
213163,1,999,79,11,68
213163,2,1,79,11,68
213181,1,999,880,87,793
213181,2,1,880,87,793
213215,1,999,266,16,250
213215,2,1,266,16,250
213233,1,999,473,366,107
213233,2,1,473,366,107
213251,1,999,1662,721,941
213251,2,1,1662,721,941
213303,1,999,2129,851,1278
213303,2,1,2068,834,1234
213303,4,3,61,17,44
213312,1,999,590,166,424
213312,2,1,590,166,424
213321,1,999,3263,1412,1851
213321,2,1,2593,1259,1334
213321,4,3,670,153,517
213330,1,999,49,2,47
213330,2,1,49,2,47
213349,1,999,11851,4858,6993
213349,2,1,10449,4454,5995
213349,4,3,1402,404,998
213358,1,999,1646,640,1006
213358,2,1,1500,598,902
213358,4,3,146,42,104
213367,1,999,7972,2695,5277
213367,2,1,4978,1713,3265
213367,4,3,2994,982,2012
213376,1,999,2248,1133,1115
213376,2,1,2248,1133,1115
213385,1,999,2474,1327,1147
213385,2,1,2474,1327,1147
213400,1,999,1332,676,656
213400,2,1,1064,548,516
213400,4,3,268,128,140
213446,1,999,155,64,91
213446,4,3,155,64,91
213455,1,999,338,21,317
213455,2,1,338,21,317
213473,1,999,883,190,693
213473,2,1,883,190,693
213491,1,999,104,4,100
213491,2,1,104,4,100
213507,1,999,2338,1036,1302
213507,2,1,1858,815,1043
213507,4,3,480,221,259
213525,1,999,11677,4453,7224
213525,2,1,11677,4453,7224
213534,1,999,1574,398,1176
213534,2,1,1574,398,1176
213543,1,999,7533,4285,3248
213543,2,1,4868,2865,2003
213543,4,3,2665,1420,1245
213552,1,999,96,11,85
213552,2,1,96,11,85
213570,1,999,1379,342,1037
213570,2,1,1379,342,1037
213589,1,999,944,897,47
213589,2,1,944,897,47
213598,1,999,2512,1032,1480
213598,2,1,1897,808,1089
213598,4,3,615,224,391
213613,1,999,6275,2665,3610
213613,2,1,5757,2520,3237
213613,4,3,518,145,373
213622,1,999,279,50,229
213622,2,1,279,50,229
213631,1,999,190,91,99
213631,4,3,190,91,99
213640,1,999,316,154,162
213640,4,3,316,154,162
213659,1,999,10350,4287,6063
213659,2,1,10350,4287,6063
213668,1,999,1350,602,748
213668,2,1,1350,602,748
213686,1,999,137,37,100
213686,2,1,137,37,100
213774,1,999,1254,276,978
213774,2,1,1254,276,978
213783,1,999,3977,1461,2516
213783,2,1,3318,1353,1965
213783,4,3,659,108,551
213826,1,999,4048,1110,2938
213826,2,1,2525,775,1750
213826,4,3,1523,335,1188
213914,1,999,441,41,400
213914,2,1,441,41,400
213932,1,999,130,14,116
213932,2,1,130,14,116
213987,1,999,4987,2048,2939
213987,2,1,4387,1779,2608
213987,4,3,600,269,331
213996,1,999,3034,1148,1886
213996,2,1,2876,1092,1784
213996,4,3,158,56,102
214023,1,999,197,144,53
214023,2,1,197,144,53
214041,1,999,10966,4472,6494
214041,2,1,8720,3864,4856
214041,4,3,2246,608,1638
214069,1,999,3415,940,2475
214069,2,1,2732,770,1962
214069,4,3,683,170,513
214111,1,999,16301,7297,9004
214111,2,1,16301,7297,9004
214148,1,999,608,6,602
214148,2,1,526,0,526
214148,4,3,82,6,76
214157,1,999,2294,872,1422
214157,2,1,1961,784,1177
214157,4,3,333,88,245
214166,1,999,2590,797,1793
214166,2,1,2536,782,1754
214166,4,3,54,15,39
214175,1,999,2698,1168,1530
214175,2,1,2698,1168,1530
214254,1,999,1520,570,950
214254,2,1,1520,570,950
214272,1,999,3689,1227,2462
214272,2,1,2809,964,1845
214272,4,3,880,263,617
214290,1,999,1327,1286,41
214290,2,1,1327,1286,41
214315,1,999,133,24,109
214315,2,1,133,24,109
214379,1,999,16729,6621,10108
214379,2,1,16729,6621,10108
214476,1,999,105,9,96
214476,2,1,105,9,96
214528,1,999,1077,848,229
214528,2,1,1077,848,229
214546,1,999,79,5,74
214546,2,1,79,5,74
214564,1,999,1112,347,765
214564,4,3,1112,347,765
214582,1,999,1704,382,1322
214582,2,1,1704,382,1322
214591,1,999,4618,2941,1677
214591,2,1,4465,2834,1631
214591,4,3,153,107,46
214607,1,999,1247,706,541
214607,4,3,1247,706,541
214616,1,999,829,393,436
214616,4,3,829,393,436
214625,1,999,1068,589,479
214625,2,1,1063,589,474
214625,4,3,5,0,5
214634,1,999,853,309,544
214634,2,1,853,309,544
214643,1,999,950,598,352
214643,2,1,821,558,263
214643,4,3,129,40,89
214652,1,999,1673,802,871
214652,2,1,1668,802,866
214652,4,3,5,0,5
214670,1,999,1048,558,490
214670,2,1,1006,550,456
214670,4,3,42,8,34
214689,1,999,4415,2330,2085
214689,2,1,4381,2319,2062
214689,4,3,34,11,23
214698,1,999,1119,560,559
214698,2,1,1114,559,555
214698,4,3,5,1,4
214704,1,999,3193,1734,1459
214704,2,1,3014,1709,1305
214704,4,3,179,25,154
214713,1,999,5109,2530,2579
214713,2,1,3434,1895,1539
214713,4,3,1675,635,1040
214731,1,999,1860,1078,782
214731,2,1,1860,1078,782
214740,1,999,1107,519,588
214740,2,1,1104,519,585
214740,4,3,3,0,3
214759,1,999,1239,511,728
214759,2,1,1239,511,728
214768,1,999,1385,766,619
214768,2,1,1385,766,619
214777,1,999,49025,26732,22293
214777,2,1,41358,22655,18703
214777,4,3,7667,4077,3590
214786,1,999,857,463,394
214786,2,1,857,463,394
214795,1,999,1383,565,818
214795,2,1,1383,565,818
214801,1,999,4219,2105,2114
214801,2,1,4119,2088,2031
214801,4,3,100,17,83
214810,1,999,1163,530,633
214810,2,1,1160,530,630
214810,4,3,3,0,3
214829,1,999,1981,960,1021
214829,2,1,1663,923,740
214829,4,3,318,37,281
214838,1,999,362,97,265
214838,2,1,362,97,265
214883,1,999,2722,794,1928
214883,2,1,2722,794,1928
214892,1,999,587,228,359
214892,2,1,587,228,359
214944,1,999,1035,914,121
214944,2,1,1035,914,121
214962,1,999,89,5,84
214962,2,1,89,5,84
214971,1,999,367,160,207
214971,2,1,260,116,144
214971,4,3,107,44,63
215008,1,999,99,99,0
215008,2,1,99,99,0
215026,1,999,20,17,3
215026,2,1,20,17,3
215044,1,999,287,104,183
215044,2,1,287,104,183
215053,1,999,284,105,179
215053,2,1,284,105,179
215062,1,999,28453,13343,15110
215062,2,1,13470,6550,6920
215062,4,3,14983,6793,8190
215099,1,999,4072,1416,2656
215099,2,1,3250,1131,2119
215099,4,3,822,285,537
215105,1,999,2533,1065,1468
215105,2,1,2242,967,1275
215105,4,3,291,98,193
215114,1,999,1476,682,794
215114,2,1,1064,517,547
215114,4,3,412,165,247
215123,1,999,2489,995,1494
215123,4,3,2489,995,1494
215132,1,999,3029,1203,1826
215132,2,1,1519,563,956
215132,4,3,1510,640,870
215239,1,999,29043,10291,18752
215239,2,1,29043,10291,18752
215266,1,999,1821,850,971
215266,2,1,1821,850,971
215275,1,999,2008,1007,1001
215275,2,1,2008,1007,1001
215284,1,999,3149,1685,1464
215284,2,1,3149,1685,1464
215293,1,999,33082,15731,17351
215293,2,1,20301,10050,10251
215293,4,3,12781,5681,7100
215309,1,999,566,204,362
215309,2,1,566,204,362
215336,1,999,63,3,60
215336,2,1,63,3,60
215381,1,999,631,610,21
215381,2,1,631,610,21
215390,1,999,312,150,162
215390,2,1,312,150,162
215415,1,999,3226,2056,1170
215415,2,1,3226,2056,1170
215424,1,999,336,206,130
215424,4,3,336,206,130
215433,1,999,812,108,704
215433,2,1,812,108,704
215442,1,999,4828,1946,2882
215442,2,1,3979,1591,2388
215442,4,3,849,355,494
215479,1,999,63,5,58
215479,2,1,63,5,58
215530,1,999,51,2,49
215530,2,1,51,2,49
215585,1,999,7773,2918,4855
215585,2,1,7773,2918,4855
215594,1,999,704,110,594
215594,2,1,704,110,594
215619,1,999,61,18,43
215619,4,3,61,18,43
215628,1,999,111,92,19
215628,4,3,111,92,19
215637,1,999,515,241,274
215637,2,1,515,241,274
215646,1,999,1222,675,547
215646,2,1,1222,675,547
215655,1,999,5823,3076,2747
215655,2,1,4360,2391,1969
215655,4,3,1463,685,778
215682,1,999,583,554,29
215682,2,1,583,554,29
215691,1,999,1118,238,880
215691,2,1,598,129,469
215691,4,3,520,109,411
215743,1,999,2725,1030,1695
215743,2,1,1915,779,1136
215743,4,3,810,251,559
215770,1,999,10788,4609,6179
215770,2,1,5796,2753,3043
215770,4,3,4992,1856,3136
215798,1,999,2041,1041,1000
215798,2,1,1754,925,829
215798,4,3,287,116,171
215813,1,999,75,71,4
215813,4,3,75,71,4
215886,1,999,238,93,145
215886,2,1,238,93,145
215929,1,999,6858,2912,3946
215929,2,1,4311,1904,2407
215929,4,3,2547,1008,1539
215947,1,999,3126,1119,2007
215947,2,1,2546,964,1582
215947,4,3,580,155,425
215965,1,999,95,16,79
215965,2,1,95,16,79
215974,1,999,451,135,316
215974,2,1,451,135,316
215983,1,999,43,5,38
215983,2,1,43,5,38
215992,1,999,504,101,403
215992,2,1,504,101,403
216010,1,999,9379,4244,5135
216010,2,1,7671,3707,3964
216010,4,3,1708,537,1171
216038,1,999,10309,4328,5981
216038,2,1,9095,3955,5140
216038,4,3,1214,373,841
216047,1,999,270,202,68
216047,2,1,141,112,29
216047,4,3,129,90,39
216074,1,999,108,4,104
216074,2,1,108,4,104
216083,1,999,975,386,589
216083,2,1,975,386,589
216162,1,999,244,32,212
216162,2,1,244,32,212
216223,1,999,63,2,61
216223,2,1,63,2,61
216278,1,999,2456,1100,1356
216278,2,1,2456,1100,1356
216287,1,999,1563,762,801
216287,2,1,1563,762,801
216296,1,999,967,877,90
216296,2,1,967,877,90
216311,1,999,116,116,0
216311,2,1,116,116,0
216339,1,999,42688,20062,22626
216339,2,1,31273,15019,16254
216339,4,3,11415,5043,6372
216357,1,999,1151,623,528
216357,2,1,1151,623,528
216366,1,999,3901,1164,2737
216366,2,1,1167,210,957
216366,4,3,2734,954,1780
216418,1,999,2823,1279,1544
216418,2,1,2823,1279,1544
216427,1,999,281,271,10
216427,2,1,281,271,10
216436,1,999,520,508,12
216436,2,1,520,508,12
216445,1,999,429,420,9
216445,2,1,429,420,9
216454,1,999,516,501,15
216454,2,1,516,501,15
216463,1,999,183,120,63
216463,4,3,183,120,63
216524,1,999,1809,834,975
216524,2,1,1809,834,975
216542,1,999,1376,658,718
216542,2,1,1321,625,696
216542,4,3,55,33,22
216551,1,999,341,290,51
216551,2,1,341,290,51
216579,1,999,157,8,149
216579,2,1,157,8,149
216597,1,999,12136,6052,6084
216597,2,1,7862,3836,4026
216597,4,3,4274,2216,2058
216630,1,999,191,31,160
216630,2,1,191,31,160
216649,1,999,38,14,24
216649,2,1,38,14,24
216667,1,999,1512,762,750
216667,2,1,1512,762,750
216694,1,999,2972,1019,1953
216694,2,1,1905,687,1218
216694,4,3,1067,332,735
216746,1,999,132,129,3
216746,2,1,132,129,3
216764,1,999,17551,6710,10841
216764,2,1,14030,5733,8297
216764,4,3,3521,977,2544
216773,1,999,110,20,90
216773,2,1,110,20,90
216782,1,999,1643,276,1367
216782,2,1,1643,276,1367
216807,1,999,1690,689,1001
216807,2,1,1583,647,936
216807,4,3,107,42,65
216816,1,999,661,516,145
216816,4,3,661,516,145
216825,1,999,11583,4327,7256
216825,2,1,11583,4327,7256
216852,1,999,5532,2147,3385
216852,2,1,3562,1601,1961
216852,4,3,1970,546,1424
216931,1,999,9314,3320,5994
216931,2,1,2445,1263,1182
216931,4,3,6869,2057,4812
216986,1,999,176,14,162
216986,2,1,176,14,162
217013,1,999,977,162,815
217013,2,1,916,153,763
217013,4,3,61,9,52
217040,1,999,75,75,0
217040,2,1,75,75,0
217059,1,999,6233,2748,3485
217059,2,1,5895,2624,3271
217059,4,3,338,124,214
217077,1,999,3259,1659,1600
217077,2,1,3259,1659,1600
217086,1,999,400,86,314
217086,2,1,400,86,314
217095,1,999,312,31,281
217095,2,1,312,31,281
217156,1,999,9276,4368,4908
217156,2,1,6850,3180,3670
217156,4,3,2426,1188,1238
217165,1,999,3816,2234,1582
217165,2,1,3413,2000,1413
217165,4,3,403,234,169
217235,1,999,12399,5420,6979
217235,2,1,10660,4766,5894
217235,4,3,1739,654,1085
217244,1,999,1007,102,905
217244,2,1,1007,102,905
217305,1,999,4517,3438,1079
217305,2,1,4476,3434,1042
217305,4,3,41,4,37
217323,1,999,344,330,14
217323,2,1,344,330,14
217350,1,999,87,3,84
217350,2,1,87,3,84
217402,1,999,5745,2447,3298
217402,2,1,4756,2065,2691
217402,4,3,989,382,607
217420,1,999,10939,3538,7401
217420,2,1,8952,3115,5837
217420,4,3,1987,423,1564
217475,1,999,24411,9884,14527
217475,2,1,24411,9884,14527
217484,1,999,19185,8384,10801
217484,2,1,15249,6813,8436
217484,4,3,3936,1571,2365
217493,1,999,2486,862,1624
217493,2,1,2040,653,1387
217493,4,3,446,209,237
217518,1,999,5086,2628,2458
217518,2,1,4661,2432,2229
217518,4,3,425,196,229
217536,1,999,2860,997,1863
217536,2,1,2054,630,1424
217536,4,3,806,367,439
217545,1,999,1402,133,1269
217545,2,1,1402,133,1269
217572,1,999,125,21,104
217572,2,1,125,21,104
217581,1,999,239,9,230
217581,2,1,239,9,230
217606,1,999,342,191,151
217606,2,1,342,191,151
217615,1,999,4330,1550,2780
217615,2,1,4330,1550,2780
217624,1,999,905,352,553
217624,2,1,905,352,553
217633,1,999,2746,916,1830
217633,2,1,2493,793,1700
217633,4,3,253,123,130
217688,1,999,4688,1711,2977
217688,2,1,3762,1373,2389
217688,4,3,926,338,588
217712,1,999,3946,1159,2787
217712,2,1,3946,1159,2787
217721,1,999,3508,1757,1751
217721,2,1,3508,1757,1751
217749,1,999,4385,2071,2314
217749,2,1,3477,1566,1911
217749,4,3,908,505,403
217776,1,999,2701,957,1744
217776,2,1,1778,707,1071
217776,4,3,923,250,673
217794,1,999,233,18,215
217794,2,1,233,18,215
217819,1,999,14545,4791,9754
217819,2,1,11011,4223,6788
217819,4,3,3534,568,2966
217828,1,999,98,3,95
217828,2,1,98,3,95
217837,1,999,1708,531,1177
217837,2,1,1708,531,1177
217864,1,999,3909,2949,960
217864,2,1,2682,2423,259
217864,4,3,1227,526,701
217873,1,999,2077,737,1340
217873,2,1,1980,705,1275
217873,4,3,97,32,65
217882,1,999,22338,12030,10308
217882,2,1,16906,9280,7626
217882,4,3,5432,2750,2682
217891,1,999,174,96,78
217891,2,1,174,96,78
217907,1,999,1299,372,927
217907,2,1,1299,372,927
217925,1,999,1520,794,726
217925,2,1,701,348,353
217925,4,3,819,446,373
217934,1,999,1608,73,1535
217934,2,1,1315,39,1276
217934,4,3,293,34,259
217961,1,999,3944,745,3199
217961,2,1,754,0,754
217961,4,3,3190,745,2445
217989,1,999,1405,622,783
217989,2,1,1405,622,783
217998,1,999,949,531,418
217998,2,1,630,286,344
217998,4,3,319,245,74
218025,1,999,7997,2637,5360
218025,2,1,7997,2637,5360
218043,1,999,121,24,97
218043,2,1,121,24,97
218061,1,999,4711,1516,3195
218061,2,1,4178,1416,2762
218061,4,3,533,100,433
218070,1,999,3177,1284,1893
218070,2,1,2863,1216,1647
218070,4,3,314,68,246
218089,1,999,282,115,167
218089,2,1,247,99,148
218089,4,3,35,16,19
218113,1,999,20293,8133,12160
218113,2,1,20293,8133,12160
218140,1,999,10305,3603,6702
218140,2,1,10305,3603,6702
218159,1,999,109,1,108
218159,2,1,109,1,108
218195,1,999,239,16,223
218195,2,1,239,16,223
218229,1,999,3671,1143,2528
218229,2,1,3402,1116,2286
218229,4,3,269,27,242
218238,1,999,3881,1513,2368
218238,2,1,3881,1513,2368
218265,1,999,166,92,74
218265,4,3,166,92,74
218335,1,999,3001,1102,1899
218335,2,1,292,53,239
218335,4,3,2709,1049,1660
218353,1,999,17355,6840,10515
218353,2,1,17355,6840,10515
218399,1,999,1229,552,677
218399,2,1,1229,552,677
218414,1,999,1199,665,534
218414,2,1,1199,665,534
218441,1,999,2620,1342,1278
218441,2,1,2351,1180,1171
218441,4,3,269,162,107
218487,1,999,4348,1535,2813
218487,2,1,4348,1535,2813
218520,1,999,8156,2866,5290
218520,2,1,8156,2866,5290
218539,1,999,1321,625,696
218539,2,1,1243,600,643
218539,4,3,78,25,53
218645,1,999,3715,1224,2491
218645,2,1,3577,1204,2373
218645,4,3,138,20,118
218654,1,999,2161,840,1321
218654,2,1,2161,840,1321
218663,1,999,33503,14802,18701
218663,2,1,23379,10929,12450
218663,4,3,10124,3873,6251
218672,1,999,2006,776,1230
218672,2,1,2006,776,1230
218681,1,999,1507,458,1049
218681,2,1,1507,458,1049
218690,1,999,1493,661,832
218690,2,1,1493,661,832
218706,1,999,784,281,503
218706,2,1,784,281,503
218724,1,999,10148,4478,5670
218724,2,1,9009,4220,4789
218724,4,3,1139,258,881
218733,1,999,5068,2187,2881
218733,2,1,4353,2026,2327
218733,4,3,715,161,554
218742,1,999,6689,2317,4372
218742,2,1,6384,2279,4105
218742,4,3,305,38,267
218751,1,999,274,161,113
218751,4,3,274,161,113
218821,1,999,858,452,406
218821,2,1,858,452,406
218830,1,999,8259,3046,5213
218830,2,1,8259,3046,5213
218858,1,999,6005,1865,4140
218858,2,1,6005,1865,4140
218867,1,999,72,2,70
218867,2,1,72,2,70
218885,1,999,9252,3954,5298
218885,2,1,9252,3954,5298
218894,1,999,22883,8988,13895
218894,2,1,22883,8988,13895
218919,1,999,854,344,510
218919,2,1,854,344,510
218955,1,999,1067,365,702
218955,2,1,1067,365,702
218964,1,999,7221,2228,4993
218964,2,1,5479,1782,3697
218964,4,3,1742,446,1296
218973,1,999,1551,809,742
218973,2,1,1551,809,742
218991,1,999,8643,3366,5277
218991,2,1,8643,3366,5277
219000,1,999,1941,735,1206
219000,2,1,1895,713,1182
219000,4,3,46,22,24
219037,1,999,204,6,198
219037,2,1,204,6,198
219046,1,999,6830,2331,4499
219046,2,1,5403,2048,3355
219046,4,3,1427,283,1144
219055,1,999,649,207,442
219055,2,1,649,207,442
219082,1,999,4913,2094,2819
219082,2,1,4355,1809,2546
219082,4,3,558,285,273
219091,1,999,953,400,553
219091,2,1,855,351,504
219091,4,3,98,49,49
219125,1,999,173,9,164
219125,2,1,173,9,164
219143,1,999,1638,790,848
219143,2,1,1638,790,848
219170,1,999,17,3,14
219170,2,1,17,3,14
219189,1,999,1237,863,374
219189,2,1,1237,863,374
219198,1,999,1513,610,903
219198,2,1,1380,557,823
219198,4,3,133,53,80
219204,1,999,3542,1039,2503
219204,2,1,2911,831,2080
219204,4,3,631,208,423
219213,1,999,1315,259,1056
219213,2,1,1315,259,1056
219240,1,999,174,109,65
219240,4,3,174,109,65
219259,1,999,3893,1628,2265
219259,2,1,3092,1364,1728
219259,4,3,801,264,537
219277,1,999,2602,866,1736
219277,2,1,2349,802,1547
219277,4,3,253,64,189
219295,1,999,810,151,659
219295,2,1,810,151,659
219338,1,999,17,2,15
219338,2,1,17,2,15
219347,1,999,2721,1884,837
219347,2,1,2339,1611,728
219347,4,3,382,273,109
219356,1,999,15051,6908,8143
219356,2,1,12997,6055,6942
219356,4,3,2054,853,1201
219374,1,999,1634,492,1142
219374,2,1,1467,450,1017
219374,4,3,167,42,125
219383,1,999,2109,921,1188
219383,2,1,1526,702,824
219383,4,3,583,219,364
219392,1,999,28,5,23
219392,2,1,28,5,23
219408,1,999,371,107,264
219408,2,1,371,107,264
219426,1,999,3069,1570,1499
219426,2,1,3069,1570,1499
219453,1,999,227,4,223
219453,2,1,227,4,223
219471,1,999,12973,4672,8301
219471,2,1,9127,3345,5782
219471,4,3,3846,1327,2519
219480,1,999,1563,836,727
219480,2,1,1563,836,727
219505,1,999,91,66,25
219505,2,1,85,65,20
219505,4,3,6,1,5
219578,1,999,863,127,736
219578,2,1,863,127,736
219587,1,999,115,4,111
219587,2,1,115,4,111
219596,1,999,472,264,208
219596,2,1,472,264,208
219602,1,999,12534,4869,7665
219602,2,1,11343,4559,6784
219602,4,3,1191,310,881
219639,1,999,1152,125,1027
219639,2,1,1152,125,1027
219709,1,999,6543,2638,3905
219709,2,1,5076,2153,2923
219709,4,3,1467,485,982
219718,1,999,5836,2524,3312
219718,2,1,4162,1880,2282
219718,4,3,1674,644,1030
219790,1,999,1948,931,1017
219790,2,1,1780,842,938
219790,4,3,168,89,79
219806,1,999,2303,1001,1302
219806,2,1,1927,864,1063
219806,4,3,376,137,239
219824,1,999,13549,5246,8303
219824,2,1,13549,5246,8303
219833,1,999,2194,979,1215
219833,2,1,1512,682,830
219833,4,3,682,297,385
219842,1,999,267,184,83
219842,4,3,267,184,83
219879,1,999,4944,2016,2928
219879,2,1,4944,2016,2928
219888,1,999,7537,2765,4772
219888,2,1,7537,2765,4772
219903,1,999,1133,83,1050
219903,2,1,1133,83,1050
219921,1,999,403,288,115
219921,2,1,403,288,115
219949,1,999,1598,652,946
219949,2,1,1256,527,729
219949,4,3,342,125,217
219976,1,999,4546,1854,2692
219976,2,1,3090,1314,1776
219976,4,3,1456,540,916
219994,1,999,1059,536,523
219994,2,1,1059,536,523
220002,1,999,1027,267,760
220002,2,1,1027,267,760
220057,1,999,4753,1501,3252
220057,2,1,4753,1501,3252
220075,1,999,17091,7195,9896
220075,2,1,13752,6006,7746
220075,4,3,3339,1189,2150
220118,1,999,736,132,604
220118,2,1,736,132,604
220127,1,999,917,365,552
220127,2,1,917,365,552
220136,1,999,155,115,40
220136,4,3,155,115,40
220163,1,999,132,8,124
220163,2,1,132,8,124
220181,1,999,629,244,385
220181,2,1,559,208,351
220181,4,3,70,36,34
220206,1,999,315,174,141
220206,2,1,315,174,141
220215,1,999,2290,1016,1274
220215,2,1,1593,727,866
220215,4,3,697,289,408
220251,1,999,593,302,291
220251,2,1,593,302,291
220279,1,999,875,476,399
220279,2,1,875,476,399
220312,1,999,184,97,87
220312,2,1,184,97,87
220321,1,999,1012,527,485
220321,2,1,1012,527,485
220394,1,999,372,177,195
220394,2,1,372,177,195
220400,1,999,7412,2567,4845
220400,2,1,7412,2567,4845
220464,1,999,150,61,89
220464,2,1,150,61,89
220473,1,999,889,466,423
220473,2,1,727,391,336
220473,4,3,162,75,87
220491,1,999,499,31,468
220491,2,1,499,31,468
220516,1,999,2345,843,1502
220516,2,1,2013,709,1304
220516,4,3,332,134,198
220552,1,999,1551,352,1199
220552,2,1,1339,303,1036
220552,4,3,212,49,163
220570,1,999,84,36,48
220570,2,1,84,36,48
220598,1,999,2371,1134,1237
220598,2,1,2371,1134,1237
220604,1,999,1340,472,868
220604,2,1,1340,472,868
220613,1,999,4913,2053,2860
220613,2,1,4359,1860,2499
220613,4,3,554,193,361
220631,1,999,5618,1808,3810
220631,2,1,1989,689,1300
220631,4,3,3629,1119,2510
220640,1,999,834,382,452
220640,2,1,834,382,452
220701,1,999,1244,477,767
220701,2,1,1244,477,767
220710,1,999,1117,517,600
220710,2,1,1117,517,600
220756,1,999,379,272,107
220756,2,1,379,272,107
220765,1,999,693,65,628
220765,2,1,693,65,628
220792,1,999,801,337,464
220792,4,3,801,337,464
220808,1,999,486,181,305
220808,2,1,399,152,247
220808,4,3,87,29,58
220853,1,999,1448,913,535
220853,2,1,1448,913,535
220862,1,999,26312,10116,16196
220862,2,1,20299,7844,12455
220862,4,3,6013,2272,3741
220871,1,999,323,170,153
220871,4,3,323,170,153
220941,1,999,1019,265,754
220941,2,1,940,244,696
220941,4,3,79,21,58
220978,1,999,31269,14538,16731
220978,2,1,27196,13086,14110
220978,4,3,4073,1452,2621
220996,1,999,211,88,123
220996,4,3,211,88,123
221014,1,999,1269,497,772
221014,2,1,959,385,574
221014,4,3,310,112,198
221050,1,999,1365,864,501
221050,2,1,1365,864,501
221096,1,999,6878,2635,4243
221096,2,1,6878,2635,4243
221102,1,999,613,259,354
221102,2,1,613,259,354
221148,1,999,3582,3475,107
221148,2,1,3582,3475,107
221157,1,999,368,13,355
221157,2,1,368,13,355
221184,1,999,14305,5619,8686
221184,2,1,14305,5619,8686
221236,1,999,425,261,164
221236,2,1,425,261,164
221254,1,999,207,21,186
221254,2,1,207,21,186
221281,1,999,551,218,333
221281,2,1,551,218,333
221290,1,999,263,13,250
221290,2,1,263,13,250
221333,1,999,702,475,227
221333,2,1,702,475,227
221351,1,999,1816,775,1041
221351,2,1,1798,762,1036
221351,4,3,18,13,5
221388,1,999,250,120,130
221388,2,1,250,120,130
221397,1,999,8900,3164,5736
221397,2,1,8900,3164,5736
221430,1,999,458,283,175
221430,2,1,458,283,175
221485,1,999,19989,6969,13020
221485,2,1,19989,6969,13020
221494,1,999,821,490,331
221494,2,1,821,490,331
221519,1,999,1761,829,932
221519,2,1,1546,717,829
221519,4,3,215,112,103
221582,1,999,761,351,410
221582,2,1,761,351,410
221591,1,999,811,489,322
221591,2,1,811,489,322
221607,1,999,371,198,173
221607,2,1,371,198,173
221616,1,999,749,444,305
221616,2,1,749,444,305
221625,1,999,1369,442,927
221625,2,1,1369,442,927
221634,1,999,277,179,98
221634,2,1,277,179,98
221643,1,999,15585,7298,8287
221643,2,1,15585,7298,8287
221661,1,999,3512,1496,2016
221661,2,1,2925,1311,1614
221661,4,3,587,185,402
221670,1,999,487,217,270
221670,4,3,487,217,270
221731,1,999,1206,403,803
221731,2,1,1206,403,803
221740,1,999,12015,5341,6674
221740,2,1,10106,4515,5591
221740,4,3,1909,826,1083
221759,1,999,32981,16482,16499
221759,2,1,23168,12001,11167
221759,4,3,9813,4481,5332
221768,1,999,9865,4101,5764
221768,2,1,9118,3849,5269
221768,4,3,747,252,495
221795,1,999,237,200,37
221795,2,1,237,200,37
221829,1,999,431,30,401
221829,2,1,431,30,401
221838,1,999,10416,3731,6685
221838,2,1,7816,2942,4874
221838,4,3,2600,789,1811
221847,1,999,12981,6362,6619
221847,2,1,10352,5490,4862
221847,4,3,2629,872,1757
221856,1,999,1325,682,643
221856,2,1,1003,424,579
221856,4,3,322,258,64
221892,1,999,3106,1139,1967
221892,2,1,1631,700,931
221892,4,3,1475,439,1036
221908,1,999,8785,3863,4922
221908,2,1,8785,3863,4922
221953,1,999,2512,978,1534
221953,2,1,2241,923,1318
221953,4,3,271,55,216
221971,1,999,5195,1977,3218
221971,2,1,3485,1429,2056
221971,4,3,1710,548,1162
221980,1,999,109,3,106
221980,2,1,109,3,106
221999,1,999,13500,6132,7368
221999,2,1,7000,3432,3568
221999,4,3,6500,2700,3800
222026,1,999,160,15,145
222026,2,1,160,15,145
222053,1,999,12351,4635,7716
222053,2,1,12351,4635,7716
222062,1,999,9093,3515,5578
222062,2,1,9093,3515,5578
222099,1,999,649,30,619
222099,2,1,649,30,619
222105,1,999,178,178,0
222105,2,1,178,178,0
222178,1,999,5120,2299,2821
222178,2,1,3963,1827,2136
222178,4,3,1157,472,685
222567,1,999,8787,4082,4705
222567,2,1,8787,4082,4705
222576,1,999,15823,6259,9564
222576,2,1,15823,6259,9564
222628,1,999,2392,846,1546
222628,2,1,544,218,326
222628,4,3,1848,628,1220
222673,1,999,344,42,302
222673,2,1,344,42,302
222682,1,999,437,88,349
222682,2,1,437,88,349
222691,1,999,410,41,369
222691,2,1,410,41,369
222707,1,999,252,12,240
222707,2,1,252,12,240
222761,1,999,1916,1837,79
222761,2,1,1916,1837,79
222822,1,999,8020,3024,4996
222822,2,1,8020,3024,4996
222831,1,999,7996,3415,4581
222831,2,1,6781,3037,3744
222831,4,3,1215,378,837
222877,1,999,266,147,119
222877,2,1,245,142,103
222877,4,3,21,5,16
222886,1,999,325,27,298
222886,2,1,325,27,298
222938,1,999,3379,1528,1851
222938,2,1,3379,1528,1851
222983,1,999,1338,596,742
222983,2,1,1317,592,725
222983,4,3,21,4,17
222992,1,999,77953,34752,43201
222992,2,1,77953,34752,43201
223001,1,999,183,83,100
223001,4,3,183,83,100
223056,1,999,128,11,117
223056,2,1,128,11,117
223083,1,999,556,123,433
223083,2,1,556,123,433
223117,1,999,134,112,22
223117,2,1,58,44,14
223117,4,3,76,68,8
223214,1,999,2115,945,1170
223214,2,1,251,28,223
223214,4,3,1864,917,947
223223,1,999,1489,690,799
223223,4,3,1489,690,799
223232,1,999,16083,7049,9034
223232,2,1,13217,5592,7625
223232,4,3,2866,1457,1409
223320,1,999,6203,2610,3593
223320,2,1,6203,2610,3593
223427,1,999,25552,12367,13185
223427,2,1,25552,12367,13185
223463,1,999,2110,514,1596
223463,2,1,2110,514,1596
223472,1,999,414,49,365
223472,2,1,414,49,365
223506,1,999,6528,3058,3470
223506,2,1,6528,3058,3470
223524,1,999,24479,10060,14419
223524,2,1,24479,10060,14419
223658,1,999,393,376,17
223658,2,1,393,376,17
223667,1,999,33,3,30
223667,2,1,33,3,30
223773,1,999,11673,4484,7189
223773,2,1,11673,4484,7189
223816,1,999,48781,27523,21258
223816,2,1,48781,27523,21258
223852,1,999,53,2,51
223852,2,1,53,2,51
223898,1,999,6591,2716,3875
223898,2,1,6591,2716,3875
223922,1,999,2061,1018,1043
223922,2,1,2061,1018,1043
224004,1,999,3240,933,2307
224004,2,1,1536,578,958
224004,4,3,1704,355,1349
224013,1,999,89,2,87
224013,2,1,89,2,87
224110,1,999,14381,6000,8381
224110,2,1,14381,6000,8381
224147,1,999,11785,4526,7259
224147,2,1,9366,3797,5569
224147,4,3,2419,729,1690
224156,1,999,460,41,419
224156,2,1,460,41,419
224183,1,999,1130,54,1076
224183,2,1,1130,54,1076
224226,1,999,6931,2747,4184
224226,2,1,4505,1846,2659
224226,4,3,2426,901,1525
224244,1,999,403,220,183
224244,2,1,387,214,173
224244,4,3,16,6,10
224271,1,999,216,120,96
224271,2,1,216,120,96
224305,1,999,2490,1729,761
224305,4,3,2490,1729,761
224323,1,999,3270,1784,1486
224323,2,1,1403,689,714
224323,4,3,1867,1095,772
224350,1,999,17098,7330,9768
224350,2,1,17098,7330,9768
224402,1,999,7434,4313,3121
224402,2,1,7434,4313,3121
224439,1,999,3124,561,2563
224439,2,1,3124,561,2563
224527,1,999,1273,637,636
224527,2,1,1273,637,636
224545,1,999,2510,717,1793
224545,2,1,1575,471,1104
224545,4,3,935,246,689
224554,1,999,13264,5223,8041
224554,2,1,7222,2825,4397
224554,4,3,6042,2398,3644
224572,1,999,23435,9325,14110
224572,2,1,23435,9325,14110
224615,1,999,19312,6466,12846
224615,2,1,19312,6466,12846
224642,1,999,41768,18012,23756
224642,2,1,41768,18012,23756
224660,1,999,894,453,441
224660,2,1,894,453,441
224679,1,999,1470,1193,277
224679,2,1,1470,1193,277
224712,1,999,141,50,91
224712,4,3,141,50,91
224758,1,999,117,7,110
224758,2,1,117,7,110
224776,1,999,2892,1318,1574
224776,2,1,2892,1318,1574
224828,1,999,276,33,243
224828,2,1,276,33,243
224891,1,999,1598,708,890
224891,2,1,1598,708,890
224907,1,999,170,4,166
224907,2,1,170,4,166
224961,1,999,3594,1448,2146
224961,2,1,3594,1448,2146
225070,1,999,7282,2836,4446
225070,2,1,7282,2836,4446
225201,1,999,1265,812,453
225201,2,1,1265,812,453
225247,1,999,2643,1210,1433
225247,2,1,2114,954,1160
225247,4,3,529,256,273
225308,1,999,11851,4925,6926
225308,2,1,11851,4925,6926
225371,1,999,6371,2489,3882
225371,2,1,6371,2489,3882
225399,1,999,2954,977,1977
225399,2,1,2462,839,1623
225399,4,3,492,138,354
225414,1,999,10338,3781,6557
225414,2,1,6082,2003,4079
225414,4,3,4256,1778,2478
225423,1,999,92869,38552,54317
225423,2,1,92869,38552,54317
225432,1,999,16341,6348,9993
225432,2,1,16154,6268,9886
225432,4,3,187,80,107
225502,1,999,5286,1863,3423
225502,2,1,2918,940,1978
225502,4,3,2368,923,1445
225511,1,999,45001,22532,22469
225511,2,1,35757,17894,17863
225511,4,3,9244,4638,4606
225520,1,999,6199,2305,3894
225520,2,1,6199,2305,3894
225548,1,999,1431,752,679
225548,2,1,1404,735,669
225548,4,3,27,17,10
225575,1,999,1059,512,547
225575,2,1,988,485,503
225575,4,3,71,27,44
225627,1,999,9153,3475,5678
225627,2,1,6884,2594,4290
225627,4,3,2269,881,1388
225779,1,999,464,170,294
225779,2,1,464,170,294
225788,1,999,358,174,184
225788,2,1,358,174,184
225849,1,999,1489,1245,244
225849,2,1,1489,1245,244
225858,1,999,1146,939,207
225858,2,1,1146,939,207
225876,1,999,562,207,355
225876,2,1,562,207,355
225885,1,999,570,298,272
225885,2,1,570,298,272
225991,1,999,313,172,141
225991,2,1,313,172,141
226019,1,999,9091,3454,5637
226019,2,1,9091,3454,5637
226091,1,999,18537,7143,11394
226091,2,1,11472,4639,6833
226091,4,3,7065,2504,4561
226107,1,999,3543,904,2639
226107,2,1,3543,904,2639
226116,1,999,3770,1283,2487
226116,2,1,3770,1283,2487
226125,1,999,224,4,220
226125,2,1,224,4,220
226134,1,999,13824,5935,7889
226134,2,1,13824,5935,7889
226152,1,999,8287,3327,4960
226152,2,1,6951,2826,4125
226152,4,3,1336,501,835
226204,1,999,9943,5154,4789
226204,2,1,9943,5154,4789
226231,1,999,4458,1851,2607
226231,2,1,3901,1700,2201
226231,4,3,557,151,406
226277,1,999,3326,3230,96
226277,2,1,3326,3230,96
226329,1,999,1260,858,402
226329,2,1,1260,858,402
226374,1,999,84,54,30
226374,2,1,84,54,30
226383,1,999,2592,1046,1546
226383,2,1,2019,857,1162
226383,4,3,573,189,384
226408,1,999,6235,2521,3714
226408,2,1,6235,2521,3714
226471,1,999,3302,1267,2035
226471,2,1,2888,1086,1802
226471,4,3,414,181,233
226578,1,999,14610,5199,9411
226578,2,1,14610,5199,9411
226587,1,999,1812,945,867
226587,2,1,1812,945,867
226675,1,999,380,72,308
226675,2,1,380,72,308
226772,1,999,162,15,147
226772,2,1,162,15,147
226806,1,999,11695,4957,6738
226806,2,1,11695,4957,6738
226833,1,999,7608,3178,4430
226833,2,1,6705,2875,3830
226833,4,3,903,303,600
226860,1,999,106,17,89
226860,2,1,106,17,89
226879,1,999,395,56,339
226879,2,1,395,56,339
226903,1,999,591,111,480
226903,2,1,591,111,480
226930,1,999,15107,5969,9138
226930,2,1,15107,5969,9138
227003,1,999,1705,736,969
227003,2,1,1705,736,969
227058,1,999,110,5,105
227058,2,1,110,5,105
227146,1,999,15272,6011,9261
227146,2,1,15272,6011,9261
227155,1,999,101,2,99
227155,2,1,101,2,99
227182,1,999,86966,35170,51796
227182,2,1,86966,35170,51796
227191,1,999,20817,9052,11765
227191,2,1,20817,9052,11765
227216,1,999,44140,19772,24368
227216,2,1,33914,15995,17919
227216,4,3,10226,3777,6449
227225,1,999,4418,1573,2845
227225,2,1,4418,1573,2845
227243,1,999,912,418,494
227243,2,1,829,374,455
227243,4,3,83,44,39
227289,1,999,191,138,53
227289,4,3,191,138,53
227298,1,999,739,704,35
227298,2,1,739,704,35
227304,1,999,7551,2965,4586
227304,2,1,7551,2965,4586
227313,1,999,488,20,468
227313,2,1,488,20,468
227322,1,999,530,19,511
227322,2,1,530,19,511
227331,1,999,2963,792,2171
227331,2,1,1702,452,1250
227331,4,3,1261,340,921
227368,1,999,23023,9947,13076
227368,2,1,19011,8368,10643
227368,4,3,4012,1579,2433
227377,1,999,18970,8007,10963
227377,2,1,17743,7578,10165
227377,4,3,1227,429,798
227386,1,999,3265,977,2288
227386,2,1,3265,977,2288
227401,1,999,8505,3279,5226
227401,2,1,8505,3279,5226
227429,1,999,272,133,139
227429,2,1,272,133,139
227526,1,999,9946,3896,6050
227526,2,1,7647,3228,4419
227526,4,3,2299,668,1631
227687,1,999,2309,1043,1266
227687,2,1,2309,1043,1266
227748,1,999,308,293,15
227748,2,1,308,293,15
227757,1,999,6503,3581,2922
227757,2,1,3768,1977,1791
227757,4,3,2735,1604,1131
227766,1,999,34627,15015,19612
227766,2,1,34627,15015,19612
227836,1,999,1460,596,864
227836,2,1,1460,596,864
227845,1,999,6109,2407,3702
227845,2,1,4909,1972,2937
227845,4,3,1200,435,765
227854,1,999,14847,6534,8313
227854,2,1,14847,6534,8313
227863,1,999,4430,1559,2871
227863,2,1,1800,715,1085
227863,4,3,2630,844,1786
227881,1,999,19710,8263,11447
227881,2,1,16226,7037,9189
227881,4,3,3484,1226,2258
227924,1,999,36718,15800,20918
227924,2,1,36718,15800,20918
227979,1,999,41792,18078,23714
227979,2,1,41792,18078,23714
228042,1,999,1263,523,740
228042,2,1,1205,510,695
228042,4,3,58,13,45
228088,1,999,90,8,82
228088,2,1,90,8,82
228149,1,999,4475,2081,2394
228149,2,1,2574,1096,1478
228149,4,3,1901,985,916
228158,1,999,14094,6503,7591
228158,2,1,14094,6503,7591
228185,1,999,69,51,18
228185,2,1,69,51,18
228194,1,999,1399,754,645
228194,4,3,1399,754,645
228200,1,999,1581,699,882
228200,2,1,1581,699,882
228219,1,999,2440,788,1652
228219,2,1,2440,788,1652
228246,1,999,12513,6377,6136
228246,2,1,6842,3246,3596
228246,4,3,5671,3131,2540
228282,1,999,523,35,488
228282,2,1,523,35,488
228291,1,999,43,39,4
228291,2,1,43,39,4
228316,1,999,8196,3489,4707
228316,2,1,8196,3489,4707
228325,1,999,2375,1236,1139
228325,2,1,1919,994,925
228325,4,3,456,242,214
228343,1,999,1423,561,862
228343,2,1,1423,561,862
228431,1,999,14939,5708,9231
228431,2,1,12670,4903,7767
228431,4,3,2269,805,1464
228459,1,999,36743,16083,20660
228459,2,1,30338,13681,16657
228459,4,3,6405,2402,4003
228468,1,999,1111,474,637
228468,2,1,998,433,565
228468,4,3,113,41,72
228486,1,999,256,132,124
228486,2,1,256,132,124
228501,1,999,4062,1624,2438
228501,2,1,2772,1176,1596
228501,4,3,1290,448,842
228529,1,999,13690,5515,8175
228529,2,1,10889,4572,6317
228529,4,3,2801,943,1858
228547,1,999,74833,31083,43750
228547,2,1,74833,31083,43750
228608,1,999,8593,2942,5651
228608,2,1,8593,2942,5651
228635,1,999,3078,1407,1671
228635,2,1,86,21,65
228635,4,3,2992,1386,1606
228644,1,999,3811,1484,2327
228644,2,1,1239,399,840
228644,4,3,2572,1085,1487
228653,1,999,3033,983,2050
228653,2,1,785,152,633
228653,4,3,2248,831,1417
228680,1,999,6754,5115,1639
228680,2,1,6754,5115,1639
228699,1,999,6226,2459,3767
228699,2,1,6226,2459,3767
228705,1,999,11927,5486,6441
228705,2,1,9084,4248,4836
228705,4,3,2843,1238,1605
228714,1,999,2147,1306,841
228714,2,1,2053,1266,787
228714,4,3,94,40,54
228723,1,999,51417,27630,23787
228723,2,1,40345,21215,19130
228723,4,3,11072,6415,4657
228769,1,999,45533,18886,26647
228769,2,1,34004,14060,19944
228769,4,3,11529,4826,6703
228778,1,999,55620,27543,28077
228778,2,1,41616,20320,21296
228778,4,3,14004,7223,6781
228787,1,999,20000,11204,8796
228787,2,1,12106,6731,5375
228787,4,3,7894,4473,3421
228796,1,999,26232,11910,14322
228796,2,1,21200,9610,11590
228796,4,3,5032,2300,2732
228802,1,999,7816,3241,4575
228802,2,1,5845,2472,3373
228802,4,3,1971,769,1202
228866,1,999,349,197,152
228866,4,3,349,197,152
228875,1,999,9771,4074,5697
228875,2,1,8321,3400,4921
228875,4,3,1450,674,776
228884,1,999,1081,592,489
228884,2,1,1031,563,468
228884,4,3,50,29,21
228909,1,999,1912,850,1062
228909,4,3,1912,850,1062
228981,1,999,1418,682,736
228981,2,1,1418,682,736
229018,1,999,5170,2028,3142
229018,2,1,3851,1541,2310
229018,4,3,1319,487,832
229027,1,999,35098,17523,17575
229027,2,1,29544,15081,14463
229027,4,3,5554,2442,3112
229036,1,999,936,187,749
229036,2,1,936,187,749
229063,1,999,11063,4687,6376
229063,2,1,8035,3510,4525
229063,4,3,3028,1177,1851
229115,1,999,35105,19273,15832
229115,2,1,27514,15316,12198
229115,4,3,7591,3957,3634
229151,1,999,223,134,89
229151,2,1,223,134,89
229160,1,999,3768,1465,2303
229160,2,1,2071,766,1305
229160,4,3,1697,699,998
229179,1,999,17458,1900,15558
229179,2,1,9077,823,8254
229179,4,3,8381,1077,7304
229267,1,999,2665,1224,1441
229267,2,1,2419,1134,1285
229267,4,3,246,90,156
229300,1,999,5124,1851,3273
229300,2,1,671,97,574
229300,4,3,4453,1754,2699
229319,1,999,8102,3692,4410
229319,2,1,8102,3692,4410
229328,1,999,2409,1432,977
229328,2,1,2409,1432,977
229337,1,999,4797,1499,3298
229337,2,1,1569,277,1292
229337,4,3,3228,1222,2006
229355,1,999,15806,6441,9365
229355,2,1,15806,6441,9365
229416,1,999,3728,3646,82
229416,2,1,3728,3646,82
229425,1,999,699,19,680
229425,2,1,699,19,680
229504,1,999,8655,3651,5004
229504,2,1,8655,3651,5004
229522,1,999,153,23,130
229522,2,1,153,23,130
229540,1,999,5975,2108,3867
229540,2,1,5975,2108,3867
229638,1,999,136,52,84
229638,2,1,136,52,84
229780,1,999,10677,5561,5116
229780,2,1,8070,4339,3731
229780,4,3,2607,1222,1385
229799,1,999,8153,3173,4980
229799,2,1,8153,3173,4980
229814,1,999,9232,4021,5211
229814,2,1,7243,3248,3995
229814,4,3,1989,773,1216
229832,1,999,4427,2133,2294
229832,2,1,4427,2133,2294
229841,1,999,10535,4485,6050
229841,2,1,10535,4485,6050
229887,1,999,1560,604,956
229887,2,1,1523,600,923
229887,4,3,37,4,33
229957,1,999,129,21,108
229957,2,1,129,21,108
230010,1,999,1473,706,767
230010,2,1,1473,706,767
230038,1,999,40203,21075,19128
230038,2,1,36069,18533,17536
230038,4,3,4134,2542,1592
230047,1,999,3678,1625,2053
230047,2,1,3678,1625,2053
230056,1,999,991,231,760
230056,2,1,989,229,760
230056,4,3,2,2,0
230065,1,999,449,13,436
230065,2,1,449,13,436
230092,1,999,3515,1481,2034
230092,2,1,3515,1481,2034
230135,1,999,85,8,77
230135,2,1,85,8,77
230144,1,999,81,3,78
230144,2,1,81,3,78
230162,1,999,8460,4675,3785
230162,2,1,8460,4675,3785
230171,1,999,11387,5497,5890
230171,2,1,11387,5497,5890
230199,1,999,89,3,86
230199,2,1,89,3,86
230205,1,999,50,1,49
230205,2,1,50,1,49
230214,1,999,492,70,422
230214,2,1,492,70,422
230223,1,999,99,16,83
230223,2,1,99,16,83
230366,1,999,795,290,505
230366,2,1,795,290,505
230384,1,999,1451,1207,244
230384,2,1,1451,1207,244
230418,1,999,2463,1337,1126
230418,2,1,2463,1337,1126
230472,1,999,864,202,662
230472,2,1,864,202,662
230490,1,999,4960,2833,2127
230490,2,1,4960,2833,2127
230597,1,999,5335,2551,2784
230597,2,1,5335,2551,2784
230603,1,999,13150,4684,8466
230603,2,1,11688,4133,7555
230603,4,3,1462,551,911
230621,1,999,1374,550,824
230621,2,1,1364,545,819
230621,4,3,10,5,5
230630,1,999,739,335,404
230630,2,1,739,335,404
230676,1,999,1036,504,532
230676,2,1,1036,504,532
230728,1,999,33517,15185,18332
230728,2,1,27528,12617,14911
230728,4,3,5989,2568,3421
230737,1,999,40697,23143,17554
230737,2,1,40596,23089,17507
230737,4,3,101,54,47
230746,1,999,50643,25022,25621
230746,2,1,50643,25022,25621
230764,1,999,37046,20506,16540
230764,2,1,29012,16010,13002
230764,4,3,8034,4496,3538
230782,1,999,31546,14998,16548
230782,2,1,30709,14545,16164
230782,4,3,837,453,384
230807,1,999,3829,1777,2052
230807,2,1,2685,1190,1495
230807,4,3,1144,587,557
230816,1,999,865,273,592
230816,2,1,693,228,465
230816,4,3,172,45,127
230825,1,999,244,132,112
230825,2,1,244,132,112
230834,1,999,3104,1238,1866
230834,2,1,2305,1062,1243
230834,4,3,799,176,623
230852,1,999,3386,1891,1495
230852,2,1,3007,1714,1293
230852,4,3,379,177,202
230861,1,999,11395,3701,7694
230861,2,1,11395,3701,7694
230889,1,999,998,298,700
230889,2,1,352,115,237
230889,4,3,646,183,463
230898,1,999,847,366,481
230898,2,1,758,339,419
230898,4,3,89,27,62
230913,1,999,2442,847,1595
230913,2,1,1997,748,1249
230913,4,3,445,99,346
230931,1,999,1764,850,914
230931,2,1,1532,814,718
230931,4,3,232,36,196
230940,1,999,326,167,159
230940,2,1,326,167,159
230959,1,999,4560,2048,2512
230959,2,1,3774,1806,1968
230959,4,3,786,242,544
230977,1,999,780,465,315
230977,2,1,780,465,315
230995,1,999,4123,2961,1162
230995,2,1,2396,1745,651
230995,4,3,1727,1216,511
231004,1,999,78,13,65
231004,2,1,78,13,65
231059,1,999,3466,1303,2163
231059,2,1,2117,1007,1110
231059,4,3,1349,296,1053
231068,1,999,606,169,437
231068,4,3,606,169,437
231077,1,999,536,169,367
231077,2,1,292,111,181
231077,4,3,244,58,186
231086,1,999,543,200,343
231086,2,1,543,200,343
231095,1,999,140,84,56
231095,2,1,140,84,56
231147,1,999,815,376,439
231147,4,3,815,376,439
231165,1,999,1966,1130,836
231165,2,1,1966,1130,836
231174,1,999,15923,6606,9317
231174,2,1,13752,5717,8035
231174,4,3,2171,889,1282
231280,1,999,162,21,141
231280,2,1,162,21,141
231411,1,999,1599,1553,46
231411,2,1,1599,1553,46
231420,1,999,971,522,449
231420,2,1,925,507,418
231420,4,3,46,15,31
231536,1,999,6984,3069,3915
231536,2,1,6984,3069,3915
231554,1,999,816,340,476
231554,2,1,816,340,476
231581,1,999,1737,726,1011
231581,2,1,1737,726,1011
231624,1,999,9117,4142,4975
231624,2,1,6425,2892,3533
231624,4,3,2692,1250,1442
231651,1,999,6320,2569,3751
231651,2,1,2548,948,1600
231651,4,3,3772,1621,2151
231688,1,999,51,2,49
231688,2,1,51,2,49
231697,1,999,7957,3718,4239
231697,2,1,7957,3718,4239
231712,1,999,5139,2204,2935
231712,2,1,4889,2132,2757
231712,4,3,250,72,178
231721,1,999,109,3,106
231721,2,1,109,3,106
231785,1,999,1369,285,1084
231785,2,1,1369,285,1084
231828,1,999,1632,275,1357
231828,2,1,1632,275,1357
231837,1,999,1200,205,995
231837,2,1,1000,173,827
231837,4,3,200,32,168
231873,1,999,2178,928,1250
231873,2,1,2178,928,1250
231882,1,999,6741,2809,3932
231882,2,1,6741,2809,3932
231970,1,999,884,352,532
231970,4,3,884,352,532
232016,1,999,3544,505,3039
232016,2,1,3544,505,3039
232025,1,999,1055,520,535
232025,2,1,993,499,494
232025,4,3,62,21,41
232043,1,999,2265,772,1493
232043,2,1,1270,447,823
232043,4,3,995,325,670
232052,1,999,1461,454,1007
232052,2,1,1461,454,1007
232089,1,999,1544,819,725
232089,2,1,1544,819,725
232186,1,999,45933,20234,25699
232186,2,1,29280,13775,15505
232186,4,3,16653,6459,10194
232195,1,999,10569,4029,6540
232195,2,1,10569,4029,6540
232256,1,999,1097,1088,9
232256,2,1,1097,1088,9
232265,1,999,6206,2270,3936
232265,2,1,5187,1896,3291
232265,4,3,1019,374,645
232308,1,999,1277,106,1171
232308,2,1,827,7,820
232308,4,3,450,99,351
232414,1,999,19620,7724,11896
232414,2,1,19620,7724,11896
232423,1,999,22093,8799,13294
232423,2,1,19492,8052,11440
232423,4,3,2601,747,1854
232450,1,999,14522,5842,8680
232450,2,1,14522,5842,8680
232502,1,999,1034,155,879
232502,2,1,1034,155,879
232557,1,999,77778,34769,43009
232557,2,1,46923,21107,25816
232557,4,3,30855,13662,17193
232566,1,999,5610,1643,3967
232566,2,1,4345,1523,2822
232566,4,3,1265,120,1145
232575,1,999,9511,3584,5927
232575,2,1,9511,3584,5927
232593,1,999,30,2,28
232593,2,1,30,2,28
232609,1,999,3185,1198,1987
232609,2,1,2404,955,1449
232609,4,3,781,243,538
232618,1,999,275,18,257
232618,2,1,275,18,257
232672,1,999,2075,199,1876
232672,2,1,1730,141,1589
232672,4,3,345,58,287
232681,1,999,6049,2126,3923
232681,2,1,4870,1791,3079
232681,4,3,1179,335,844
232706,1,999,4146,1100,3046
232706,2,1,2595,742,1853
232706,4,3,1551,358,1193
232724,1,999,108,10,98
232724,2,1,108,10,98
232788,1,999,4442,1742,2700
232788,2,1,4442,1742,2700
232797,1,999,7679,1778,5901
232797,2,1,7634,1769,5865
232797,4,3,45,9,36
232867,1,999,8014,3877,4137
232867,2,1,8014,3877,4137
232885,1,999,586,73,513
232885,2,1,586,73,513
232919,1,999,642,600,42
232919,2,1,642,600,42
232937,1,999,8015,2730,5285
232937,2,1,7000,2466,4534
232937,4,3,1015,264,751
232946,1,999,75490,35631,39859
232946,2,1,75490,35631,39859
232982,1,999,29176,12989,16187
232982,2,1,21409,9928,11481
232982,4,3,7767,3061,4706
233019,1,999,4744,1785,2959
233019,2,1,4744,1785,2959
233037,1,999,2558,971,1587
233037,2,1,2558,971,1587
233082,1,999,198,32,166
233082,2,1,198,32,166
233091,1,999,926,150,776
233091,2,1,926,150,776
233116,1,999,7817,3131,4686
233116,2,1,7817,3131,4686
233277,1,999,9868,3977,5891
233277,2,1,8406,3625,4781
233277,4,3,1462,352,1110
233286,1,999,79,3,76
233286,2,1,79,3,76
233295,1,999,1253,592,661
233295,2,1,1253,592,661
233301,1,999,572,194,378
233301,2,1,563,191,372
233301,4,3,9,3,6
233310,1,999,5045,1794,3251
233310,2,1,5045,1794,3251
233329,1,999,734,56,678
233329,2,1,734,56,678
233338,1,999,2113,720,1393
233338,2,1,2113,720,1393
233356,1,999,295,22,273
233356,2,1,295,22,273
233374,1,999,5500,2302,3198
233374,2,1,4112,1765,2347
233374,4,3,1388,537,851
233408,1,999,421,31,390
233408,2,1,421,31,390
233426,1,999,2212,972,1240
233426,2,1,2212,972,1240
233480,1,999,58,19,39
233480,2,1,58,19,39
233499,1,999,602,299,303
233499,2,1,602,299,303
233541,1,999,5917,1834,4083
233541,2,1,2718,1015,1703
233541,4,3,3199,819,2380
233611,1,999,825,402,423
233611,2,1,825,402,423
233639,1,999,9439,3685,5754
233639,2,1,9439,3685,5754
233648,1,999,5352,2483,2869
233648,2,1,5352,2483,2869
233657,1,999,133,15,118
233657,2,1,133,15,118
233666,1,999,74,6,68
233666,2,1,74,6,68
233684,1,999,19565,7964,11601
233684,2,1,14137,5899,8238
233684,4,3,5428,2065,3363
233718,1,999,855,27,828
233718,2,1,823,25,798
233718,4,3,32,2,30
233754,1,999,16306,6551,9755
233754,2,1,16306,6551,9755
233772,1,999,46066,18375,27691
233772,2,1,46066,18375,27691
233842,1,999,294,125,169
233842,4,3,294,125,169
233897,1,999,2419,1100,1319
233897,2,1,2419,1100,1319
233903,1,999,3863,1589,2274
233903,2,1,3863,1589,2274
233912,1,999,639,190,449
233912,2,1,639,190,449
233921,1,999,33248,19190,14058
233921,2,1,24719,14406,10313
233921,4,3,8529,4784,3745
233949,1,999,12844,5618,7226
233949,2,1,12844,5618,7226
234030,1,999,36401,15539,20862
234030,2,1,25810,11520,14290
234030,4,3,10591,4019,6572
234076,1,999,30731,13410,17321
234076,2,1,18758,8505,10253
234076,4,3,11973,4905,7068
234085,1,999,1691,1523,168
234085,2,1,1691,1523,168
234119,1,999,218,35,183
234119,2,1,218,35,183
234137,1,999,620,278,342
234137,2,1,527,231,296
234137,4,3,93,47,46
234155,1,999,6571,2571,4000
234155,2,1,5702,2269,3433
234155,4,3,869,302,567
234164,1,999,2247,994,1253
234164,2,1,1794,748,1046
234164,4,3,453,246,207
234173,1,999,1399,525,874
234173,2,1,1399,525,874
234191,1,999,170,50,120
234191,2,1,170,50,120
234207,1,999,2183,1126,1057
234207,2,1,1766,882,884
234207,4,3,417,244,173
234216,1,999,1615,490,1125
234216,2,1,1615,490,1125
234225,1,999,136,77,59
234225,2,1,136,77,59
234359,1,999,283,197,86
234359,2,1,283,197,86
234377,1,999,5397,2009,3388
234377,2,1,5397,2009,3388
234401,1,999,150,7,143
234401,2,1,150,7,143
234492,1,999,2897,1486,1411
234492,2,1,2897,1486,1411
234526,1,999,49,44,5
234526,2,1,49,44,5
234650,1,999,180,7,173
234650,2,1,180,7,173
234669,1,999,23059,10298,12761
234669,2,1,23059,10298,12761
234687,1,999,94,7,87
234687,2,1,94,7,87
234696,1,999,5502,2727,2775
234696,2,1,5502,2727,2775
234711,1,999,3175,1276,1899
234711,2,1,3175,1276,1899
234739,1,999,825,106,719
234739,2,1,825,106,719
234784,1,999,1534,203,1331
234784,2,1,1534,203,1331
234827,1,999,14011,6783,7228
234827,2,1,13071,6422,6649
234827,4,3,940,361,579
234845,1,999,6251,2640,3611
234845,2,1,6251,2640,3611
234915,1,999,3662,1509,2153
234915,2,1,1710,721,989
234915,4,3,1952,788,1164
234924,1,999,181,18,163
234924,2,1,181,18,163
234933,1,999,20118,8654,11464
234933,2,1,20118,8654,11464
234951,1,999,12699,5130,7569
234951,2,1,12699,5130,7569
234979,1,999,9867,4542,5325
234979,2,1,9867,4542,5325
235024,1,999,849,281,568
235024,2,1,849,281,568
235088,1,999,542,531,11
235088,2,1,542,531,11
235097,1,999,15049,6561,8488
235097,2,1,12691,5679,7012
235097,4,3,2358,882,1476
235103,1,999,16113,7809,8304
235103,2,1,16113,7809,8304
235149,1,999,13768,5289,8479
235149,2,1,13768,5289,8479
235158,1,999,204,16,188
235158,2,1,204,16,188
235167,1,999,5929,2690,3239
235167,2,1,5563,2547,3016
235167,4,3,366,143,223
235237,1,999,15165,7452,7713
235237,2,1,15165,7452,7713
235307,1,999,311,17,294
235307,2,1,311,17,294
235316,1,999,8756,3908,4848
235316,2,1,5077,2380,2697
235316,4,3,3679,1528,2151
235334,1,999,3781,1845,1936
235334,2,1,3781,1845,1936
235343,1,999,12744,6030,6714
235343,2,1,12744,6030,6714
235352,1,999,90,11,79
235352,2,1,90,11,79
235422,1,999,1471,365,1106
235422,2,1,1019,247,772
235422,4,3,452,118,334
235431,1,999,10765,4389,6376
235431,2,1,10765,4389,6376
235495,1,999,256,117,139
235495,2,1,256,117,139
235501,1,999,670,420,250
235501,2,1,670,420,250
235510,1,999,1286,1001,285
235510,2,1,1286,1001,285
235529,1,999,799,640,159
235529,2,1,799,640,159
235547,1,999,1031,166,865
235547,2,1,242,36,206
235547,4,3,789,130,659
235583,1,999,520,52,468
235583,2,1,520,52,468
235671,1,999,9052,5538,3514
235671,2,1,9052,5538,3514
235699,1,999,7040,3244,3796
235699,2,1,7040,3244,3796
235750,1,999,6366,2378,3988
235750,2,1,6366,2378,3988
235769,1,999,181,86,95
235769,2,1,181,86,95
235954,1,999,37,0,37
235954,2,1,37,0,37
236018,1,999,115,36,79
236018,2,1,115,36,79
236027,1,999,340,16,324
236027,2,1,340,16,324
236072,1,999,11345,4711,6634
236072,2,1,11345,4711,6634
236133,1,999,1593,638,955
236133,2,1,1299,521,778
236133,4,3,294,117,177
236188,1,999,12222,5616,6606
236188,2,1,12222,5616,6606
236212,1,999,1024,804,220
236212,2,1,1024,804,220
236230,1,999,4029,1469,2560
236230,2,1,3534,1303,2231
236230,4,3,495,166,329
236258,1,999,5694,2721,2973
236258,2,1,5694,2721,2973
236328,1,999,2992,1188,1804
236328,2,1,2666,1106,1560
236328,4,3,326,82,244
236382,1,999,7289,4629,2660
236382,2,1,7289,4629,2660
236452,1,999,1974,919,1055
236452,2,1,1535,747,788
236452,4,3,439,172,267
236504,1,999,9553,5283,4270
236504,2,1,9553,5283,4270
236513,1,999,12493,5473,7020
236513,2,1,12493,5473,7020
236531,1,999,544,119,425
236531,2,1,544,119,425
236577,1,999,4656,1485,3171
236577,2,1,3375,1088,2287
236577,4,3,1281,397,884
236595,1,999,8919,3650,5269
236595,2,1,5022,1977,3045
236595,4,3,3897,1673,2224
236610,1,999,9682,4150,5532
236610,2,1,9682,4150,5532
236638,1,999,8969,3643,5326
236638,2,1,8969,3643,5326
236656,1,999,8643,3698,4945
236656,2,1,8643,3698,4945
236692,1,999,11437,5770,5667
236692,2,1,11437,5770,5667
236708,1,999,16367,6973,9394
236708,2,1,16367,6973,9394
236744,1,999,151,10,141
236744,2,1,151,10,141
236753,1,999,15256,5839,9417
236753,2,1,15256,5839,9417
236887,1,999,8696,5133,3563
236887,2,1,8696,5133,3563
236896,1,999,2139,991,1148
236896,2,1,1823,905,918
236896,4,3,316,86,230
236939,1,999,29962,14304,15658
236939,2,1,24659,11851,12808
236939,4,3,5303,2453,2850
236948,1,999,49554,23469,26085
236948,2,1,35264,16833,18431
236948,4,3,14290,6636,7654
236975,1,999,5344,2232,3112
236975,2,1,5344,2232,3112
236993,1,999,730,60,670
236993,2,1,730,60,670
237011,1,999,16778,7333,9445
237011,2,1,15156,6683,8473
237011,4,3,1622,650,972
237039,1,999,7038,3193,3845
237039,2,1,7038,3193,3845
237057,1,999,1658,696,962
237057,2,1,1658,696,962
237066,1,999,3131,1314,1817
237066,2,1,2449,1113,1336
237066,4,3,682,201,481
237109,1,999,7188,2498,4690
237109,2,1,7188,2498,4690
237118,1,999,717,239,478
237118,2,1,625,213,412
237118,4,3,92,26,66
237127,1,999,20,0,20
237127,2,1,20,0,20
237136,1,999,343,179,164
237136,2,1,331,167,164
237136,4,3,12,12,0
237145,1,999,38,1,37
237145,2,1,38,1,37
237154,1,999,8399,3017,5382
237154,2,1,7326,2566,4760
237154,4,3,1073,451,622
237172,1,999,500,334,166
237172,2,1,500,334,166
237181,1,999,1020,547,473
237181,2,1,979,530,449
237181,4,3,41,17,24
237215,1,999,2586,936,1650
237215,2,1,2586,936,1650
237242,1,999,242,170,72
237242,2,1,242,170,72
237303,1,999,157,67,90
237303,2,1,157,67,90
237312,1,999,1668,713,955
237312,2,1,1253,499,754
237312,4,3,415,214,201
237321,1,999,146,21,125
237321,2,1,146,21,125
237330,1,999,3520,1479,2041
237330,2,1,3135,1377,1758
237330,4,3,385,102,283
237358,1,999,922,408,514
237358,2,1,922,408,514
237367,1,999,5503,2372,3131
237367,2,1,5066,2220,2846
237367,4,3,437,152,285
237385,1,999,2181,1228,953
237385,2,1,2181,1228,953
237419,1,999,24,21,3
237419,2,1,24,21,3
237437,1,999,1928,476,1452
237437,2,1,1928,476,1452
237473,1,999,167,112,55
237473,2,1,167,112,55
237491,1,999,32,1,31
237491,2,1,32,1,31
237525,1,999,17898,6983,10915
237525,2,1,11429,5099,6330
237525,4,3,6469,1884,4585
237543,1,999,342,114,228
237543,2,1,342,114,228
237552,1,999,204,30,174
237552,2,1,204,30,174
237561,1,999,124,55,69
237561,2,1,124,55,69
237570,1,999,137,12,125
237570,2,1,137,12,125
237598,1,999,300,60,240
237598,2,1,300,60,240
237604,1,999,917,187,730
237604,2,1,917,187,730
237613,1,999,148,13,135
237613,2,1,148,13,135
237640,1,999,571,265,306
237640,2,1,517,253,264
237640,4,3,54,12,42
237686,1,999,5599,2394,3205
237686,2,1,5599,2394,3205
237701,1,999,2188,1056,1132
237701,2,1,2188,1056,1132
237729,1,999,294,121,173
237729,2,1,294,121,173
237783,1,999,1500,714,786
237783,2,1,936,427,509
237783,4,3,564,287,277
237792,1,999,5104,2121,2983
237792,2,1,4904,2043,2861
237792,4,3,200,78,122
237817,1,999,3131,1075,2056
237817,2,1,3131,1075,2056
237844,1,999,109,85,24
237844,2,1,109,85,24
237880,1,999,806,435,371
237880,4,3,806,435,371
237899,1,999,4034,1679,2355
237899,2,1,3930,1645,2285
237899,4,3,104,34,70
237905,1,999,56,7,49
237905,2,1,49,7,42
237905,4,3,7,0,7
237932,1,999,3125,1324,1801
237932,2,1,2936,1252,1684
237932,4,3,189,72,117
237950,1,999,1438,900,538
237950,2,1,1438,900,538
237969,1,999,1493,670,823
237969,2,1,1404,628,776
237969,4,3,89,42,47
237978,1,999,135,40,95
237978,2,1,135,40,95
237987,1,999,356,74,282
237987,2,1,356,74,282
237996,1,999,299,119,180
237996,2,1,299,119,180
238005,1,999,83,3,80
238005,2,1,83,3,80
238014,1,999,5878,2393,3485
238014,2,1,5878,2393,3485
238032,1,999,33293,16918,16375
238032,2,1,23918,13098,10820
238032,4,3,9375,3820,5555
238078,1,999,1616,597,1019
238078,2,1,1204,462,742
238078,4,3,412,135,277
238096,1,999,30,3,27
238096,2,1,30,3,27
238166,1,999,141,8,133
238166,2,1,141,8,133
238175,1,999,213,10,203
238175,2,1,213,10,203
238193,1,999,3111,70,3041
238193,2,1,2562,5,2557
238193,4,3,549,65,484
238263,1,999,24550,10943,13607
238263,2,1,24486,10932,13554
238263,4,3,64,11,53
238324,1,999,405,37,368
238324,2,1,369,37,332
238324,4,3,36,0,36
238333,1,999,1428,619,809
238333,2,1,1428,619,809
238397,1,999,3997,1586,2411
238397,2,1,3997,1586,2411
238421,1,999,153,30,123
238421,2,1,153,30,123
238430,1,999,10980,3175,7805
238430,2,1,3860,1366,2494
238430,4,3,7120,1809,5311
238458,1,999,3975,1332,2643
238458,2,1,3381,1176,2205
238458,4,3,594,156,438
238476,1,999,3254,1450,1804
238476,2,1,3103,1399,1704
238476,4,3,151,51,100
238573,1,999,3,1,2
238573,2,1,3,1,2
238616,1,999,7991,2643,5348
238616,2,1,4465,1562,2903
238616,4,3,3526,1081,2445
238661,1,999,3949,1167,2782
238661,2,1,2260,664,1596
238661,4,3,1689,503,1186
238722,1,999,17609,9142,8467
238722,2,1,17609,9142,8467
238759,1,999,13983,5636,8347
238759,2,1,13983,5636,8347
238786,1,999,137,11,126
238786,2,1,137,11,126
238810,1,999,171,13,158
238810,2,1,171,13,158
238892,1,999,1927,1447,480
238892,2,1,1927,1447,480
238935,1,999,405,206,199
238935,2,1,405,206,199
238980,1,999,5020,1871,3149
238980,2,1,3852,1519,2333
238980,4,3,1168,352,816
239008,1,999,4815,1997,2818
239008,2,1,4815,1997,2818
239017,1,999,1601,733,868
239017,2,1,1601,733,868
239071,1,999,1072,533,539
239071,2,1,964,437,527
239071,4,3,108,96,12
239080,1,999,4063,1169,2894
239080,2,1,2332,650,1682
239080,4,3,1731,519,1212
239105,1,999,12529,6051,6478
239105,2,1,8409,4037,4372
239105,4,3,4120,2014,2106
239132,1,999,267,53,214
239132,2,1,267,53,214
239169,1,999,1380,692,688
239169,4,3,1380,692,688
239220,1,999,5413,2271,3142
239220,2,1,5413,2271,3142
239248,1,999,28458,12954,15504
239248,2,1,28458,12954,15504
239309,1,999,707,285,422
239309,2,1,707,285,422
239318,1,999,2850,2245,605
239318,2,1,2560,2034,526
239318,4,3,290,211,79
239372,1,999,12089,6019,6070
239372,2,1,12089,6019,6070
239390,1,999,2348,95,2253
239390,2,1,1525,48,1477
239390,4,3,823,47,776
239424,1,999,140,117,23
239424,4,3,140,117,23
239442,1,999,2198,824,1374
239442,2,1,2198,824,1374
239460,1,999,8331,3455,4876
239460,2,1,8331,3455,4876
239488,1,999,14910,5928,8982
239488,2,1,14910,5928,8982
239503,1,999,708,346,362
239503,2,1,589,271,318
239503,4,3,119,75,44
239512,1,999,599,287,312
239512,2,1,599,287,312
239628,1,999,1097,533,564
239628,2,1,1097,533,564
239637,1,999,118,107,11
239637,4,3,118,107,11
239716,1,999,2354,964,1390
239716,2,1,2252,932,1320
239716,4,3,102,32,70
239743,1,999,1291,330,961
239743,2,1,642,189,453
239743,4,3,649,141,508
239877,1,999,88,3,85
239877,2,1,88,3,85
239910,1,999,4442,2250,2192
239910,2,1,4442,2250,2192
239929,1,999,1846,446,1400
239929,2,1,1846,446,1400
240055,1,999,18975,8739,10236
240055,2,1,18975,8739,10236
240107,1,999,12601,2747,9854
240107,2,1,2556,724,1832
240107,4,3,10045,2023,8022
240116,1,999,8481,3809,4672
240116,2,1,8481,3809,4672
240125,1,999,13881,7174,6707
240125,2,1,13881,7174,6707
240170,1,999,7675,3640,4035
240170,2,1,7675,3640,4035
240189,1,999,13452,6595,6857
240189,2,1,11315,5733,5582
240189,4,3,2137,862,1275
240198,1,999,6420,2505,3915
240198,2,1,6420,2505,3915
240213,1,999,80,14,66
240213,4,3,80,14,66
240240,1,999,142,2,140
240240,2,1,142,2,140
240268,1,999,12908,5219,7689
240268,2,1,11894,4883,7011
240268,4,3,1014,336,678
240277,1,999,7926,2801,5125
240277,2,1,7416,2681,4735
240277,4,3,510,120,390
240329,1,999,11876,4809,7067
240329,2,1,9842,4254,5588
240329,4,3,2034,555,1479
240338,1,999,983,424,559
240338,2,1,983,424,559
240365,1,999,15954,6214,9740
240365,2,1,13573,5588,7985
240365,4,3,2381,626,1755
240374,1,999,6170,2821,3349
240374,2,1,5937,2709,3228
240374,4,3,233,112,121
240392,1,999,6630,1434,5196
240392,2,1,6391,1361,5030
240392,4,3,239,73,166
240417,1,999,11286,5434,5852
240417,2,1,9325,4834,4491
240417,4,3,1961,600,1361
240426,1,999,3434,1416,2018
240426,2,1,3129,1325,1804
240426,4,3,305,91,214
240444,1,999,46756,22559,24197
240444,2,1,33772,16187,17585
240444,4,3,12984,6372,6612
240453,1,999,36123,16861,19262
240453,2,1,29596,14277,15319
240453,4,3,6527,2584,3943
240462,1,999,9249,5608,3641
240462,2,1,8207,5058,3149
240462,4,3,1042,550,492
240471,1,999,7893,3170,4723
240471,2,1,7048,2924,4124
240471,4,3,845,246,599
240480,1,999,10878,4956,5922
240480,2,1,10007,4740,5267
240480,4,3,871,216,655
240505,1,999,6035,2633,3402
240505,2,1,6035,2633,3402
240514,1,999,3541,1596,1945
240514,2,1,3541,1596,1945
240596,1,999,2158,846,1312
240596,2,1,2158,846,1312
240620,1,999,8056,3422,4634
240620,2,1,8056,3422,4634
240657,1,999,2817,1104,1713
240657,2,1,2817,1104,1713
240666,1,999,6306,3823,2483
240666,2,1,6306,3823,2483
240693,1,999,7120,4151,2969
240693,2,1,7120,4151,2969
240709,1,999,53,3,50
240709,2,1,53,3,50
240718,1,999,2871,2769,102
240718,2,1,2871,2769,102
240727,1,999,14902,6943,7959
240727,2,1,11474,5446,6028
240727,4,3,3428,1497,1931
240736,1,999,2744,1045,1699
240736,2,1,2744,1045,1699
240745,1,999,3574,1550,2024
240745,2,1,3574,1550,2024
240754,1,999,4427,1744,2683
240754,2,1,3954,1593,2361
240754,4,3,473,151,322
240790,1,999,1388,547,841
240790,2,1,1388,547,841
240879,1,999,811,321,490
240879,2,1,811,321,490
240985,1,999,626,258,368
240985,2,1,626,258,368
241100,1,999,1758,758,1000
241100,2,1,1570,720,850
241100,4,3,188,38,150
241128,1,999,1495,602,893
241128,2,1,1414,581,833
241128,4,3,81,21,60
241146,1,999,1434,531,903
241146,2,1,1434,531,903
241182,1,999,586,177,409
241182,2,1,586,177,409
241191,1,999,1395,568,827
241191,2,1,1324,560,764
241191,4,3,71,8,63
241216,1,999,1896,1379,517
241216,2,1,1794,1314,480
241216,4,3,102,65,37
241225,1,999,2716,830,1886
241225,2,1,2223,715,1508
241225,4,3,493,115,378
241304,1,999,2189,680,1509
241304,2,1,2047,655,1392
241304,4,3,142,25,117
241331,1,999,1003,163,840
241331,2,1,221,23,198
241331,4,3,782,140,642
241377,1,999,2862,1176,1686
241377,2,1,2231,1029,1202
241377,4,3,631,147,484
241386,1,999,1186,307,879
241386,2,1,994,275,719
241386,4,3,192,32,160
241395,1,999,846,292,554
241395,2,1,588,249,339
241395,4,3,258,43,215
241410,1,999,9182,3484,5698
241410,2,1,6378,2479,3899
241410,4,3,2804,1005,1799
241517,1,999,2050,552,1498
241517,2,1,2050,552,1498
241614,1,999,232,148,84
241614,2,1,232,148,84
241720,1,999,2015,908,1107
241720,2,1,2015,908,1107
241739,1,999,15216,5168,10048
241739,2,1,12404,4340,8064
241739,4,3,2812,828,1984
241766,1,999,458,330,128
241766,2,1,420,304,116
241766,4,3,38,26,12
241793,1,999,675,280,395
241793,4,3,675,280,395
241836,1,999,1522,528,994
241836,2,1,1522,528,994
241906,1,999,582,129,453
241906,2,1,582,129,453
241951,1,999,621,280,341
241951,2,1,621,280,341
242042,1,999,882,528,354
242042,2,1,882,528,354
242112,1,999,3004,1325,1679
242112,2,1,3004,1325,1679
242121,1,999,979,306,673
242121,2,1,979,306,673
242130,1,999,493,189,304
242130,2,1,493,189,304
242149,1,999,780,351,429
242149,2,1,780,351,429
242316,1,999,463,195,268
242316,2,1,463,195,268
242413,1,999,663,416,247
242413,2,1,663,416,247
242422,1,999,23411,9599,13812
242422,2,1,23411,9599,13812
242556,1,999,834,587,247
242556,2,1,834,587,247
242565,1,999,750,507,243
242565,2,1,750,507,243
242583,1,999,720,462,258
242583,2,1,720,462,258
242617,1,999,5898,2668,3230
242617,2,1,5019,2390,2629
242617,4,3,879,278,601
242626,1,999,5320,2456,2864
242626,2,1,4973,2348,2625
242626,4,3,347,108,239
242635,1,999,5902,2259,3643
242635,2,1,5404,2144,3260
242635,4,3,498,115,383
242644,1,999,2822,1032,1790
242644,2,1,2705,1007,1698
242644,4,3,117,25,92
242653,1,999,11922,4954,6968
242653,2,1,8376,3837,4539
242653,4,3,3546,1117,2429
242662,1,999,6918,2701,4217
242662,2,1,6521,2584,3937
242662,4,3,397,117,280
242680,1,999,2615,1027,1588
242680,2,1,2542,989,1553
242680,4,3,73,38,35
242699,1,999,2740,957,1783
242699,2,1,2647,904,1743
242699,4,3,93,53,40
242705,1,999,5528,2990,2538
242705,2,1,5402,2956,2446
242705,4,3,126,34,92
242723,1,999,898,405,493
242723,4,3,898,405,493
242750,1,999,205,119,86
242750,2,1,205,119,86
242820,1,999,1428,1342,86
242820,2,1,1428,1342,86
242884,1,999,2210,553,1657
242884,2,1,2210,553,1657
242945,1,999,568,170,398
242945,2,1,568,170,398
242954,1,999,94,15,79
242954,2,1,94,15,79
242972,1,999,4011,1084,2927
242972,2,1,4011,1084,2927
242981,1,999,2291,818,1473
242981,2,1,2291,818,1473
243072,1,999,4538,1654,2884
243072,2,1,4538,1654,2884
243081,1,999,650,201,449
243081,4,3,650,201,449
243106,1,999,3276,1306,1970
243106,2,1,3276,1306,1970
243115,1,999,4026,1475,2551
243115,2,1,4026,1475,2551
243133,1,999,5191,2501,2690
243133,2,1,5191,2501,2690
243142,1,999,4682,1737,2945
243142,2,1,4682,1737,2945
243151,1,999,3741,1139,2602
243151,2,1,3741,1139,2602
243179,1,999,4793,1636,3157
243179,2,1,4793,1636,3157
243188,1,999,2005,890,1115
243188,2,1,2005,890,1115
243197,1,999,13555,7020,6535
243197,2,1,12430,6409,6021
243197,4,3,1125,611,514
243203,1,999,2407,619,1788
243203,2,1,542,104,438
243203,4,3,1865,515,1350
243212,1,999,3255,1291,1964
243212,2,1,3255,1291,1964
243221,1,999,18274,6625,11649
243221,2,1,14526,5266,9260
243221,4,3,3748,1359,2389
243346,1,999,15864,5572,10292
243346,2,1,14500,5228,9272
243346,4,3,1364,344,1020
243407,1,999,20,5,15
243407,2,1,20,5,15
243416,1,999,299,77,222
243416,2,1,299,77,222
243443,1,999,7088,2682,4406
243443,2,1,5790,2298,3492
243443,4,3,1298,384,914
243498,1,999,288,189,99
243498,4,3,288,189,99
243568,1,999,525,196,329
243568,2,1,205,51,154
243568,4,3,320,145,175
243577,1,999,6218,4736,1482
243577,2,1,5201,4039,1162
243577,4,3,1017,697,320
243586,1,999,1801,713,1088
243586,2,1,1640,647,993
243586,4,3,161,66,95
243601,1,999,18485,7278,11207
243601,2,1,15075,6272,8803
243601,4,3,3410,1006,2404
243638,1,999,5097,2359,2738
243638,2,1,5097,2359,2738
243647,1,999,922,364,558
243647,2,1,922,364,558
243665,1,999,3420,945,2475
243665,2,1,3141,889,2252
243665,4,3,279,56,223
243744,1,999,22026,12564,9462
243744,2,1,8161,4197,3964
243744,4,3,13865,8367,5498
243780,1,999,44644,26073,18571
243780,2,1,34267,19977,14290
243780,4,3,10377,6096,4281
243799,1,999,61,5,56
243799,2,1,61,5,56
243823,1,999,1205,718,487
243823,2,1,222,90,132
243823,4,3,983,628,355
243832,1,999,1771,738,1033
243832,2,1,1665,682,983
243832,4,3,106,56,50
243841,1,999,1069,416,653
243841,2,1,1069,416,653
244011,1,999,1621,1211,410
244011,2,1,1621,1211,410
244154,1,999,966,773,193
244154,2,1,966,773,193
244190,1,999,1496,717,779
244190,2,1,273,64,209
244190,4,3,1223,653,570
244233,1,999,1314,469,845
244233,2,1,1314,469,845
244279,1,999,306,25,281
244279,2,1,306,25,281
244437,1,999,38015,14282,23733
244437,2,1,38015,14282,23733
244446,1,999,8061,3146,4915
244446,2,1,8061,3146,4915
244491,1,999,178,4,174
244491,2,1,178,4,174
244561,1,999,1401,381,1020
244561,2,1,1401,381,1020
244613,1,999,368,366,2
244613,2,1,368,366,2
245032,1,999,1012,199,813
245032,2,1,1012,199,813
245069,1,999,86,17,69
245069,2,1,86,17,69
245281,1,999,65,58,7
245281,2,1,65,58,7
245290,1,999,272,127,145
245290,2,1,272,127,145
245342,1,999,2517,1546,971
245342,2,1,2517,1546,971
245421,1,999,181,20,161
245421,2,1,181,20,161
245430,1,999,469,53,416
245430,2,1,469,53,416
245625,1,999,2935,1200,1735
245625,2,1,2935,1200,1735
245652,1,999,578,338,240
245652,2,1,444,260,184
245652,4,3,134,78,56
245731,1,999,43,43,0
245731,2,1,27,27,0
245731,4,3,16,16,0
245777,1,999,20,20,0
245777,2,1,16,16,0
245777,4,3,4,4,0
245838,1,999,1261,329,932
245838,2,1,263,77,186
245838,4,3,998,252,746
245847,1,999,497,107,390
245847,2,1,197,44,153
245847,4,3,300,63,237
245865,1,999,1109,250,859
245865,4,3,1109,250,859
245883,1,999,1273,312,961
245883,2,1,431,121,310
245883,4,3,842,191,651
245892,1,999,949,290,659
245892,2,1,222,63,159
245892,4,3,727,227,500
245953,1,999,1743,717,1026
245953,2,1,1340,571,769
245953,4,3,403,146,257
245962,1,999,1013,248,765
245962,2,1,1013,248,765
245980,1,999,51,5,46
245980,2,1,51,5,46
245999,1,999,2680,1388,1292
245999,2,1,2680,1388,1292
246008,1,999,511,66,445
246008,2,1,511,66,445
246017,1,999,1008,582,426
246017,2,1,1008,582,426
246035,1,999,1396,245,1151
246035,2,1,1396,245,1151
246071,1,999,127,20,107
246071,2,1,127,20,107
246202,1,999,1030,187,843
246202,2,1,1030,187,843
246266,1,999,1425,563,862
246266,2,1,1425,563,862
246345,1,999,218,105,113
246345,4,3,218,105,113
246354,1,999,12465,4962,7503
246354,2,1,12465,4962,7503
246406,1,999,59,9,50
246406,2,1,59,9,50
246415,1,999,116,4,112
246415,2,1,116,4,112
246460,1,999,136,27,109
246460,2,1,136,27,109
246594,1,999,177,10,167
246594,2,1,177,10,167
246789,1,999,114,75,39
246789,4,3,114,75,39
246813,1,999,8321,2833,5488
246813,2,1,8321,2833,5488
246895,1,999,1472,518,954
246895,2,1,1472,518,954
246974,1,999,1304,146,1158
246974,2,1,1304,146,1158
247010,1,999,74,3,71
247010,2,1,74,3,71
247047,1,999,126,6,120
247047,2,1,126,6,120
247065,1,999,1657,392,1265
247065,2,1,1657,392,1265
247153,1,999,551,53,498
247153,2,1,551,53,498
247162,1,999,191,70,121
247162,2,1,14,10,4
247162,4,3,177,60,117
247409,1,999,379,24,355
247409,2,1,379,24,355
247603,1,999,5241,2397,2844
247603,2,1,5241,2397,2844
247649,1,999,607,428,179
247649,2,1,607,428,179
247700,1,999,1396,350,1046
247700,2,1,1396,350,1046
247773,1,999,98,98,0
247773,2,1,84,84,0
247773,4,3,14,14,0
247825,1,999,69,52,17
247825,2,1,33,28,5
247825,4,3,36,24,12
247834,1,999,41650,18106,23544
247834,2,1,41650,18106,23544
247922,1,999,7,1,6
247922,4,3,7,1,6
247940,1,999,9870,4629,5241
247940,2,1,9870,4629,5241
248165,1,999,42,0,42
248165,2,1,42,0,42
248192,1,999,24,1,23
248192,2,1,24,1,23
248305,1,999,360,11,349
248305,2,1,360,11,349
248314,1,999,77,5,72
248314,2,1,77,5,72
248527,1,999,72,6,66
248527,2,1,72,6,66
248606,1,999,990,559,431
248606,2,1,990,559,431
248624,1,999,134,14,120
248624,2,1,134,14,120
248633,1,999,54,4,50
248633,2,1,54,4,50
248660,1,999,99,6,93
248660,2,1,99,6,93
248703,1,999,320,17,303
248703,2,1,320,17,303
248776,1,999,2832,1032,1800
248776,2,1,2832,1032,1800
248846,1,999,385,34,351
248846,2,1,385,34,351
248882,1,999,852,226,626
248882,2,1,852,226,626
248925,1,999,1488,734,754
248925,2,1,1488,734,754
248934,1,999,18625,7854,10771
248934,2,1,18625,7854,10771
249061,1,999,83,5,78
249061,2,1,83,5,78
249140,1,999,1105,384,721
249140,2,1,1105,384,721
249238,1,999,461,40,421
249238,2,1,461,40,421
249247,1,999,1963,523,1440
249247,2,1,1963,523,1440
249566,1,999,425,386,39
249566,2,1,425,386,39
249609,1,999,720,225,495
249609,2,1,720,225,495
250027,1,999,464,115,349
250027,2,1,464,115,349
250072,1,999,188,16,172
250072,2,1,188,16,172
250285,1,999,502,465,37
250285,2,1,502,465,37
250407,1,999,2166,218,1948
250407,2,1,2166,218,1948
250498,1,999,293,81,212
250498,2,1,293,81,212
250601,1,999,1085,387,698
250601,2,1,1085,387,698
250744,1,999,995,101,894
250744,2,1,995,101,894
250832,1,999,125,2,123
250832,2,1,125,2,123
250902,1,999,118,6,112
250902,2,1,118,6,112
250920,1,999,3523,1986,1537
250920,2,1,3523,1986,1537
250993,1,999,240,123,117
250993,2,1,240,123,117
251075,1,999,914,219,695
251075,2,1,914,219,695
251251,1,999,962,566,396
251251,2,1,962,566,396
251260,1,999,7310,3172,4138
251260,2,1,7310,3172,4138
251312,1,999,2529,496,2033
251312,2,1,2022,396,1626
251312,4,3,507,100,407
260293,1,999,18650,3818,14832
260293,2,1,18375,3743,14632
260293,4,3,275,75,200
260336,1,999,29,2,27
260336,2,1,29,2,27
260354,1,999,209,26,183
260354,2,1,209,26,183
260363,1,999,36,4,32
260363,2,1,36,4,32
260372,1,999,767,279,488
260372,2,1,767,279,488
260664,1,999,519,466,53
260664,2,1,519,466,53
260691,1,999,2520,546,1974
260691,2,1,2520,546,1974
260789,1,999,603,206,397
260789,2,1,603,206,397
260813,1,999,228,40,188
260813,2,1,228,40,188
260901,1,999,91976,24282,67694
260901,2,1,80143,21170,58973
260901,4,3,11833,3112,8721
260910,1,999,951,228,723
260910,2,1,920,215,705
260910,4,3,31,13,18
260929,1,999,310,25,285
260929,2,1,310,25,285
260947,1,999,42,22,20
260947,2,1,42,22,20
260956,1,999,140,101,39
260956,4,3,140,101,39
260965,1,999,155,5,150
260965,2,1,155,5,150
260974,1,999,811,669,142
260974,2,1,811,669,142
260992,1,999,1673,332,1341
260992,2,1,1673,332,1341
261375,1,999,2064,1012,1052
261375,2,1,2064,1012,1052
261384,1,999,854,640,214
261384,2,1,854,640,214
261393,1,999,433,268,165
261393,2,1,433,268,165
261436,1,999,1040,56,984
261436,2,1,1040,56,984
261472,1,999,2291,1758,533
261472,2,1,2291,1758,533
261676,1,999,286,14,272
261676,2,1,286,14,272
261685,1,999,289,16,273
261685,2,1,289,16,273
261719,1,999,61,6,55
261719,2,1,61,6,55
261773,1,999,61,24,37
261773,2,1,61,24,37
261861,1,999,264,52,212
261861,2,1,264,52,212
261931,1,999,519,191,328
261931,2,1,519,191,328
262022,1,999,229,127,102
262022,4,3,229,127,102
262031,1,999,11550,4866,6684
262031,2,1,11550,4866,6684
262086,1,999,10081,3268,6813
262086,2,1,4659,1745,2914
262086,4,3,5422,1523,3899
262129,1,999,832,328,504
262129,2,1,832,328,504
262235,1,999,118,7,111
262235,2,1,118,7,111
262299,1,999,173,11,162
262299,2,1,173,11,162
262332,1,999,2628,1471,1157
262332,2,1,2628,1471,1157
262341,1,999,1183,1093,90
262341,2,1,1183,1093,90
262369,1,999,240,7,233
262369,2,1,240,7,233
262402,1,999,454,438,16
262402,2,1,454,438,16
262457,1,999,1783,555,1228
262457,2,1,1783,555,1228
262466,1,999,177,83,94
262466,2,1,177,83,94
262509,1,999,1008,271,737
262509,2,1,1008,271,737
262660,1,999,221,18,203
262660,2,1,221,18,203
362700,1,999,659,118,541
362700,2,1,659,118,541
362782,1,999,149,3,146
362782,2,1,149,3,146
363013,1,999,199,19,180
363013,2,1,199,19,180
363077,1,999,429,71,358
363077,2,1,429,71,358
363147,1,999,79,2,77
363147,2,1,79,2,77
363165,1,999,1724,936,788
363165,2,1,1724,936,788
363387,1,999,2342,647,1695
363387,2,1,2342,647,1695
363439,1,999,1067,256,811
363439,2,1,1067,256,811
363457,1,999,299,225,74
363457,2,1,299,225,74
363590,1,999,1384,198,1186
363590,2,1,1384,198,1186
363633,1,999,2719,1210,1509
363633,2,1,2719,1210,1509
363679,1,999,177,6,171
363679,2,1,177,6,171
363712,1,999,49,49,0
363712,2,1,49,49,0
363721,1,999,346,143,203
363721,4,3,346,143,203
363882,1,999,76,5,71
363882,2,1,76,5,71
363907,1,999,2157,934,1223
363907,2,1,1542,795,747
363907,4,3,615,139,476
363916,1,999,934,273,661
363916,2,1,666,215,451
363916,4,3,268,58,210
363934,1,999,1460,1302,158
363934,2,1,1346,1214,132
363934,4,3,114,88,26
364016,1,999,16046,6948,9098
364016,2,1,16046,6948,9098
364025,1,999,17938,8450,9488
364025,2,1,17938,8450,9488
364122,1,999,6,2,4
364122,2,1,6,2,4
364168,1,999,664,568,96
364168,2,1,664,568,96
364317,1,999,1662,177,1485
364317,2,1,1662,177,1485
364326,1,999,1374,163,1211
364326,2,1,1374,163,1211
364335,1,999,1882,381,1501
364335,2,1,1882,381,1501
364548,1,999,394,180,214
364548,2,1,394,180,214
364566,1,999,181,7,174
364566,2,1,181,7,174
364575,1,999,65,15,50
364575,2,1,65,15,50
364584,1,999,245,37,208
364584,2,1,245,37,208
364593,1,999,265,43,222
364593,2,1,265,43,222
364618,1,999,116,12,104
364618,2,1,116,12,104
364627,1,999,479,222,257
364627,2,1,479,222,257
364636,1,999,89,40,49
364636,2,1,89,40,49
364751,1,999,297,11,286
364751,2,1,297,11,286
364760,1,999,47,5,42
364760,2,1,47,5,42
364812,1,999,114,0,114
364812,2,1,114,0,114
364885,1,999,612,171,441
364885,2,1,612,171,441
364946,1,999,392,163,229
364946,2,1,392,163,229
364955,1,999,1731,428,1303
364955,2,1,1731,428,1303
364964,1,999,36,3,33
364964,2,1,36,3,33
364973,1,999,1633,891,742
364973,2,1,1633,891,742
365055,1,999,2200,1003,1197
365055,2,1,2200,1003,1197
365073,1,999,235,8,227
365073,2,1,235,8,227
365091,1,999,603,22,581
365091,2,1,603,22,581
365107,1,999,86,4,82
365107,2,1,86,4,82
365125,1,999,280,1,279
365125,2,1,280,1,279
365198,1,999,596,285,311
365198,2,1,596,285,311
365204,1,999,2044,682,1362
365204,2,1,2044,682,1362
365213,1,999,628,340,288
365213,2,1,628,340,288
365240,1,999,662,282,380
365240,2,1,662,282,380
365374,1,999,1569,789,780
365374,2,1,1569,789,780
365383,1,999,198,20,178
365383,2,1,198,20,178
365426,1,999,352,177,175
365426,4,3,352,177,175
365453,1,999,42,3,39
365453,2,1,42,3,39
365480,1,999,771,398,373
365480,2,1,771,398,373
365505,1,999,98,25,73
365505,2,1,98,25,73
365569,1,999,71,25,46
365569,2,1,71,25,46
365693,1,999,166,4,162
365693,2,1,166,4,162
365763,1,999,52,21,31
365763,2,1,52,21,31
365824,1,999,314,17,297
365824,2,1,314,17,297
365833,1,999,289,19,270
365833,2,1,289,19,270
366003,1,999,154,84,70
366003,2,1,120,70,50
366003,4,3,34,14,20
366155,1,999,60,40,20
366155,2,1,60,40,20
366191,1,999,2638,2585,53
366191,2,1,2638,2585,53
366252,1,999,7575,4786,2789
366252,2,1,7575,4786,2789
366261,1,999,256,105,151
366261,2,1,256,105,151
366270,1,999,1073,62,1011
366270,2,1,1073,62,1011
366289,1,999,287,170,117
366289,2,1,287,170,117
366340,1,999,978,419,559
366340,2,1,978,419,559
366368,1,999,119,57,62
366368,4,3,119,57,62
366395,1,999,34783,15972,18811
366395,2,1,34783,15972,18811
366401,1,999,12675,5892,6783
366401,2,1,12675,5892,6783
366438,1,999,157,4,153
366438,2,1,157,4,153
366447,1,999,2806,1367,1439
366447,2,1,2806,1367,1439
366465,1,999,4468,1557,2911
366465,2,1,4468,1557,2911
366535,1,999,983,247,736
366535,2,1,983,247,736
366544,1,999,1244,240,1004
366544,2,1,1244,240,1004
366553,1,999,3539,1000,2539
366553,2,1,3539,1000,2539
366571,1,999,43,7,36
366571,2,1,43,7,36
366580,1,999,1021,907,114
366580,2,1,1021,907,114
366605,1,999,68,15,53
366605,4,3,68,15,53
366623,1,999,116,53,63
366623,2,1,116,53,63
366632,1,999,86,15,71
366632,2,1,86,15,71
366650,1,999,1567,1148,419
366650,2,1,1567,1148,419
366678,1,999,1319,1077,242
366678,2,1,1319,1077,242
366696,1,999,1734,1382,352
366696,2,1,1734,1382,352
366702,1,999,820,420,400
366702,4,3,820,420,400
366711,1,999,10872,4183,6689
366711,2,1,9843,3913,5930
366711,4,3,1029,270,759
366748,1,999,723,218,505
366748,2,1,211,100,111
366748,4,3,512,118,394
366757,1,999,769,379,390
366757,4,3,769,379,390
366793,1,999,151,82,69
366793,4,3,151,82,69
366960,1,999,1496,329,1167
366960,2,1,1496,329,1167
367024,1,999,1582,462,1120
367024,2,1,1527,445,1082
367024,4,3,55,17,38
367051,1,999,142,4,138
367051,2,1,142,4,138
367088,1,999,67,3,64
367088,2,1,67,3,64
367097,1,999,288,78,210
367097,2,1,288,78,210
367103,1,999,67,15,52
367103,2,1,67,15,52
367112,1,999,1449,354,1095
367112,2,1,1449,354,1095
367130,1,999,248,26,222
367130,2,1,248,26,222
367158,1,999,128,12,116
367158,2,1,128,12,116
367194,1,999,722,570,152
367194,2,1,722,570,152
367316,1,999,403,101,302
367316,2,1,403,101,302
367334,1,999,451,431,20
367334,2,1,451,431,20
367361,1,999,46,23,23
367361,2,1,46,23,23
367398,1,999,829,116,713
367398,2,1,829,116,713
367413,1,999,991,576,415
367413,2,1,991,576,415
367431,1,999,69,9,60
367431,2,1,69,9,60
367459,1,999,12190,5205,6985
367459,2,1,12190,5205,6985
367662,1,999,138,1,137
367662,2,1,138,1,137
367839,1,999,136,55,81
367839,2,1,75,32,43
367839,4,3,61,23,38
367875,1,999,704,257,447
367875,2,1,704,257,447
367884,1,999,3645,1213,2432
367884,2,1,3215,1067,2148
367884,4,3,430,146,284
367909,1,999,1480,274,1206
367909,2,1,1480,274,1206
367936,1,999,3980,890,3090
367936,2,1,648,166,482
367936,4,3,3332,724,2608
367954,1,999,1956,732,1224
367954,4,3,1956,732,1224
367972,1,999,237,20,217
367972,2,1,237,20,217
367981,1,999,170,4,166
367981,2,1,170,4,166
368036,1,999,96,12,84
368036,2,1,96,12,84
368160,1,999,57,2,55
368160,2,1,57,2,55
368230,1,999,342,56,286
368230,2,1,342,56,286
368364,1,999,262,107,155
368364,2,1,262,107,155
368407,1,999,94,7,87
368407,2,1,94,7,87
368443,1,999,1338,333,1005
368443,2,1,1338,333,1005
368452,1,999,489,212,277
368452,2,1,489,212,277
368540,1,999,86,5,81
368540,2,1,86,5,81
368601,1,999,2139,1351,788
368601,2,1,2139,1351,788
368629,1,999,1344,294,1050
368629,2,1,1344,294,1050
368647,1,999,48,3,45
368647,2,1,48,3,45
368771,1,999,237,83,154
368771,2,1,237,83,154
368780,1,999,365,139,226
368780,2,1,365,139,226
368799,1,999,1184,447,737
368799,2,1,1184,447,737
368805,1,999,981,234,747
368805,2,1,981,234,747
368832,1,999,107,15,92
368832,2,1,107,15,92
368911,1,999,3234,905,2329
368911,2,1,3234,905,2329
369002,1,999,738,373,365
369002,4,3,738,373,365
369020,1,999,58,1,57
369020,2,1,58,1,57
369084,1,999,1411,877,534
369084,2,1,1411,877,534
369109,1,999,203,46,157
369109,2,1,203,46,157
369400,1,999,6162,6014,148
369400,2,1,6162,6014,148
369419,1,999,1555,575,980
369419,2,1,1555,575,980
369446,1,999,143,11,132
369446,2,1,143,11,132
369455,1,999,142,69,73
369455,2,1,142,69,73
369516,1,999,577,151,426
369516,2,1,577,151,426
369659,1,999,286,75,211
369659,4,3,286,75,211
369668,1,999,192,115,77
369668,2,1,192,115,77
369686,1,999,390,51,339
369686,2,1,390,51,339
369695,1,999,133,12,121
369695,2,1,133,12,121
369783,1,999,1651,162,1489
369783,2,1,1651,162,1489
369792,1,999,22,5,17
369792,2,1,22,5,17
369817,1,999,102,62,40
369817,4,3,102,62,40
369862,1,999,706,128,578
369862,2,1,706,128,578
369905,1,999,1686,286,1400
369905,2,1,1686,286,1400
369950,1,999,334,291,43
369950,2,1,334,291,43
371034,1,999,29,8,21
371034,2,1,29,8,21
371052,1,999,606,42,564
371052,2,1,606,42,564
371140,1,999,118,2,116
371140,2,1,118,2,116
371265,1,999,1630,219,1411
371265,2,1,1630,219,1411
371690,1,999,2277,311,1966
371690,2,1,2277,311,1966
371760,1,999,3481,1116,2365
371760,2,1,3481,1116,2365
371779,1,999,3072,880,2192
371779,2,1,3072,880,2192
371830,1,999,93,45,48
371830,2,1,93,45,48
371928,1,999,202,88,114
371928,2,1,202,88,114
371964,1,999,652,148,504
371964,2,1,652,148,504
371982,1,999,1410,86,1324
371982,2,1,1410,86,1324
372000,1,999,70,3,67
372000,2,1,70,3,67
372028,1,999,218,36,182
372028,2,1,218,36,182
372037,1,999,2035,203,1832
372037,2,1,2035,203,1832
372073,1,999,606,243,363
372073,2,1,606,243,363
372082,1,999,3337,1031,2306
372082,2,1,3337,1031,2306
372213,1,999,496050,150167,345883
372213,2,1,409538,124546,284992
372213,4,3,86512,25621,60891
372222,1,999,7962,4007,3955
372222,2,1,6886,3543,3343
372222,4,3,1076,464,612
372240,1,999,46,2,44
372240,2,1,46,2,44
372329,1,999,1278,256,1022
372329,2,1,1278,256,1022
372356,1,999,215,10,205
372356,2,1,215,10,205
372462,1,999,149,13,136
372462,2,1,149,13,136
372523,1,999,681,132,549
372523,2,1,681,132,549
372578,1,999,1250,886,364
372578,2,1,1250,886,364
372718,1,999,415,65,350
372718,2,1,415,65,350
372772,1,999,646,196,450
372772,2,1,646,196,450
372921,1,999,1642,712,930
372921,2,1,1642,712,930
372958,1,999,1125,320,805
372958,2,1,1125,320,805
373058,1,999,805,349,456
373058,2,1,805,349,456
373085,1,999,743,125,618
373085,2,1,743,125,618
373119,1,999,336,332,4
373119,2,1,336,332,4
373216,1,999,274,18,256
373216,2,1,274,18,256
373340,1,999,155,9,146
373340,2,1,155,9,146
373447,1,999,43,5,38
373447,2,1,43,5,38
373526,1,999,532,468,64
373526,2,1,532,468,64
373605,1,999,48,1,47
373605,2,1,48,1,47
373678,1,999,337,148,189
373678,2,1,337,148,189
373696,1,999,353,162,191
373696,2,1,353,162,191
373711,1,999,60,7,53
373711,2,1,60,7,53
373784,1,999,2927,1877,1050
373784,2,1,2927,1877,1050
373827,1,999,582,429,153
373827,2,1,582,429,153
373890,1,999,1312,129,1183
373890,2,1,1312,129,1183
374024,1,999,466,96,370
374024,4,3,466,96,370
374112,1,999,33,6,27
374112,2,1,33,6,27
374291,1,999,69,5,64
374291,2,1,69,5,64
374316,1,999,162,84,78
374316,2,1,162,84,78
374440,1,999,5,1,4
374440,2,1,5,1,4
374574,1,999,1817,245,1572
374574,2,1,1817,245,1572
374592,1,999,172,54,118
374592,2,1,172,54,118
374875,1,999,1389,377,1012
374875,2,1,1389,377,1012
374927,1,999,132,6,126
374927,2,1,132,6,126
374972,1,999,3643,563,3080
374972,2,1,3643,563,3080
374990,1,999,190,12,178
374990,2,1,190,12,178
375106,1,999,207,192,15
375106,2,1,207,192,15
375230,1,999,116,116,0
375230,2,1,116,116,0
375300,1,999,536,45,491
375300,2,1,536,45,491
375319,1,999,248,15,233
375319,2,1,248,15,233
375373,1,999,389,98,291
375373,2,1,389,98,291
375407,1,999,253,69,184
375407,2,1,253,69,184
375416,1,999,1076,241,835
375416,2,1,1076,241,835
375489,1,999,1746,323,1423
375489,2,1,1746,323,1423
375540,1,999,195,14,181
375540,2,1,195,14,181
375559,1,999,284,17,267
375559,2,1,284,17,267
375568,1,999,27,3,24
375568,2,1,27,3,24
375647,1,999,238,36,202
375647,2,1,238,36,202
375656,1,999,302,155,147
375656,2,1,302,155,147
375683,1,999,910,353,557
375683,2,1,910,353,557
375692,1,999,84,36,48
375692,2,1,84,36,48
375708,1,999,205,115,90
375708,2,1,205,115,90
375717,1,999,168,89,79
375717,2,1,168,89,79
375726,1,999,765,407,358
375726,2,1,765,407,358
375735,1,999,418,188,230
375735,2,1,418,188,230
375744,1,999,404,268,136
375744,2,1,404,268,136
375753,1,999,65,45,20
375753,2,1,65,45,20
375762,1,999,65,24,41
375762,2,1,65,24,41
375799,1,999,44,2,42
375799,2,1,44,2,42
375841,1,999,1017,556,461
375841,2,1,1017,556,461
375939,1,999,509,89,420
375939,2,1,509,89,420
375948,1,999,1651,619,1032
375948,2,1,1651,619,1032
375966,1,999,185,24,161
375966,2,1,185,24,161
375984,1,999,938,125,813
375984,2,1,938,125,813
376039,1,999,82,27,55
376039,2,1,82,27,55
376136,1,999,993,155,838
376136,2,1,993,155,838
376224,1,999,1185,299,886
376224,2,1,1185,299,886
376242,1,999,515,322,193
376242,2,1,515,322,193
376288,1,999,171,27,144
376288,2,1,171,27,144
376321,1,999,2514,724,1790
376321,2,1,2514,724,1790
376330,1,999,835,143,692
376330,2,1,835,143,692
376385,1,999,2036,823,1213
376385,2,1,2036,823,1213
376446,1,999,200,11,189
376446,2,1,200,11,189
376631,1,999,58,12,46
376631,2,1,58,12,46
376668,1,999,74,14,60
376668,2,1,74,14,60
376677,1,999,264,79,185
376677,2,1,264,79,185
376695,1,999,1176,546,630
376695,2,1,1176,546,630
376987,1,999,168,6,162
376987,2,1,168,6,162
377069,1,999,1485,1229,256
377069,2,1,1485,1229,256
377111,1,999,1182,278,904
377111,2,1,1182,278,904
377193,1,999,102,9,93
377193,2,1,102,9,93
377218,1,999,133,133,0
377218,2,1,133,133,0
377272,1,999,71,9,62
377272,2,1,71,9,62
377281,1,999,83,6,77
377281,2,1,83,6,77
377315,1,999,159,11,148
377315,2,1,159,11,148
377342,1,999,149,18,131
377342,2,1,149,18,131
377421,1,999,336,78,258
377421,2,1,336,78,258
377449,1,999,659,142,517
377449,2,1,659,142,517
377458,1,999,672,43,629
377458,2,1,672,43,629
377485,1,999,61,4,57
377485,2,1,61,4,57
377546,1,999,107,39,68
377546,2,1,107,39,68
377555,1,999,4017,1818,2199
377555,2,1,3459,1601,1858
377555,4,3,558,217,341
377564,1,999,4177,1688,2489
377564,2,1,3488,1513,1975
377564,4,3,689,175,514
377634,1,999,13,2,11
377634,2,1,13,2,11
377643,1,999,211,15,196
377643,2,1,211,15,196
377652,1,999,152,16,136
377652,2,1,152,16,136
377661,1,999,81,10,71
377661,2,1,81,10,71
377670,1,999,60,6,54
377670,2,1,60,6,54
377722,1,999,594,27,567
377722,2,1,594,27,567
377759,1,999,122,84,38
377759,2,1,122,84,38
378105,1,999,437,73,364
378105,2,1,437,73,364
378406,1,999,1417,1016,401
378406,2,1,1417,1016,401
378576,1,999,764,231,533
378576,2,1,166,65,101
378576,4,3,598,166,432
378886,1,999,485,237,248
378886,2,1,485,237,248
378956,1,999,871,829,42
378956,2,1,871,829,42
379029,1,999,2279,400,1879
379029,2,1,2279,400,1879
379135,1,999,155,132,23
379135,2,1,155,132,23
379463,1,999,140,45,95
379463,2,1,140,45,95
379621,1,999,152,20,132
379621,2,1,152,20,132
379746,1,999,114,8,106
379746,2,1,114,8,106
379782,1,999,454,79,375
379782,2,1,272,37,235
379782,4,3,182,42,140
380067,1,999,204,6,198
380067,2,1,204,6,198
380094,1,999,823,231,592
380094,2,1,823,231,592
380359,1,999,750,248,502
380359,2,1,750,248,502
380368,1,999,2848,1246,1602
380368,2,1,2848,1246,1602
380377,1,999,1397,505,892
380377,2,1,1397,505,892
380401,1,999,206,6,200
380401,2,1,206,6,200
380410,1,999,268,7,261
380410,2,1,268,7,261
380438,1,999,977,272,705
380438,2,1,977,272,705
380447,1,999,209,4,205
380447,2,1,209,4,205
380456,1,999,300,9,291
380456,2,1,300,9,291
380465,1,999,3581,1909,1672
380465,2,1,1981,1148,833
380465,4,3,1600,761,839
380474,1,999,787,227,560
380474,2,1,787,227,560
381255,1,999,308,227,81
381255,2,1,308,227,81
381282,1,999,262,137,125
381282,2,1,262,137,125
381325,1,999,365,171,194
381325,2,1,365,171,194
381334,1,999,196,64,132
381334,2,1,196,64,132
381352,1,999,138,34,104
381352,4,3,138,34,104
381361,1,999,102,23,79
381361,2,1,102,23,79
381370,1,999,283,13,270
381370,2,1,283,13,270
381404,1,999,502,27,475
381404,2,1,502,27,475
381459,1,999,230,162,68
381459,4,3,230,162,68
381486,1,999,34,2,32
381486,2,1,34,2,32
381529,1,999,787,263,524
381529,2,1,787,263,524
381617,1,999,2429,733,1696
381617,2,1,2417,727,1690
381617,4,3,12,6,6
381635,1,999,164,5,159
381635,2,1,164,5,159
381644,1,999,361,31,330
381644,2,1,361,31,330
381699,1,999,33,1,32
381699,2,1,33,1,32
381705,1,999,56,4,52
381705,2,1,56,4,52
381732,1,999,411,78,333
381732,2,1,411,78,333
381741,1,999,311,60,251
381741,2,1,311,60,251
381750,1,999,149,12,137
381750,2,1,149,12,137
381787,1,999,677,351,326
381787,2,1,677,351,326
381796,1,999,398,81,317
381796,2,1,398,81,317
381866,1,999,42,10,32
381866,2,1,42,10,32
381909,1,999,2343,1728,615
381909,2,1,2343,1728,615
381945,1,999,83,31,52
381945,2,1,83,31,52
382054,1,999,606,149,457
382054,2,1,606,149,457
382063,1,999,3147,1264,1883
382063,2,1,1295,621,674
382063,4,3,1852,643,1209
382258,1,999,629,124,505
382258,2,1,629,124,505
382267,1,999,152,4,148
382267,2,1,152,4,148
382276,1,999,829,117,712
382276,2,1,829,117,712
382416,1,999,80,21,59
382416,2,1,80,21,59
382461,1,999,91,2,89
382461,2,1,91,2,89
382504,1,999,784,190,594
382504,2,1,784,190,594
382771,1,999,1330,250,1080
382771,2,1,1330,250,1080
382780,1,999,569,78,491
382780,2,1,569,78,491
382896,1,999,531,127,404
382896,2,1,531,127,404
382902,1,999,137,10,127
382902,2,1,137,10,127
382911,1,999,145,73,72
382911,2,1,145,73,72
382957,1,999,765,102,663
382957,2,1,765,102,663
383020,1,999,127,26,101
383020,4,3,127,26,101
383084,1,999,5396,3537,1859
383084,2,1,5396,3537,1859
383163,1,999,403,17,386
383163,2,1,403,17,386
383172,1,999,77,30,47
383172,2,1,77,30,47
383190,1,999,4691,1852,2839
383190,2,1,4691,1852,2839
383251,1,999,242,22,220
383251,2,1,242,22,220
383279,1,999,190,29,161
383279,2,1,190,29,161
383297,1,999,297,11,286
383297,2,1,297,11,286
383312,1,999,167,72,95
383312,2,1,167,72,95
383330,1,999,226,88,138
383330,2,1,226,88,138
383367,1,999,301,64,237
383367,2,1,301,64,237
383400,1,999,114,20,94
383400,2,1,114,20,94
383464,1,999,105,9,96
383464,2,1,105,9,96
383507,1,999,13,7,6
383507,2,1,13,7,6
383525,1,999,239,34,205
383525,2,1,239,34,205
383765,1,999,240,10,230
383765,2,1,240,10,230
383792,1,999,292,5,287
383792,2,1,292,5,287
383899,1,999,1488,340,1148
383899,2,1,1488,340,1148
383950,1,999,771,91,680
383950,2,1,771,91,680
383996,1,999,1802,658,1144
383996,2,1,1802,658,1144
384184,1,999,314,62,252
384184,2,1,314,62,252
384193,1,999,749,127,622
384193,2,1,749,127,622
384209,1,999,1314,318,996
384209,2,1,1314,318,996
384254,1,999,158,96,62
384254,2,1,158,96,62
384306,1,999,183,44,139
384306,4,3,183,44,139
384333,1,999,12612,4900,7712
384333,2,1,12612,4900,7712
384342,1,999,10233,4909,5324
384342,2,1,10233,4909,5324
384360,1,999,2277,792,1485
384360,2,1,2277,792,1485
384379,1,999,2138,839,1299
384379,2,1,2138,839,1299
384388,1,999,1547,627,920
384388,2,1,1547,627,920
384397,1,999,2212,804,1408
384397,2,1,2212,804,1408
384412,1,999,524,217,307
384412,2,1,524,217,307
384421,1,999,78,78,0
384421,2,1,78,78,0
385008,1,999,1527,235,1292
385008,2,1,1527,235,1292
385132,1,999,150,24,126
385132,2,1,150,24,126
385503,1,999,649,88,561
385503,2,1,649,88,561
385549,1,999,392,51,341
385549,2,1,392,51,341
385619,1,999,1957,1014,943
385619,2,1,1828,922,906
385619,4,3,129,92,37
386153,1,999,410,0,410
386153,2,1,410,0,410
386472,1,999,686,245,441
386472,2,1,686,245,441
387235,1,999,62,5,57
387235,2,1,62,5,57
387660,1,999,7,6,1
387660,2,1,7,6,1
387819,1,999,99,13,86
387819,2,1,99,13,86
387925,1,999,711,114,597
387925,2,1,711,114,597
388043,1,999,2632,560,2072
388043,2,1,2632,560,2072
388520,1,999,596,333,263
388520,2,1,596,333,263
388663,1,999,275,31,244
388663,2,1,275,31,244
389727,1,999,968,126,842
389727,2,1,968,126,842
389860,1,999,823,308,515
389860,2,1,823,308,515
390701,1,999,30652,6584,24068
390701,2,1,30373,6497,23876
390701,4,3,279,87,192
390905,1,999,378,86,292
390905,2,1,378,86,292
391005,1,999,441,13,428
391005,2,1,441,13,428
391333,1,999,84,12,72
391333,2,1,84,12,72
391546,1,999,171,26,145
391546,2,1,171,26,145
391564,1,999,550,62,488
391564,2,1,550,62,488
391582,1,999,1343,166,1177
391582,2,1,1343,166,1177
391759,1,999,81,2,79
391759,2,1,81,2,79
391810,1,999,143,30,113
391810,2,1,143,30,113
392257,1,999,391,68,323
392257,2,1,391,68,323
392354,1,999,24,12,12
392354,2,1,24,12,12
392415,1,999,1184,185,999
392415,2,1,1184,185,999
392798,1,999,107,5,102
392798,2,1,107,5,102
392840,1,999,426,206,220
392840,2,1,426,206,220
393180,1,999,1152,471,681
393180,2,1,1152,471,681
393524,1,999,311,33,278
393524,2,1,311,33,278
393649,1,999,1067,557,510
393649,2,1,1067,557,510
393861,1,999,248,46,202
393861,2,1,248,46,202
393977,1,999,114,4,110
393977,2,1,114,4,110
395362,1,999,2912,1077,1835
395362,2,1,2912,1077,1835
395690,1,999,1519,586,933
395690,2,1,1519,586,933
397270,1,999,72,25,47
397270,2,1,72,25,47
397641,1,999,247,219,28
397641,2,1,247,219,28
397942,1,999,1057,252,805
397942,2,1,1057,252,805
398130,1,999,798,572,226
398130,2,1,798,572,226
398574,1,999,3084,2141,943
398574,2,1,3084,2141,943
399212,1,999,20660,14113,6547
399212,2,1,20660,14113,6547
399869,1,999,1166,933,233
399869,2,1,1166,933,233
399911,1,999,444,159,285
399911,2,1,441,158,283
399911,4,3,3,1,2
400080,1,999,2929,531,2398
400080,2,1,2929,531,2398
400187,1,999,1044,212,832
400187,2,1,1044,212,832
400637,1,999,2503,419,2084
400637,2,1,2503,419,2084
401223,1,999,289,149,140
401223,2,1,131,56,75
401223,4,3,158,93,65
401250,1,999,250,56,194
401250,4,3,250,56,194
401339,1,999,1092,688,404
401339,2,1,1092,688,404
401481,1,999,130,0,130
401481,2,1,130,0,130
402563,1,999,636,25,611
402563,2,1,636,25,611
402615,1,999,1561,585,976
402615,2,1,1373,496,877
402615,4,3,188,89,99
402776,1,999,350,164,186
402776,2,1,350,164,186
402800,1,999,406,13,393
402800,2,1,406,13,393
402828,1,999,627,304,323
402828,4,3,627,304,323
403414,1,999,60,6,54
403414,2,1,60,6,54
403469,1,999,8222,3650,4572
403469,2,1,8222,3650,4572
403478,1,999,1883,759,1124
403478,2,1,1883,759,1124
403487,1,999,18552,14189,4363
403487,2,1,18552,14189,4363
404037,1,999,28,4,24
404037,2,1,28,4,24
404055,1,999,1009,221,788
404055,2,1,1009,221,788
404073,1,999,5524,1670,3854
404073,2,1,5472,1652,3820
404073,4,3,52,18,34
404082,1,999,8480,2690,5790
404082,2,1,8437,2673,5764
404082,4,3,43,17,26
404222,1,999,220,89,131
404222,4,3,220,89,131
404338,1,999,404,198,206
404338,2,1,240,101,139
404338,4,3,164,97,67
404365,1,999,729,328,401
404365,2,1,729,328,401
404374,1,999,652,202,450
404374,2,1,652,202,450
404383,1,999,1277,914,363
404383,2,1,1277,914,363
404426,1,999,6991,2998,3993
404426,2,1,6991,2998,3993
404499,1,999,2837,394,2443
404499,2,1,2837,394,2443
404505,1,999,1566,194,1372
404505,2,1,1566,194,1372
404514,1,999,1878,253,1625
404514,2,1,1878,253,1625
404648,1,999,3037,960,2077
404648,2,1,3031,959,2072
404648,4,3,6,1,5
404684,1,999,837,261,576
404684,2,1,837,261,576
404718,1,999,118,5,113
404718,2,1,118,5,113
404806,1,999,733,199,534
404806,2,1,733,199,534
404912,1,999,1876,342,1534
404912,2,1,1876,342,1534
404921,1,999,1192,459,733
404921,2,1,1192,459,733
404994,1,999,9451,3060,6391
404994,2,1,9451,3060,6391
405003,1,999,38,4,34
405003,2,1,38,4,34
405012,1,999,90,8,82
405012,2,1,90,8,82
405021,1,999,91,4,87
405021,2,1,91,4,87
405058,1,999,134,134,0
405058,2,1,134,134,0
405076,1,999,415,75,340
405076,2,1,415,75,340
405748,1,999,137,81,56
405748,2,1,137,81,56
405854,1,999,178,178,0
405854,2,1,178,178,0
405872,1,999,5600,2127,3473
405872,2,1,5600,2127,3473
405979,1,999,3044,1297,1747
405979,2,1,2282,1021,1261
405979,4,3,762,276,486
405988,1,999,3095,1107,1988
405988,2,1,1954,729,1225
405988,4,3,1141,378,763
405997,1,999,5911,2322,3589
405997,2,1,5086,2013,3073
405997,4,3,825,309,516
406006,1,999,2986,1288,1698
406006,2,1,2461,1046,1415
406006,4,3,525,242,283
406015,1,999,14395,5554,8841
406015,2,1,11652,4689,6963
406015,4,3,2743,865,1878
406024,1,999,885,184,701
406024,2,1,885,184,701
406033,1,999,1398,199,1199
406033,2,1,1398,199,1199
406051,1,999,139,14,125
406051,2,1,139,14,125
406060,1,999,197,50,147
406060,2,1,197,50,147
406149,1,999,128,30,98
406149,2,1,128,30,98
406194,1,999,883,497,386
406194,2,1,883,497,386
406200,1,999,3021,634,2387
406200,2,1,3021,634,2387
406219,1,999,1217,354,863
406219,2,1,1217,354,863
406264,1,999,2174,401,1773
406264,2,1,2174,401,1773
406325,1,999,132,11,121
406325,2,1,132,11,121
406361,1,999,78,8,70
406361,2,1,78,8,70
406413,1,999,178,39,139
406413,2,1,178,39,139
406422,1,999,192,15,177
406422,2,1,192,15,177
406486,1,999,74,18,56
406486,2,1,74,18,56
406495,1,999,267,26,241
406495,2,1,267,26,241
406547,1,999,987,196,791
406547,2,1,987,196,791
407054,1,999,344,68,276
407054,2,1,344,68,276
407063,1,999,1341,1010,331
407063,2,1,1341,1010,331
407090,1,999,454,11,443
407090,2,1,454,11,443
407142,1,999,137,5,132
407142,2,1,137,5,132
407151,1,999,197,6,191
407151,2,1,197,6,191
407179,1,999,321,26,295
407179,2,1,321,26,295
407285,1,999,880,274,606
407285,2,1,876,272,604
407285,4,3,4,2,2
407319,1,999,1288,929,359
407319,2,1,1288,929,359
407328,1,999,387,56,331
407328,2,1,387,56,331
407355,1,999,416,22,394
407355,2,1,416,22,394
407391,1,999,257,43,214
407391,2,1,257,43,214
407407,1,999,245,21,224
407407,2,1,245,21,224
407425,1,999,360,22,338
407425,2,1,360,22,338
407434,1,999,137,8,129
407434,2,1,137,8,129
407452,1,999,192,135,57
407452,2,1,192,135,57
407461,1,999,365,249,116
407461,2,1,365,249,116
407470,1,999,154,6,148
407470,2,1,154,6,148
407489,1,999,158,88,70
407489,2,1,158,88,70
407504,1,999,1360,420,940
407504,2,1,1360,420,940
407513,1,999,508,187,321
407513,2,1,508,187,321
407522,1,999,90,22,68
407522,2,1,90,22,68
407568,1,999,100,1,99
407568,2,1,100,1,99
407577,1,999,496,255,241
407577,2,1,496,255,241
407595,1,999,298,88,210
407595,2,1,298,88,210
407601,1,999,116,51,65
407601,2,1,116,51,65
407629,1,999,3030,1580,1450
407629,4,3,3030,1580,1450
407683,1,999,223,13,210
407683,2,1,223,13,210
407708,1,999,543,23,520
407708,2,1,543,23,520
407726,1,999,162,10,152
407726,2,1,162,10,152
407735,1,999,255,31,224
407735,2,1,255,31,224
407744,1,999,88,1,87
407744,2,1,88,1,87
407832,1,999,814,408,406
407832,2,1,814,408,406
408039,1,999,3074,783,2291
408039,2,1,3074,783,2291
408057,1,999,171,2,169
408057,2,1,171,2,169
408066,1,999,204,14,190
408066,2,1,204,14,190
408163,1,999,108,7,101
408163,2,1,108,7,101
408312,1,999,139,16,123
408312,2,1,139,16,123
408385,1,999,432,101,331
408385,2,1,432,101,331
408394,1,999,1291,916,375
408394,2,1,1291,916,375
408437,1,999,36,7,29
408437,2,1,36,7,29
408844,1,999,5453,1756,3697
408844,2,1,5453,1756,3697
408862,1,999,333,40,293
408862,2,1,333,40,293
409032,1,999,624,28,596
409032,2,1,624,28,596
409069,1,999,1448,1147,301
409069,2,1,1448,1147,301
409120,1,999,217,64,153
409120,2,1,217,64,153
409166,1,999,156,8,148
409166,2,1,156,8,148
409193,1,999,515,509,6
409193,2,1,515,509,6
409209,1,999,153,8,145
409209,2,1,153,8,145
409245,1,999,17,0,17
409245,2,1,17,0,17
409254,1,999,329,14,315
409254,4,3,329,14,315
409315,1,999,36951,15869,21082
409315,2,1,36951,15869,21082
409333,1,999,134,66,68
409333,2,1,134,66,68
409537,1,999,174,66,108
409537,2,1,174,66,108
409591,1,999,266,92,174
409591,2,1,266,92,174
409616,1,999,542,274,268
409616,4,3,542,274,268
409670,1,999,1468,277,1191
409670,2,1,1468,277,1191
409698,1,999,5216,2045,3171
409698,2,1,4770,1921,2849
409698,4,3,446,124,322
409829,1,999,1367,180,1187
409829,2,1,1367,180,1187
409838,1,999,1519,375,1144
409838,2,1,1519,375,1144
409874,1,999,2265,607,1658
409874,2,1,2265,607,1658
410034,1,999,131,103,28
410034,2,1,131,103,28
410070,1,999,1337,293,1044
410070,2,1,1337,293,1044
410256,1,999,139,30,109
410256,2,1,139,30,109
410283,1,999,2151,506,1645
410283,2,1,2151,506,1645
410496,1,999,528,130,398
410496,2,1,528,130,398
410502,1,999,2627,1136,1491
410502,2,1,2627,1136,1491
410520,1,999,628,29,599
410520,2,1,628,29,599
410539,1,999,511,122,389
410539,2,1,511,122,389
410788,1,999,890,454,436
410788,2,1,890,454,436
410797,1,999,238,158,80
410797,2,1,238,158,80
410964,1,999,61,0,61
410964,2,1,61,0,61
411055,1,999,733,353,380
411055,2,1,733,353,380
411374,1,999,1073,63,1010
411374,2,1,1073,63,1010
411684,1,999,233,80,153
411684,2,1,233,80,153
411754,1,999,44,16,28
411754,2,1,44,16,28
412003,1,999,110,38,72
412003,2,1,110,38,72
412173,1,999,844,76,768
412173,2,1,844,76,768
412535,1,999,39,4,35
412535,2,1,39,4,35
412544,1,999,218,63,155
412544,2,1,218,63,155
412599,1,999,1878,584,1294
412599,2,1,1878,584,1294
412650,1,999,293,273,20
412650,2,1,293,273,20
413176,1,999,44,15,29
413176,2,1,44,15,29
413185,1,999,41,32,9
413185,2,1,41,32,9
413343,1,999,34,2,32
413343,2,1,34,2,32
413413,1,999,60869,16710,44159
413413,2,1,15427,5645,9782
413413,4,3,45442,11065,34377
413617,1,999,933,286,647
413617,2,1,933,286,647
413626,1,999,382,139,243
413626,2,1,382,139,243
413635,1,999,1066,251,815
413635,2,1,1066,251,815
413644,1,999,107,29,78
413644,4,3,107,29,78
413680,1,999,693,663,30
413680,2,1,693,663,30
413778,1,999,491,45,446
413778,2,1,491,45,446
413802,1,999,942,536,406
413802,2,1,942,536,406
413820,1,999,40,1,39
413820,2,1,40,1,39
413839,1,999,1080,783,297
413839,2,1,1080,783,297
413848,1,999,747,560,187
413848,2,1,747,560,187
413857,1,999,1686,1282,404
413857,2,1,1686,1282,404
413866,1,999,1138,838,300
413866,2,1,1138,838,300
413884,1,999,1646,1147,499
413884,2,1,1646,1147,499
413918,1,999,24,13,11
413918,2,1,24,13,11
413945,1,999,142,35,107
413945,2,1,142,35,107
413972,1,999,148,9,139
413972,2,1,148,9,139
414054,1,999,90,2,88
414054,2,1,90,2,88
414063,1,999,376,14,362
414063,2,1,376,14,362
414124,1,999,283,188,95
414124,2,1,283,188,95
414160,1,999,3869,1055,2814
414160,2,1,3843,1049,2794
414160,4,3,26,6,20
414452,1,999,50,8,42
414452,2,1,50,8,42
414461,1,999,4793,4504,289
414461,2,1,4793,4504,289
414489,1,999,210,14,196
414489,2,1,210,14,196
414531,1,999,916,732,184
414531,2,1,916,732,184
414540,1,999,290,28,262
414540,2,1,290,28,262
414559,1,999,58,2,56
414559,2,1,58,2,56
414568,1,999,1702,1238,464
414568,2,1,1702,1238,464
414586,1,999,948,651,297
414586,2,1,948,651,297
414595,1,999,862,233,629
414595,2,1,222,62,160
414595,4,3,640,171,469
414708,1,999,9302,3350,5952
414708,2,1,8040,2907,5133
414708,4,3,1262,443,819
414823,1,999,2319,1026,1293
414823,2,1,2319,1026,1293
414841,1,999,716,588,128
414841,2,1,716,588,128
414850,1,999,800,69,731
414850,2,1,800,69,731
414869,1,999,219,8,211
414869,2,1,219,8,211
414878,1,999,645,184,461
414878,2,1,645,184,461
414911,1,999,3868,1539,2329
414911,2,1,3868,1539,2329
414939,1,999,265,47,218
414939,2,1,265,47,218
414966,1,999,186,95,91
414966,4,3,186,95,91
415039,1,999,209,8,201
415039,2,1,209,8,201
415057,1,999,276,273,3
415057,2,1,276,273,3
415729,1,999,61,16,45
415729,2,1,61,16,45
415774,1,999,1508,196,1312
415774,2,1,1508,196,1312
415987,1,999,1018,137,881
415987,2,1,1018,137,881
416458,1,999,719,198,521
416458,2,1,719,198,521
416670,1,999,110,3,107
416670,2,1,110,3,107
416801,1,999,361,131,230
416801,2,1,361,131,230
416962,1,999,3880,1380,2500
416962,2,1,2928,1091,1837
416962,4,3,952,289,663
416971,1,999,76,6,70
416971,2,1,76,6,70
416980,1,999,102,5,97
416980,2,1,102,5,97
417008,1,999,173,10,163
417008,2,1,173,10,163
417062,1,999,188,7,181
417062,2,1,188,7,181
417105,1,999,996,444,552
417105,2,1,996,444,552
417123,1,999,389,174,215
417123,2,1,389,174,215
417132,1,999,920,30,890
417132,2,1,920,30,890
417178,1,999,66,17,49
417178,2,1,66,17,49
417187,1,999,26,3,23
417187,2,1,26,3,23
417248,1,999,37,36,1
417248,2,1,37,36,1
417257,1,999,39,4,35
417257,2,1,39,4,35
417275,1,999,19,0,19
417275,2,1,19,0,19
417318,1,999,263,107,156
417318,2,1,263,107,156
417327,1,999,523,176,347
417327,2,1,523,176,347
417345,1,999,12,1,11
417345,4,3,12,1,11
417381,1,999,342,44,298
417381,2,1,342,44,298
417390,1,999,94,6,88
417390,2,1,94,6,88
417406,1,999,77,3,74
417406,2,1,77,3,74
417442,1,999,196,22,174
417442,2,1,196,22,174
417503,1,999,404,15,389
417503,2,1,404,15,389
417549,1,999,532,18,514
417549,2,1,532,18,514
417567,1,999,163,6,157
417567,2,1,163,6,157
417576,1,999,182,12,170
417576,2,1,182,12,170
417600,1,999,46,4,42
417600,2,1,46,4,42
417628,1,999,82,14,68
417628,2,1,82,14,68
417637,1,999,147,58,89
417637,2,1,147,58,89
417646,1,999,38,4,34
417646,2,1,38,4,34
417655,1,999,39,3,36
417655,2,1,39,3,36
417673,1,999,26,3,23
417673,2,1,26,3,23
417682,1,999,28,3,25
417682,2,1,28,3,25
417716,1,999,203,18,185
417716,2,1,203,18,185
417725,1,999,153,4,149
417725,2,1,153,4,149
417734,1,999,215,34,181
417734,2,1,215,34,181
417743,1,999,9,9,0
417743,2,1,9,9,0
417752,1,999,102,58,44
417752,2,1,102,58,44
417789,1,999,153,11,142
417789,2,1,153,11,142
417804,1,999,139,16,123
417804,2,1,139,16,123
417831,1,999,179,129,50
417831,2,1,179,129,50
417840,1,999,731,42,689
417840,2,1,731,42,689
417868,1,999,35,9,26
417868,2,1,35,9,26
417886,1,999,104,10,94
417886,2,1,104,10,94
417901,1,999,13,5,8
417901,2,1,13,5,8
417910,1,999,200,37,163
417910,2,1,200,37,163
417947,1,999,61,4,57
417947,2,1,61,4,57
417983,1,999,116,14,102
417983,2,1,116,14,102
417992,1,999,97,5,92
417992,2,1,97,5,92
418001,1,999,280,30,250
418001,2,1,280,30,250
418010,1,999,63,10,53
418010,2,1,63,10,53
418029,1,999,98,5,93
418029,2,1,98,5,93
418038,1,999,181,28,153
418038,2,1,181,28,153
418056,1,999,166,19,147
418056,2,1,166,19,147
418065,1,999,530,60,470
418065,2,1,530,60,470
418083,1,999,120,29,91
418083,2,1,120,29,91
418126,1,999,1024,314,710
418126,2,1,902,264,638
418126,4,3,122,50,72
418162,1,999,1044,658,386
418162,2,1,1044,658,386
418171,1,999,57,55,2
418171,2,1,57,55,2
418199,1,999,224,164,60
418199,2,1,224,164,60
418205,1,999,660,370,290
418205,2,1,660,370,290
418223,1,999,73,9,64
418223,2,1,73,9,64
418250,1,999,371,240,131
418250,2,1,371,240,131
418269,1,999,112,70,42
418269,2,1,112,70,42
418278,1,999,214,67,147
418278,2,1,214,67,147
418287,1,999,611,279,332
418287,2,1,611,279,332
418296,1,999,714,423,291
418296,2,1,714,423,291
418302,1,999,565,298,267
418302,2,1,565,298,267
418320,1,999,881,481,400
418320,2,1,881,481,400
418339,1,999,461,227,234
418339,2,1,461,227,234
418348,1,999,514,345,169
418348,2,1,514,345,169
418357,1,999,330,108,222
418357,2,1,330,108,222
418384,1,999,54,0,54
418384,2,1,54,0,54
418409,1,999,134,71,63
418409,2,1,134,71,63
418427,1,999,225,27,198
418427,2,1,225,27,198
418445,1,999,46,5,41
418445,2,1,46,5,41
418454,1,999,465,138,327
418454,2,1,465,138,327
418481,1,999,81,6,75
418481,2,1,81,6,75
418506,1,999,41,2,39
418506,2,1,41,2,39
418515,1,999,206,29,177
418515,2,1,206,29,177
418524,1,999,61,10,51
418524,2,1,61,10,51
418533,1,999,519,67,452
418533,2,1,519,67,452
418542,1,999,115,9,106
418542,2,1,115,9,106
418560,1,999,152,12,140
418560,2,1,152,12,140
418588,1,999,76,4,72
418588,2,1,76,4,72
418603,1,999,85,13,72
418603,2,1,85,13,72
418612,1,999,63,5,58
418612,2,1,63,5,58
418658,1,999,570,533,37
418658,2,1,570,533,37
418676,1,999,61,14,47
418676,2,1,61,14,47
418700,1,999,570,178,392
418700,2,1,570,178,392
418755,1,999,138,37,101
418755,2,1,138,37,101
418764,1,999,140,39,101
418764,2,1,140,39,101
418773,1,999,1356,452,904
418773,2,1,1356,452,904
418782,1,999,253,250,3
418782,2,1,253,250,3
418870,1,999,646,109,537
418870,2,1,646,109,537
418889,1,999,232,223,9
418889,2,1,232,223,9
418913,1,999,63,5,58
418913,2,1,63,5,58
418968,1,999,182,15,167
418968,2,1,182,15,167
419022,1,999,807,95,712
419022,2,1,807,95,712
419031,1,999,24,3,21
419031,2,1,24,3,21
419095,1,999,66,6,60
419095,2,1,66,6,60
419147,1,999,76,2,74
419147,2,1,76,2,74
419156,1,999,91,9,82
419156,2,1,91,9,82
419183,1,999,364,75,289
419183,2,1,364,75,289
419217,1,999,99,25,74
419217,2,1,99,25,74
419226,1,999,908,431,477
419226,2,1,908,431,477
419235,1,999,377,96,281
419235,2,1,377,96,281
419244,1,999,258,244,14
419244,2,1,258,244,14
419253,1,999,397,307,90
419253,2,1,397,307,90
419262,1,999,85,11,74
419262,2,1,85,11,74
419271,1,999,35,3,32
419271,2,1,35,3,32
419280,1,999,88,0,88
419280,2,1,88,0,88
419314,1,999,45,0,45
419314,2,1,45,0,45
419332,1,999,22,15,7
419332,2,1,22,15,7
419341,1,999,183,118,65
419341,2,1,183,118,65
419411,1,999,578,169,409
419411,2,1,578,169,409
419420,1,999,160,90,70
419420,2,1,160,90,70
419439,1,999,93,2,91
419439,2,1,93,2,91
419457,1,999,1690,368,1322
419457,2,1,168,39,129
419457,4,3,1522,329,1193
419484,1,999,26,5,21
419484,2,1,26,5,21
419509,1,999,5392,2010,3382
419509,2,1,4472,1672,2800
419509,4,3,920,338,582
419536,1,999,2817,1055,1762
419536,4,3,2817,1055,1762
419633,1,999,108,6,102
419633,2,1,108,6,102
419660,1,999,1354,311,1043
419660,2,1,1354,311,1043
419703,1,999,845,825,20
419703,2,1,845,825,20
419712,1,999,399,388,11
419712,2,1,399,388,11
419721,1,999,301,290,11
419721,2,1,301,290,11
420006,1,999,1415,346,1069
420006,2,1,1375,332,1043
420006,4,3,40,14,26
420024,1,999,392,70,322
420024,2,1,392,70,322
420042,1,999,1713,792,921
420042,2,1,1431,670,761
420042,4,3,282,122,160
420103,1,999,615,117,498
420103,2,1,615,117,498
420130,1,999,593,66,527
420130,2,1,593,66,527
420194,1,999,184,5,179
420194,2,1,184,5,179
420200,1,999,217,2,215
420200,2,1,217,2,215
420246,1,999,444,118,326
420246,4,3,444,118,326
420255,1,999,104,104,0
420255,2,1,104,104,0
420307,1,999,15413,2438,12975
420307,2,1,15112,2355,12757
420307,4,3,301,83,218
420316,1,999,1461,369,1092
420316,2,1,1461,369,1092
420325,1,999,81,81,0
420325,2,1,71,71,0
420325,4,3,10,10,0
420343,1,999,1296,1250,46
420343,2,1,1296,1250,46
420352,1,999,22,19,3
420352,2,1,22,19,3
420370,1,999,606,249,357
420370,2,1,606,249,357
420398,1,999,20855,9652,11203
420398,2,1,20855,9652,11203
420404,1,999,1176,966,210
420404,2,1,1176,966,210
420431,1,999,4470,1945,2525
420431,2,1,4470,1945,2525
420440,1,999,2239,914,1325
420440,2,1,2239,914,1325
420459,1,999,395,213,182
420459,2,1,395,213,182
420468,1,999,480,155,325
420468,2,1,480,155,325
420495,1,999,2665,424,2241
420495,2,1,2665,424,2241
420501,1,999,2288,357,1931
420501,2,1,2288,357,1931
420538,1,999,1589,615,974
420538,2,1,1589,615,974
420556,1,999,2079,784,1295
420556,2,1,2079,784,1295
420608,1,999,360,16,344
420608,2,1,360,16,344
420705,1,999,349,224,125
420705,4,3,349,224,125
420723,1,999,783,329,454
420723,2,1,783,329,454
420866,1,999,1081,300,781
420866,2,1,312,93,219
420866,4,3,769,207,562
420972,1,999,3112,1725,1387
420972,4,3,3112,1725,1387
420981,1,999,821,250,571
420981,2,1,821,250,571
421009,1,999,3119,893,2226
421009,2,1,2665,770,1895
421009,4,3,454,123,331
421018,1,999,3013,1026,1987
421018,2,1,2531,901,1630
421018,4,3,482,125,357
421513,1,999,603,131,472
421513,2,1,603,131,472
421540,1,999,276,163,113
421540,2,1,276,163,113
421559,1,999,143,56,87
421559,2,1,143,56,87
421586,1,999,281,127,154
421586,2,1,281,127,154
421610,1,999,54,0,54
421610,2,1,54,0,54
421665,1,999,33,2,31
421665,2,1,33,2,31
421708,1,999,1482,278,1204
421708,2,1,1482,278,1204
421717,1,999,38,6,32
421717,2,1,38,6,32
421771,1,999,85,7,78
421771,2,1,85,7,78
421832,1,999,1041,475,566
421832,2,1,1041,475,566
421841,1,999,330,136,194
421841,2,1,330,136,194
421878,1,999,260,30,230
421878,2,1,260,30,230
421896,1,999,359,130,229
421896,2,1,359,130,229
422020,1,999,157,152,5
422020,2,1,157,152,5
422190,1,999,133,15,118
422190,2,1,133,15,118
422695,1,999,308,50,258
422695,2,1,308,50,258
422835,1,999,751,95,656
422835,2,1,751,95,656
423120,1,999,1250,39,1211
423120,2,1,1250,39,1211
423397,1,999,59,59,0
423397,2,1,59,59,0
423412,1,999,206,186,20
423412,2,1,206,186,20
423476,1,999,434,169,265
423476,2,1,434,169,265
423582,1,999,406,81,325
423582,2,1,406,81,325
423643,1,999,2564,1354,1210
423643,4,3,2564,1354,1210
423652,1,999,778,311,467
423652,2,1,778,311,467
423670,1,999,430,66,364
423670,2,1,430,66,364
423980,1,999,4162,2122,2040
423980,2,1,4162,2122,2040
424424,1,999,350,105,245
424424,2,1,350,105,245
425250,1,999,162,24,138
425250,2,1,162,24,138
425393,1,999,19,4,15
425393,2,1,19,4,15
425870,1,999,20,3,17
425870,2,1,20,3,17
425889,1,999,1009,166,843
425889,2,1,1009,166,843
425986,1,999,468,52,416
425986,2,1,468,52,416
426314,1,999,24928,21560,3368
426314,2,1,17465,15290,2175
426314,4,3,7463,6270,1193
427025,1,999,2335,831,1504
427025,2,1,2335,831,1504
427308,1,999,332,144,188
427308,2,1,332,144,188
427335,1,999,89,3,86
427335,2,1,89,3,86
427663,1,999,912,716,196
427663,2,1,912,716,196
427894,1,999,330,276,54
427894,2,1,330,276,54
427919,1,999,312,94,218
427919,2,1,312,94,218
427973,1,999,618,561,57
427973,2,1,618,561,57
427982,1,999,575,101,474
427982,2,1,575,101,474
427991,1,999,1304,786,518
427991,2,1,1304,786,518
428000,1,999,346,166,180
428000,2,1,346,166,180
428019,1,999,332,179,153
428019,2,1,332,179,153
428037,1,999,50,50,0
428037,2,1,50,50,0
428055,1,999,496,70,426
428055,2,1,496,70,426
428073,1,999,35,2,33
428073,2,1,35,2,33
428125,1,999,136,102,34
428125,2,1,136,102,34
428143,1,999,257,26,231
428143,2,1,257,26,231
428170,1,999,2885,772,2113
428170,2,1,2885,772,2113
428259,1,999,760,199,561
428259,2,1,620,160,460
428259,4,3,140,39,101
428268,1,999,973,244,729
428268,2,1,155,36,119
428268,4,3,818,208,610
428286,1,999,1847,944,903
428286,2,1,1847,944,903
428295,1,999,276,261,15
428295,2,1,276,261,15
428329,1,999,202,33,169
428329,2,1,202,33,169
428338,1,999,216,111,105
428338,4,3,216,111,105
428392,1,999,2686,1169,1517
428392,2,1,2686,1169,1517
428444,1,999,1756,869,887
428444,2,1,1756,869,887
429012,1,999,115,105,10
429012,2,1,115,105,10
429085,1,999,165,46,119
429085,4,3,165,46,119
429094,1,999,249,61,188
429094,4,3,249,61,188
429100,1,999,175,7,168
429100,2,1,175,7,168
429128,1,999,959,59,900
429128,2,1,959,59,900
429599,1,999,1477,1087,390
429599,2,1,1477,1087,390
430050,1,999,589,110,479
430050,2,1,589,110,479
430087,1,999,1890,1047,843
430087,2,1,1529,810,719
430087,4,3,361,237,124
430096,1,999,1209,332,877
430096,2,1,1209,332,877
430148,1,999,1917,696,1221
430148,2,1,1917,696,1221
430157,1,999,452,443,9
430157,2,1,452,443,9
430166,1,999,397,392,5
430166,2,1,397,392,5
430175,1,999,1448,174,1274
430175,2,1,1448,174,1274
430184,1,999,7801,2610,5191
430184,2,1,5912,1995,3917
430184,4,3,1889,615,1274
430218,1,999,250,55,195
430218,2,1,250,55,195
430227,1,999,249,36,213
430227,2,1,249,36,213
430245,1,999,1151,164,987
430245,2,1,1151,164,987
430254,1,999,361,56,305
430254,2,1,361,56,305
430263,1,999,1470,1139,331
430263,2,1,1470,1139,331
430306,1,999,99,15,84
430306,2,1,99,15,84
430342,1,999,387,177,210
430342,2,1,387,177,210
430351,1,999,799,630,169
430351,2,1,799,630,169
430360,1,999,532,423,109
430360,2,1,532,423,109
430379,1,999,1271,913,358
430379,2,1,1271,913,358
430388,1,999,861,676,185
430388,2,1,861,676,185
430403,1,999,407,47,360
430403,2,1,407,47,360
430421,1,999,928,112,816
430421,2,1,928,112,816
430485,1,999,118,50,68
430485,2,1,118,50,68
430500,1,999,9,8,1
430500,2,1,9,8,1
430564,1,999,228,38,190
430564,2,1,228,38,190
430582,1,999,405,125,280
430582,2,1,405,125,280
430591,1,999,324,89,235
430591,4,3,324,89,235
430643,1,999,26,19,7
430643,2,1,26,19,7
430670,1,999,314,153,161
430670,4,3,314,153,161
430704,1,999,116,41,75
430704,2,1,9,2,7
430704,4,3,107,39,68
430795,1,999,344,110,234
430795,2,1,344,110,234
430810,1,999,516,172,344
430810,2,1,509,168,341
430810,4,3,7,4,3
430847,1,999,91,11,80
430847,2,1,91,11,80
430883,1,999,64,3,61
430883,2,1,64,3,61
430908,1,999,107,18,89
430908,2,1,107,18,89
430935,1,999,894,764,130
430935,2,1,894,764,130
430971,1,999,128,16,112
430971,2,1,128,16,112
430980,1,999,452,65,387
430980,2,1,452,65,387
430999,1,999,211,6,205
430999,2,1,211,6,205
431017,1,999,112,44,68
431017,2,1,112,44,68
431026,1,999,626,262,364
431026,2,1,626,262,364
431071,1,999,172,35,137
431071,2,1,172,35,137
431099,1,999,293,7,286
431099,2,1,293,7,286
431105,1,999,186,21,165
431105,2,1,186,21,165
431123,1,999,627,619,8
431123,2,1,627,619,8
431141,1,999,4021,1787,2234
431141,2,1,4021,1787,2234
431169,1,999,153,46,107
431169,2,1,153,46,107
431187,1,999,38,36,2
431187,2,1,38,36,2
431196,1,999,265,25,240
431196,2,1,265,25,240
431202,1,999,47,5,42
431202,2,1,47,5,42
431248,1,999,18,1,17
431248,2,1,1,0,1
431248,4,3,17,1,16
431266,1,999,117,5,112
431266,2,1,117,5,112
431275,1,999,142,14,128
431275,2,1,142,14,128
431284,1,999,77,9,68
431284,2,1,77,9,68
431309,1,999,700,276,424
431309,2,1,700,276,424
431558,1,999,488,156,332
431558,2,1,488,156,332
431594,1,999,22,0,22
431594,4,3,22,0,22
431600,1,999,110,23,87
431600,2,1,110,23,87
431637,1,999,1260,419,841
431637,2,1,1260,419,841
431691,1,999,35,7,28
431691,2,1,35,7,28
431707,1,999,38,2,36
431707,2,1,38,2,36
431716,1,999,494,287,207
431716,2,1,494,287,207
431770,1,999,67,11,56
431770,2,1,67,11,56
431877,1,999,67,10,57
431877,2,1,67,10,57
431886,1,999,1446,285,1161
431886,2,1,1446,285,1161
431929,1,999,336,83,253
431929,2,1,336,83,253
431956,1,999,121,24,97
431956,2,1,121,24,97
431965,1,999,136,23,113
431965,2,1,136,23,113
431983,1,999,100,100,0
431983,2,1,100,100,0
432074,1,999,233,98,135
432074,2,1,233,98,135
432117,1,999,225,9,216
432117,2,1,225,9,216
432199,1,999,2666,1913,753
432199,2,1,2666,1913,753
432214,1,999,865,462,403
432214,2,1,865,462,403
432223,1,999,1134,517,617
432223,2,1,943,426,517
432223,4,3,191,91,100
432232,1,999,2098,814,1284
432232,2,1,1710,657,1053
432232,4,3,388,157,231
432241,1,999,1581,683,898
432241,2,1,1347,570,777
432241,4,3,234,113,121
432269,1,999,270,216,54
432269,2,1,270,216,54
432302,1,999,860,247,613
432302,2,1,860,247,613
432348,1,999,313,205,108
432348,4,3,313,205,108
432357,1,999,346,66,280
432357,4,3,346,66,280
432384,1,999,907,299,608
432384,2,1,907,299,608
432524,1,999,241,107,134
432524,2,1,241,107,134
432533,1,999,2846,1727,1119
432533,2,1,2846,1727,1119
433004,1,999,212,63,149
433004,2,1,185,54,131
433004,4,3,27,9,18
433013,1,999,1110,365,745
433013,2,1,1110,365,745
433040,1,999,46,9,37
433040,2,1,46,9,37
433068,1,999,523,238,285
433068,2,1,523,238,285
433101,1,999,1694,264,1430
433101,2,1,1694,264,1430
433138,1,999,640,265,375
433138,2,1,640,265,375
433165,1,999,9,1,8
433165,2,1,9,1,8
433174,1,999,585,85,500
433174,2,1,585,85,500
433217,1,999,7,1,6
433217,4,3,7,1,6
433387,1,999,33950,13405,20545
433387,2,1,25494,10342,15152
433387,4,3,8456,3063,5393
433420,1,999,774,124,650
433420,2,1,774,124,650
433466,1,999,1742,352,1390
433466,2,1,1742,352,1390
433536,1,999,643,100,543
433536,2,1,643,100,543
433563,1,999,937,377,560
433563,2,1,937,377,560
433660,1,999,12958,5566,7392
433660,2,1,11248,5022,6226
433660,4,3,1710,544,1166
433970,1,999,730,83,647
433970,2,1,730,83,647
434016,1,999,192,59,133
434016,2,1,192,59,133
434034,1,999,1320,1079,241
434034,2,1,1320,1079,241
434052,1,999,1251,1027,224
434052,2,1,1251,1027,224
434061,1,999,6320,2841,3479
434061,2,1,6320,2841,3479
434122,1,999,18,17,1
434122,2,1,18,17,1
434140,1,999,1770,498,1272
434140,2,1,1770,498,1272
434159,1,999,918,503,415
434159,2,1,918,503,415
434274,1,999,157,19,138
434274,2,1,157,19,138
434283,1,999,84,15,69
434283,2,1,84,15,69
434308,1,999,1063,284,779
434308,2,1,1063,284,779
434317,1,999,2702,604,2098
434317,2,1,2702,604,2098
434326,1,999,74,2,72
434326,2,1,74,2,72
434344,1,999,76,4,72
434344,2,1,76,4,72
434362,1,999,46,46,0
434362,2,1,46,46,0
434380,1,999,92,11,81
434380,2,1,92,11,81
434414,1,999,692,278,414
434414,2,1,692,278,414
434432,1,999,75,26,49
434432,2,1,75,26,49
434441,1,999,154,49,105
434441,4,3,154,49,105
434469,1,999,160,35,125
434469,2,1,160,35,125
434496,1,999,84,11,73
434496,2,1,84,11,73
434502,1,999,210,30,180
434502,2,1,210,30,180
434520,1,999,1122,291,831
434520,2,1,1122,291,831
434539,1,999,615,297,318
434539,2,1,615,297,318
434548,1,999,1258,1008,250
434548,2,1,1258,1008,250
434557,1,999,817,625,192
434557,2,1,817,625,192
434566,1,999,836,739,97
434566,2,1,836,739,97
434575,1,999,642,557,85
434575,2,1,642,557,85
434584,1,999,797,385,412
434584,2,1,797,385,412
434672,1,999,35498,13625,21873
434672,2,1,35498,13625,21873
434690,1,999,549,542,7
434690,2,1,549,542,7
434715,1,999,1888,982,906
434715,4,3,1888,982,906
434751,1,999,138,51,87
434751,2,1,138,51,87
434812,1,999,557,40,517
434812,2,1,557,40,517
434821,1,999,590,58,532
434821,2,1,590,58,532
434830,1,999,316,19,297
434830,2,1,316,19,297
434900,1,999,1482,752,730
434900,2,1,1482,752,730
434937,1,999,55,55,0
434937,2,1,55,55,0
434946,1,999,3037,965,2072
434946,2,1,2376,749,1627
434946,4,3,661,216,445
434955,1,999,1817,792,1025
434955,2,1,1493,671,822
434955,4,3,324,121,203
434964,1,999,1388,633,755
434964,2,1,1090,489,601
434964,4,3,298,144,154
434973,1,999,1019,509,510
434973,2,1,862,426,436
434973,4,3,157,83,74
434982,1,999,1107,331,776
434982,2,1,1002,295,707
434982,4,3,105,36,69
434991,1,999,1017,371,646
434991,2,1,929,334,595
434991,4,3,88,37,51
435000,1,999,992,400,592
435000,2,1,99,21,78
435000,4,3,893,379,514
436003,1,999,236,18,218
436003,2,1,236,18,218
436012,1,999,945,66,879
436012,2,1,945,66,879
436021,1,999,46,7,39
436021,4,3,46,7,39
436030,1,999,64,3,61
436030,2,1,64,3,61
436067,1,999,66,4,62
436067,2,1,66,4,62
436094,1,999,1292,362,930
436094,2,1,267,76,191
436094,4,3,1025,286,739
436100,1,999,47,0,47
436100,2,1,47,0,47
436182,1,999,504,131,373
436182,2,1,504,131,373
436191,1,999,1217,736,481
436191,2,1,1217,736,481
436225,1,999,854,206,648
436225,2,1,854,206,648
436261,1,999,173,42,131
436261,4,3,173,42,131
436270,1,999,389,95,294
436270,2,1,389,95,294
436289,1,999,108,6,102
436289,2,1,108,6,102
436304,1,999,3883,1758,2125
436304,2,1,3883,1758,2125
436429,1,999,3280,2800,480
436429,2,1,3280,2800,480
436438,1,999,1368,474,894
436438,2,1,332,146,186
436438,4,3,1036,328,708
436465,1,999,1427,486,941
436465,2,1,1427,486,941
436483,1,999,841,204,637
436483,2,1,841,204,637
436526,1,999,303,283,20
436526,2,1,303,283,20
436553,1,999,521,148,373
436553,2,1,521,148,373
436562,1,999,287,25,262
436562,2,1,287,25,262
436599,1,999,92,50,42
436599,2,1,92,50,42
436614,1,999,101,56,45
436614,2,1,77,37,40
436614,4,3,24,19,5
436632,1,999,300,33,267
436632,2,1,300,33,267
436641,1,999,205,18,187
436641,2,1,205,18,187
436650,1,999,555,47,508
436650,2,1,555,47,508
436702,1,999,935,159,776
436702,2,1,935,159,776
436775,1,999,354,47,307
436775,2,1,354,47,307
436784,1,999,1356,574,782
436784,2,1,1356,574,782
436818,1,999,3158,1506,1652
436818,2,1,3158,1506,1652
436827,1,999,864,453,411
436827,2,1,864,453,411
436836,1,999,1725,806,919
436836,2,1,1725,806,919
436854,1,999,110,9,101
436854,2,1,110,9,101
437042,1,999,1446,1057,389
437042,2,1,1446,1057,389
437051,1,999,1435,1102,333
437051,2,1,1435,1102,333
437060,1,999,618,312,306
437060,2,1,618,312,306
437097,1,999,3115,2217,898
437097,2,1,2222,1607,615
437097,4,3,893,610,283
437103,1,999,11729,4862,6867
437103,2,1,11729,4862,6867
437219,1,999,1100,869,231
437219,2,1,1100,869,231
437237,1,999,60,55,5
437237,2,1,60,55,5
437316,1,999,424,59,365
437316,2,1,424,59,365
437325,1,999,817,226,591
437325,2,1,720,186,534
437325,4,3,97,40,57
437343,1,999,777,407,370
437343,4,3,777,407,370
437361,1,999,325,140,185
437361,4,3,325,140,185
437501,1,999,267,74,193
437501,2,1,267,74,193
437529,1,999,738,331,407
437529,2,1,738,331,407
437556,1,999,918,358,560
437556,2,1,918,358,560
437565,1,999,280,16,264
437565,2,1,280,16,264
437583,1,999,232,13,219
437583,2,1,232,13,219
437608,1,999,238,121,117
437608,2,1,238,121,117
437635,1,999,169,26,143
437635,2,1,169,26,143
437653,1,999,317,143,174
437653,2,1,317,143,174
437662,1,999,5859,2384,3475
437662,2,1,5859,2384,3475
437705,1,999,14,0,14
437705,2,1,14,0,14
437723,1,999,510,218,292
437723,2,1,510,218,292
437732,1,999,1731,399,1332
437732,2,1,1731,399,1332
437750,1,999,810,778,32
437750,2,1,810,778,32
437769,1,999,809,86,723
437769,2,1,809,86,723
437778,1,999,569,62,507
437778,2,1,569,62,507
437848,1,999,1623,883,740
437848,2,1,1623,883,740
437857,1,999,249,2,247
437857,2,1,249,2,247
437884,1,999,162,119,43
437884,2,1,162,119,43
437927,1,999,738,133,605
437927,2,1,738,133,605
437936,1,999,1423,297,1126
437936,2,1,1423,297,1126
438036,1,999,196,133,63
438036,2,1,196,133,63
438151,1,999,5409,1887,3522
438151,2,1,5227,1814,3413
438151,4,3,182,73,109
438179,1,999,1683,511,1172
438179,2,1,1683,511,1172
438197,1,999,1399,114,1285
438197,2,1,1399,114,1285
438212,1,999,9387,2478,6909
438212,2,1,9387,2478,6909
438258,1,999,821,146,675
438258,2,1,821,146,675
438267,1,999,642,229,413
438267,2,1,642,229,413
438285,1,999,1043,191,852
438285,2,1,1043,191,852
438294,1,999,464,95,369
438294,2,1,464,95,369
438337,1,999,518,172,346
438337,2,1,518,172,346
438382,1,999,1012,478,534
438382,2,1,741,391,350
438382,4,3,271,87,184
438416,1,999,1120,435,685
438416,2,1,1078,423,655
438416,4,3,42,12,30
438498,1,999,2872,1283,1589
438498,2,1,1890,686,1204
438498,4,3,982,597,385
438504,1,999,3914,3843,71
438504,2,1,3914,3843,71
438586,1,999,3109,1382,1727
438586,2,1,2842,1285,1557
438586,4,3,267,97,170
438601,1,999,1211,583,628
438601,2,1,1032,511,521
438601,4,3,179,72,107
438610,1,999,1309,481,828
438610,2,1,1202,440,762
438610,4,3,107,41,66
438629,1,999,218,98,120
438629,2,1,188,89,99
438629,4,3,30,9,21
438638,1,999,2240,867,1373
438638,2,1,2240,867,1373
438647,1,999,1659,381,1278
438647,2,1,1659,381,1278
438656,1,999,1421,125,1296
438656,2,1,1421,125,1296
438674,1,999,206,49,157
438674,2,1,206,49,157
438708,1,999,862,269,593
438708,2,1,862,269,593
438735,1,999,420,383,37
438735,2,1,420,383,37
438805,1,999,1519,546,973
438805,2,1,1519,546,973
438869,1,999,727,117,610
438869,2,1,727,117,610
438887,1,999,321,49,272
438887,2,1,321,49,272
438902,1,999,1894,346,1548
438902,2,1,1816,329,1487
438902,4,3,78,17,61
438966,1,999,934,160,774
438966,2,1,934,160,774
438984,1,999,216,122,94
438984,2,1,216,122,94
439020,1,999,184,56,128
439020,4,3,184,56,128
439039,1,999,698,195,503
439039,2,1,698,195,503
439057,1,999,811,292,519
439057,2,1,197,85,112
439057,4,3,614,207,407
439118,1,999,1241,231,1010
439118,2,1,1241,231,1010
439127,1,999,603,102,501
439127,2,1,603,102,501
439136,1,999,890,802,88
439136,2,1,890,802,88
439145,1,999,5638,2249,3389
439145,2,1,5638,2249,3389
439163,1,999,6118,3764,2354
439163,2,1,6118,3764,2354
439190,1,999,4298,2235,2063
439190,2,1,4298,2235,2063
439279,1,999,1265,455,810
439279,2,1,1190,425,765
439279,4,3,75,30,45
439288,1,999,1821,793,1028
439288,2,1,1821,793,1028
439297,1,999,739,254,485
439297,2,1,646,224,422
439297,4,3,93,30,63
439303,1,999,97,16,81
439303,2,1,97,16,81
439312,1,999,69,15,54
439312,2,1,69,15,54
439330,1,999,171,88,83
439330,2,1,171,88,83
439367,1,999,340,95,245
439367,2,1,340,95,245
439394,1,999,141,39,102
439394,4,3,141,39,102
439400,1,999,153,92,61
439400,2,1,153,92,61
439437,1,999,743,114,629
439437,2,1,743,114,629
439446,1,999,169,42,127
439446,2,1,66,20,46
439446,4,3,103,22,81
439455,1,999,519,49,470
439455,2,1,519,49,470
439473,1,999,290,75,215
439473,2,1,290,75,215
439482,1,999,444,40,404
439482,2,1,444,40,404
439491,1,999,171,30,141
439491,2,1,171,30,141
439507,1,999,513,115,398
439507,2,1,513,115,398
439525,1,999,874,181,693
439525,2,1,874,181,693
439570,1,999,1398,132,1266
439570,2,1,1398,132,1266
439589,1,999,275,18,257
439589,2,1,275,18,257
439604,1,999,35,0,35
439604,2,1,35,0,35
439613,1,999,327,183,144
439613,2,1,327,183,144
439622,1,999,313,51,262
439622,2,1,313,51,262
439631,1,999,49,3,46
439631,2,1,49,3,46
439668,1,999,206,186,20
439668,2,1,206,186,20
439686,1,999,442,53,389
439686,2,1,442,53,389
439695,1,999,85,4,81
439695,2,1,85,4,81
439701,1,999,614,377,237
439701,2,1,308,192,116
439701,4,3,306,185,121
439729,1,999,51,4,47
439729,2,1,51,4,47
439738,1,999,1249,164,1085
439738,2,1,1249,164,1085
439747,1,999,215,36,179
439747,2,1,215,36,179
439756,1,999,23,22,1
439756,2,1,23,22,1
439774,1,999,64,22,42
439774,2,1,64,22,42
439783,1,999,176,83,93
439783,2,1,81,42,39
439783,4,3,95,41,54
439792,1,999,826,128,698
439792,2,1,826,128,698
439817,1,999,156,104,52
439817,4,3,156,104,52
439826,1,999,950,296,654
439826,2,1,950,296,654
439844,1,999,98,0,98
439844,2,1,98,0,98
439862,1,999,104,56,48
439862,2,1,97,51,46
439862,4,3,7,5,2
439871,1,999,189,41,148
439871,2,1,189,41,148
439899,1,999,118,69,49
439899,2,1,118,69,49
439905,1,999,380,69,311
439905,2,1,380,69,311
439914,1,999,50,17,33
439914,4,3,50,17,33
439932,1,999,34,3,31
439932,2,1,34,3,31
439969,1,999,286,99,187
439969,2,1,122,46,76
439969,4,3,164,53,111
439978,1,999,139,3,136
439978,2,1,139,3,136
439996,1,999,136,31,105
439996,2,1,136,31,105
440004,1,999,56,15,41
440004,4,3,56,15,41
440031,1,999,138,84,54
440031,4,3,138,84,54
440059,1,999,880,813,67
440059,2,1,880,813,67
440077,1,999,68,0,68
440077,2,1,68,0,68
440086,1,999,708,133,575
440086,2,1,708,133,575
440101,1,999,308,20,288
440101,2,1,308,20,288
440110,1,999,927,189,738
440110,2,1,927,189,738
440129,1,999,889,167,722
440129,2,1,889,167,722
440147,1,999,1095,486,609
440147,2,1,1095,486,609
440165,1,999,1352,975,377
440165,2,1,1352,975,377
440174,1,999,109,11,98
440174,2,1,109,11,98
440217,1,999,35,1,34
440217,2,1,35,1,34
440226,1,999,195,6,189
440226,2,1,195,6,189
440244,1,999,9373,3915,5458
440244,2,1,9373,3915,5458
440262,1,999,741,720,21
440262,2,1,741,720,21
440271,1,999,794,111,683
440271,2,1,794,111,683
440299,1,999,1651,583,1068
440299,2,1,1651,583,1068
440305,1,999,5505,2268,3237
440305,2,1,5505,2268,3237
440323,1,999,844,152,692
440323,2,1,844,152,692
440332,1,999,567,188,379
440332,2,1,567,188,379
440341,1,999,3035,1658,1377
440341,2,1,3035,1658,1377
440369,1,999,1893,238,1655
440369,2,1,1893,238,1655
440378,1,999,374,57,317
440378,2,1,374,57,317
440396,1,999,171,86,85
440396,2,1,151,74,77
440396,4,3,20,12,8
440402,1,999,5778,2473,3305
440402,2,1,5778,2473,3305
440411,1,999,221,90,131
440411,2,1,22,16,6
440411,4,3,199,74,125
440420,1,999,400,230,170
440420,2,1,302,174,128
440420,4,3,98,56,42
440439,1,999,2005,853,1152
440439,2,1,1614,669,945
440439,4,3,391,184,207
440448,1,999,4116,1491,2625
440448,2,1,3517,1243,2274
440448,4,3,599,248,351
440457,1,999,842,347,495
440457,2,1,783,319,464
440457,4,3,59,28,31
440466,1,999,871,384,487
440466,2,1,773,330,443
440466,4,3,98,54,44
440484,1,999,1904,1011,893
440484,2,1,1904,1011,893
440536,1,999,1830,1229,601
440536,2,1,1830,1229,601
440545,1,999,1298,893,405
440545,2,1,1298,893,405
440572,1,999,1642,766,876
440572,4,3,1642,766,876
440581,1,999,1748,893,855
440581,4,3,1748,893,855
440590,1,999,2284,1453,831
440590,2,1,2284,1453,831
440624,1,999,3669,1294,2375
440624,2,1,3669,1294,2375
440642,1,999,1306,1033,273
440642,2,1,1306,1033,273
440651,1,999,2074,509,1565
440651,2,1,2074,509,1565
440721,1,999,821,216,605
440721,2,1,821,216,605
440730,1,999,1215,395,820
440730,2,1,1215,395,820
440749,1,999,607,406,201
440749,2,1,607,406,201
440758,1,999,432,128,304
440758,2,1,432,128,304
440767,1,999,1272,316,956
440767,2,1,1272,316,956
440776,1,999,71,22,49
440776,2,1,71,22,49
440794,1,999,391,175,216
440794,2,1,391,175,216
440800,1,999,90,46,44
440800,2,1,90,46,44
440819,1,999,195,96,99
440819,2,1,195,96,99
440828,1,999,941,337,604
440828,2,1,786,300,486
440828,4,3,155,37,118
440846,1,999,492,56,436
440846,2,1,492,56,436
440855,1,999,402,27,375
440855,2,1,402,27,375
440873,1,999,1177,637,540
440873,2,1,1177,637,540
440882,1,999,503,354,149
440882,2,1,503,354,149
440891,1,999,607,328,279
440891,2,1,607,328,279
440907,1,999,969,125,844
440907,2,1,969,125,844
440916,1,999,759,340,419
440916,4,3,759,340,419
440925,1,999,1529,632,897
440925,2,1,1529,632,897
440952,1,999,924,205,719
440952,2,1,924,205,719
440970,1,999,296,54,242
440970,2,1,296,54,242
440989,1,999,2138,1409,729
440989,2,1,2138,1409,729
441016,1,999,1697,209,1488
441016,2,1,1697,209,1488
441025,1,999,1334,193,1141
441025,2,1,1334,193,1141
441052,1,999,3514,848,2666
441052,2,1,3514,848,2666
441070,1,999,187,66,121
441070,2,1,187,66,121
441089,1,999,2872,2779,93
441089,2,1,2872,2779,93
441104,1,999,345,68,277
441104,4,3,345,68,277
441131,1,999,270,101,169
441131,4,3,270,101,169
441159,1,999,439,234,205
441159,4,3,439,234,205
441168,1,999,204,18,186
441168,2,1,204,18,186
441186,1,999,1007,295,712
441186,2,1,826,244,582
441186,4,3,181,51,130
441195,1,999,75,54,21
441195,2,1,75,54,21
441201,1,999,250,48,202
441201,2,1,250,48,202
441210,1,999,509,148,361
441210,2,1,509,148,361
441229,1,999,1202,540,662
441229,2,1,1202,540,662
441238,1,999,86,43,43
441238,4,3,86,43,43
441256,1,999,118,10,108
441256,2,1,118,10,108
441274,1,999,215,16,199
441274,2,1,215,16,199
441308,1,999,3363,892,2471
441308,4,3,3363,892,2471
441317,1,999,53,17,36
441317,2,1,53,17,36
441335,1,999,42,2,40
441335,2,1,42,2,40
441353,1,999,15,0,15
441353,2,1,15,0,15
441362,1,999,1183,113,1070
441362,2,1,1183,113,1070
441371,1,999,1215,307,908
441371,2,1,1215,307,908
441380,1,999,351,240,111
441380,2,1,351,240,111
441399,1,999,436,142,294
441399,2,1,436,142,294
441405,1,999,151,42,109
441405,2,1,151,42,109
441414,1,999,880,345,535
441414,2,1,880,345,535
441423,1,999,579,114,465
441423,2,1,579,114,465
441432,1,999,599,156,443
441432,2,1,599,156,443
441441,1,999,422,66,356
441441,2,1,422,66,356
441478,1,999,411,296,115
441478,2,1,67,47,20
441478,4,3,344,249,95
441487,1,999,288,42,246
441487,2,1,288,42,246
441496,1,999,376,346,30
441496,2,1,376,346,30
441502,1,999,541,43,498
441502,2,1,541,43,498
441511,1,999,551,230,321
441511,2,1,408,181,227
441511,4,3,143,49,94
441548,1,999,140,25,115
441548,2,1,140,25,115
441575,1,999,1321,246,1075
441575,2,1,1321,246,1075
441584,1,999,1300,328,972
441584,2,1,1300,328,972
441593,1,999,53,7,46
441593,2,1,53,7,46
441609,1,999,9,9,0
441609,2,1,9,9,0
441618,1,999,108,10,98
441618,2,1,108,10,98
441627,1,999,32,13,19
441627,2,1,32,13,19
441636,1,999,376,78,298
441636,2,1,376,78,298
441645,1,999,218,12,206
441645,2,1,218,12,206
441663,1,999,402,35,367
441663,2,1,402,35,367
441672,1,999,25,2,23
441672,2,1,25,2,23
441681,1,999,97,14,83
441681,2,1,97,14,83
441690,1,999,362,217,145
441690,2,1,362,217,145
441706,1,999,207,93,114
441706,2,1,207,93,114
441733,1,999,24,5,19
441733,2,1,24,5,19
441742,1,999,766,100,666
441742,2,1,766,100,666
441751,1,999,32,3,29
441751,2,1,32,3,29
441760,1,999,4120,2222,1898
441760,2,1,4120,2222,1898
441779,1,999,114,2,112
441779,2,1,114,2,112
441788,1,999,734,693,41
441788,2,1,734,693,41
441797,1,999,41,1,40
441797,2,1,41,1,40
441830,1,999,99,21,78
441830,2,1,99,21,78
441858,1,999,192,8,184
441858,2,1,192,8,184
441876,1,999,354,23,331
441876,2,1,354,23,331
441894,1,999,142,95,47
441894,2,1,142,95,47
441900,1,999,4415,1126,3289
441900,2,1,4415,1126,3289
441919,1,999,1374,282,1092
441919,2,1,1374,282,1092
441928,1,999,1446,243,1203
441928,2,1,1446,243,1203
441937,1,999,4229,1567,2662
441937,2,1,3963,1494,2469
441937,4,3,266,73,193
441955,1,999,1631,1314,317
441955,2,1,1631,1314,317
441964,1,999,1118,915,203
441964,2,1,1118,915,203
441973,1,999,2801,1454,1347
441973,2,1,2801,1454,1347
441982,1,999,365,202,163
441982,2,1,365,202,163
442000,1,999,1263,1106,157
442000,2,1,1263,1106,157
442037,1,999,881,260,621
442037,2,1,881,260,621
442046,1,999,1842,343,1499
442046,2,1,1842,343,1499
442064,1,999,67,18,49
442064,4,3,67,18,49
442073,1,999,1791,448,1343
442073,2,1,1791,448,1343
442134,1,999,1307,152,1155
442134,2,1,1307,152,1155
442143,1,999,1207,423,784
442143,2,1,1097,377,720
442143,4,3,110,46,64
442152,1,999,2587,904,1683
442152,2,1,2173,747,1426
442152,4,3,414,157,257
442161,1,999,1957,821,1136
442161,2,1,1762,743,1019
442161,4,3,195,78,117
442170,1,999,2341,848,1493
442170,2,1,2159,758,1401
442170,4,3,182,90,92
442189,1,999,1099,640,459
442189,2,1,870,500,370
442189,4,3,229,140,89
442204,1,999,133,32,101
442204,2,1,133,32,101
442213,1,999,53,1,52
442213,2,1,53,1,52
442222,1,999,938,221,717
442222,2,1,313,94,219
442222,4,3,625,127,498
442231,1,999,2379,1276,1103
442231,2,1,2379,1276,1103
442240,1,999,461,29,432
442240,2,1,461,29,432
442295,1,999,473,262,211
442295,4,3,473,262,211
442310,1,999,1349,303,1046
442310,2,1,1349,303,1046
442329,1,999,1275,1222,53
442329,2,1,1275,1222,53
442338,1,999,1250,856,394
442338,2,1,1250,856,394
442347,1,999,1075,857,218
442347,2,1,1075,857,218
442356,1,999,1245,187,1058
442356,2,1,1245,187,1058
442365,1,999,1172,579,593
442365,2,1,1172,579,593
442383,1,999,514,102,412
442383,2,1,514,102,412
442392,1,999,145,59,86
442392,4,3,145,59,86
442408,1,999,548,538,10
442408,2,1,548,538,10
442426,1,999,316,36,280
442426,2,1,316,36,280
442435,1,999,44,16,28
442435,2,1,44,16,28
442444,1,999,1670,633,1037
442444,2,1,1670,633,1037
442462,1,999,766,259,507
442462,2,1,766,259,507
442499,1,999,599,306,293
442499,2,1,599,306,293
442505,1,999,928,452,476
442505,2,1,928,452,476
442523,1,999,49,20,29
442523,2,1,49,20,29
442569,1,999,15601,11410,4191
442569,2,1,13761,10218,3543
442569,4,3,1840,1192,648
442578,1,999,679,169,510
442578,2,1,679,169,510
442602,1,999,1545,290,1255
442602,2,1,1545,290,1255
442611,1,999,2562,2483,79
442611,2,1,2562,2483,79
442620,1,999,754,139,615
442620,2,1,754,139,615
442639,1,999,65,37,28
442639,2,1,65,37,28
442648,1,999,1143,247,896
442648,2,1,1143,247,896
442657,1,999,401,49,352
442657,2,1,401,49,352
442684,1,999,269,18,251
442684,2,1,269,18,251
442718,1,999,786,104,682
442718,2,1,786,104,682
442727,1,999,2313,530,1783
442727,2,1,2313,530,1783
442736,1,999,985,70,915
442736,2,1,985,70,915
442745,1,999,1699,316,1383
442745,2,1,1699,316,1383
442781,1,999,401,129,272
442781,2,1,401,129,272
442790,1,999,2402,435,1967
442790,2,1,2402,435,1967
442806,1,999,778,392,386
442806,4,3,778,392,386
442815,1,999,1082,164,918
442815,2,1,1082,164,918
442824,1,999,3442,1953,1489
442824,2,1,3442,1953,1489
442842,1,999,427,123,304
442842,2,1,163,60,103
442842,4,3,264,63,201
442851,1,999,517,269,248
442851,2,1,517,269,248
442879,1,999,2494,355,2139
442879,2,1,2494,355,2139
442888,1,999,444,258,186
442888,2,1,444,258,186
442897,1,999,271,79,192
442897,2,1,214,65,149
442897,4,3,57,14,43
442930,1,999,1533,494,1039
442930,2,1,1531,494,1037
442930,4,3,2,0,2
442949,1,999,112,0,112
442949,2,1,112,0,112
442958,1,999,96,6,90
442958,2,1,96,6,90
442967,1,999,53,15,38
442967,2,1,53,15,38
442976,1,999,112,10,102
442976,2,1,112,10,102
442985,1,999,135,52,83
442985,2,1,135,52,83
443021,1,999,189,126,63
443021,2,1,189,126,63
443030,1,999,84,11,73
443030,4,3,84,11,73
443049,1,999,417,316,101
443049,2,1,190,145,45
443049,4,3,227,171,56
443058,1,999,48,20,28
443058,2,1,48,20,28
443076,1,999,268,144,124
443076,2,1,13,6,7
443076,4,3,255,138,117
443100,1,999,235,107,128
443100,2,1,235,107,128
443128,1,999,2159,1417,742
443128,4,3,2159,1417,742
443137,1,999,477,95,382
443137,2,1,477,95,382
443146,1,999,309,178,131
443146,2,1,309,178,131
443173,1,999,65,7,58
443173,2,1,65,7,58
443207,1,999,629,609,20
443207,2,1,629,609,20
443216,1,999,175,153,22
443216,2,1,175,153,22
443225,1,999,133,126,7
443225,2,1,133,126,7
443234,1,999,375,45,330
443234,2,1,375,45,330
443252,1,999,1120,882,238
443252,2,1,1120,882,238
443261,1,999,516,76,440
443261,2,1,516,76,440
443270,1,999,330,100,230
443270,2,1,330,100,230
443289,1,999,123,12,111
443289,2,1,123,12,111
443298,1,999,373,340,33
443298,2,1,373,340,33
443304,1,999,12,4,8
443304,2,1,12,4,8
443322,1,999,642,256,386
443322,2,1,642,256,386
443331,1,999,1262,309,953
443331,2,1,1236,305,931
443331,4,3,26,4,22
443340,1,999,369,199,170
443340,2,1,369,199,170
443359,1,999,270,196,74
443359,2,1,270,196,74
443377,1,999,282,278,4
443377,2,1,282,278,4
443410,1,999,976,836,140
443410,2,1,913,780,133
443410,4,3,63,56,7
443429,1,999,245,28,217
443429,2,1,245,28,217
443438,1,999,831,202,629
443438,2,1,831,202,629
443456,1,999,223,100,123
443456,2,1,161,71,90
443456,4,3,62,29,33
443465,1,999,216,82,134
443465,2,1,190,73,117
443465,4,3,26,9,17
443474,1,999,1664,609,1055
443474,2,1,1398,482,916
443474,4,3,266,127,139
443483,1,999,239,33,206
443483,2,1,239,33,206
443492,1,999,3929,1622,2307
443492,2,1,3929,1622,2307
443517,1,999,103,4,99
443517,2,1,103,4,99
443526,1,999,1183,927,256
443526,2,1,1183,927,256
443535,1,999,1019,664,355
443535,2,1,1019,664,355
443544,1,999,722,239,483
443544,2,1,596,199,397
443544,4,3,126,40,86
443553,1,999,912,347,565
443553,2,1,912,347,565
443562,1,999,2138,870,1268
443562,2,1,2138,870,1268
443571,1,999,305,178,127
443571,2,1,305,178,127
443605,1,999,459,66,393
443605,2,1,459,66,393
443623,1,999,1842,980,862
443623,2,1,1842,980,862
443632,1,999,235,178,57
443632,2,1,235,178,57
443641,1,999,343,19,324
443641,2,1,343,19,324
443650,1,999,1095,160,935
443650,2,1,1095,160,935
443669,1,999,575,69,506
443669,2,1,575,69,506
443678,1,999,199,9,190
443678,2,1,199,9,190
443687,1,999,1507,748,759
443687,2,1,1507,748,759
443696,1,999,86,40,46
443696,2,1,86,40,46
443702,1,999,12,7,5
443702,4,3,12,7,5
443739,1,999,688,79,609
443739,2,1,688,79,609
443748,1,999,1452,124,1328
443748,2,1,1452,124,1328
443766,1,999,4560,1148,3412
443766,2,1,3272,864,2408
443766,4,3,1288,284,1004
443784,1,999,5071,1899,3172
443784,2,1,3922,1445,2477
443784,4,3,1149,454,695
443827,1,999,933,501,432
443827,2,1,933,501,432
443836,1,999,1095,154,941
443836,2,1,1095,154,941
443845,1,999,2356,397,1959
443845,2,1,2356,397,1959
443854,1,999,1526,387,1139
443854,2,1,1526,387,1139
443881,1,999,1774,472,1302
443881,2,1,1675,438,1237
443881,4,3,99,34,65
443890,1,999,1855,465,1390
443890,2,1,1682,404,1278
443890,4,3,173,61,112
443906,1,999,326,137,189
443906,2,1,269,115,154
443906,4,3,57,22,35
443924,1,999,1555,483,1072
443924,2,1,1417,437,980
443924,4,3,138,46,92
443942,1,999,232,16,216
443942,2,1,232,16,216
443951,1,999,267,122,145
443951,2,1,267,122,145
443979,1,999,128,2,126
443979,2,1,128,2,126
443988,1,999,975,450,525
443988,4,3,975,450,525
443997,1,999,562,363,199
443997,2,1,562,363,199
444015,1,999,2300,217,2083
444015,2,1,2300,217,2083
444024,1,999,1748,136,1612
444024,2,1,1748,136,1612
444033,1,999,318,222,96
444033,2,1,318,222,96
444042,1,999,2084,611,1473
444042,2,1,2084,611,1473
444051,1,999,243,36,207
444051,2,1,243,36,207
444060,1,999,720,397,323
444060,2,1,720,397,323
444079,1,999,751,308,443
444079,2,1,751,308,443
444088,1,999,1077,251,826
444088,2,1,1077,251,826
444103,1,999,14,13,1
444103,4,3,14,13,1
444121,1,999,748,194,554
444121,2,1,748,194,554
444130,1,999,13714,6079,7635
444130,2,1,777,307,470
444130,4,3,12937,5772,7165
444158,1,999,51950,17492,34458
444158,2,1,47787,15721,32066
444158,4,3,4163,1771,2392
444167,1,999,5321,1489,3832
444167,2,1,5321,1489,3832
444176,1,999,512,236,276
444176,2,1,512,236,276
444194,1,999,262,31,231
444194,2,1,262,31,231
444200,1,999,862,91,771
444200,2,1,862,91,771
444219,1,999,13237,5421,7816
444219,2,1,13237,5421,7816
444228,1,999,53,2,51
444228,2,1,53,2,51
444237,1,999,1196,234,962
444237,2,1,1196,234,962
444255,1,999,907,197,710
444255,2,1,907,197,710
444264,1,999,175,49,126
444264,2,1,175,49,126
444282,1,999,236,19,217
444282,2,1,236,19,217
444291,1,999,261,14,247
444291,2,1,261,14,247
444307,1,999,218,17,201
444307,2,1,218,17,201
444316,1,999,211,11,200
444316,2,1,211,11,200
444325,1,999,248,59,189
444325,2,1,248,59,189
444334,1,999,195,65,130
444334,2,1,195,65,130
444343,1,999,305,42,263
444343,2,1,305,42,263
444352,1,999,432,117,315
444352,2,1,432,117,315
444361,1,999,111,59,52
444361,2,1,111,59,52
444370,1,999,301,300,1
444370,2,1,301,300,1
444389,1,999,1112,209,903
444389,2,1,1112,209,903
444398,1,999,277,159,118
444398,2,1,277,159,118
444404,1,999,122,70,52
444404,2,1,122,70,52
444413,1,999,129,129,0
444413,2,1,117,117,0
444413,4,3,12,12,0
444422,1,999,263,18,245
444422,2,1,263,18,245
444440,1,999,257,14,243
444440,2,1,257,14,243
444459,1,999,7,7,0
444459,2,1,7,7,0
444468,1,999,44,3,41
444468,2,1,44,3,41
444477,1,999,416,110,306
444477,2,1,416,110,306
444486,1,999,456,48,408
444486,2,1,456,48,408
444510,1,999,26,3,23
444510,2,1,26,3,23
444529,1,999,295,39,256
444529,2,1,295,39,256
444547,1,999,59,1,58
444547,2,1,59,1,58
444556,1,999,76,30,46
444556,2,1,76,30,46
444565,1,999,381,185,196
444565,2,1,381,185,196
444574,1,999,1167,272,895
444574,2,1,1167,272,895
444583,1,999,1188,707,481
444583,2,1,1188,707,481
444592,1,999,184,12,172
444592,2,1,184,12,172
444608,1,999,76,2,74
444608,2,1,76,2,74
444626,1,999,77,6,71
444626,2,1,77,6,71
444635,1,999,69,11,58
444635,2,1,69,11,58
444644,1,999,24,2,22
444644,2,1,24,2,22
444653,1,999,76,8,68
444653,2,1,76,8,68
444662,1,999,86,20,66
444662,2,1,86,20,66
444671,1,999,385,160,225
444671,2,1,385,160,225
444680,1,999,191,99,92
444680,2,1,191,99,92
444699,1,999,44,10,34
444699,4,3,44,10,34
444705,1,999,58,8,50
444705,2,1,58,8,50
444714,1,999,2103,446,1657
444714,2,1,2103,446,1657
444723,1,999,8961,3070,5891
444723,2,1,5281,1978,3303
444723,4,3,3680,1092,2588
444732,1,999,159,49,110
444732,2,1,159,49,110
444750,1,999,26,0,26
444750,2,1,26,0,26
444769,1,999,292,41,251
444769,2,1,292,41,251
444778,1,999,159,77,82
444778,2,1,116,57,59
444778,4,3,43,20,23
444796,1,999,411,221,190
444796,2,1,411,221,190
444811,1,999,203,30,173
444811,2,1,203,30,173
444857,1,999,67,0,67
444857,2,1,67,0,67
444866,1,999,337,55,282
444866,2,1,337,55,282
444893,1,999,359,66,293
444893,2,1,359,66,293
444909,1,999,25,1,24
444909,2,1,25,1,24
444927,1,999,647,313,334
444927,2,1,647,313,334
444936,1,999,41,4,37
444936,2,1,41,4,37
444945,1,999,380,37,343
444945,2,1,380,37,343
444954,1,999,4176,2530,1646
444954,2,1,4176,2530,1646
444972,1,999,321,102,219
444972,2,1,321,102,219
444990,1,999,570,156,414
444990,2,1,570,156,414
445009,1,999,5201,1897,3304
445009,2,1,5201,1897,3304
445018,1,999,2580,931,1649
445018,2,1,2580,931,1649
445027,1,999,39138,13215,25923
445027,2,1,35077,11800,23277
445027,4,3,4061,1415,2646
445072,1,999,1301,640,661
445072,2,1,1301,640,661
445081,1,999,1179,1022,157
445081,2,1,1179,1022,157
445090,1,999,797,180,617
445090,2,1,797,180,617
445115,1,999,1174,687,487
445115,2,1,1174,687,487
445124,1,999,1575,772,803
445124,2,1,1575,772,803
445133,1,999,817,341,476
445133,2,1,674,283,391
445133,4,3,143,58,85
445142,1,999,926,193,733
445142,2,1,926,193,733
445188,1,999,4547,2356,2191
445188,2,1,4295,2202,2093
445188,4,3,252,154,98
445197,1,999,1398,207,1191
445197,2,1,1398,207,1191
445203,1,999,1137,211,926
445203,2,1,1137,211,926
445212,1,999,432,77,355
445212,2,1,432,77,355
445221,1,999,155,7,148
445221,2,1,155,7,148
445230,1,999,1893,419,1474
445230,2,1,1893,419,1474
445249,1,999,723,86,637
445249,2,1,723,86,637
445258,1,999,577,234,343
445258,2,1,577,234,343
445267,1,999,4870,1626,3244
445267,2,1,4659,1590,3069
445267,4,3,211,36,175
445276,1,999,988,460,528
445276,2,1,988,460,528
445300,1,999,856,415,441
445300,2,1,856,415,441
445319,1,999,422,215,207
445319,2,1,362,176,186
445319,4,3,60,39,21
445328,1,999,788,95,693
445328,2,1,788,95,693
445337,1,999,664,162,502
445337,2,1,664,162,502
445346,1,999,878,167,711
445346,2,1,878,167,711
445355,1,999,503,95,408
445355,2,1,503,95,408
445364,1,999,405,71,334
445364,2,1,405,71,334
445373,1,999,830,140,690
445373,2,1,830,140,690
445382,1,999,1450,94,1356
445382,2,1,1450,94,1356
445391,1,999,370,162,208
445391,2,1,324,145,179
445391,4,3,46,17,29
445407,1,999,781,455,326
445407,2,1,781,455,326
445416,1,999,495,105,390
445416,2,1,477,102,375
445416,4,3,18,3,15
445434,1,999,1894,590,1304
445434,2,1,1894,590,1304
445452,1,999,2445,2300,145
445452,2,1,2445,2300,145
445461,1,999,2019,1187,832
445461,2,1,2019,1187,832
445470,1,999,884,114,770
445470,2,1,884,114,770
445489,1,999,120,27,93
445489,2,1,120,27,93
445498,1,999,97,97,0
445498,2,1,97,97,0
445504,1,999,210,18,192
445504,2,1,210,18,192
445531,1,999,47,3,44
445531,2,1,47,3,44
445540,1,999,94,3,91
445540,2,1,94,3,91
445559,1,999,523,337,186
445559,2,1,523,337,186
445577,1,999,639,200,439
445577,2,1,639,200,439
445601,1,999,1332,196,1136
445601,2,1,1332,196,1136
445610,1,999,403,51,352
445610,2,1,403,51,352
445629,1,999,237,27,210
445629,2,1,237,27,210
445638,1,999,115,16,99
445638,2,1,115,16,99
445647,1,999,217,16,201
445647,2,1,217,16,201
445656,1,999,232,18,214
445656,2,1,232,18,214
445665,1,999,459,42,417
445665,2,1,459,42,417
445674,1,999,1175,650,525
445674,2,1,1175,650,525
445683,1,999,63,4,59
445683,2,1,63,4,59
445692,1,999,297,276,21
445692,2,1,296,275,21
445692,4,3,1,1,0
445708,1,999,2867,1198,1669
445708,2,1,2867,1198,1669
445717,1,999,3471,1215,2256
445717,2,1,2989,1078,1911
445717,4,3,482,137,345
445726,1,999,776,457,319
445726,2,1,776,457,319
445735,1,999,1063,430,633
445735,2,1,289,68,221
445735,4,3,774,362,412
445744,1,999,751,78,673
445744,2,1,751,78,673
445753,1,999,523,141,382
445753,2,1,523,141,382
445762,1,999,452,423,29
445762,2,1,452,423,29
445771,1,999,923,149,774
445771,2,1,923,149,774
445780,1,999,93,3,90
445780,2,1,93,3,90
445799,1,999,2339,2301,38
445799,2,1,2339,2301,38
445814,1,999,1195,252,943
445814,2,1,1195,252,943
445832,1,999,241,20,221
445832,2,1,241,20,221
445841,1,999,218,3,215
445841,2,1,218,3,215
445850,1,999,255,14,241
445850,2,1,255,14,241
445869,1,999,74,21,53
445869,4,3,74,21,53
445896,1,999,157,5,152
445896,2,1,157,5,152
445911,1,999,1348,406,942
445911,2,1,1348,406,942
445920,1,999,1286,365,921
445920,2,1,1286,365,921
445939,1,999,536,102,434
445939,2,1,536,102,434
445948,1,999,396,66,330
445948,2,1,396,66,330
445957,1,999,569,168,401
445957,2,1,569,168,401
445984,1,999,38,38,0
445984,2,1,38,38,0
445993,1,999,152,12,140
445993,2,1,152,12,140
446002,1,999,108,25,83
446002,4,3,108,25,83
446039,1,999,59,20,39
446039,4,3,59,20,39
446048,1,999,877,424,453
446048,2,1,738,354,384
446048,4,3,139,70,69
446057,1,999,224,24,200
446057,2,1,224,24,200
446075,1,999,50,3,47
446075,2,1,50,3,47
446084,1,999,285,30,255
446084,2,1,285,30,255
446093,1,999,321,28,293
446093,2,1,321,28,293
446109,1,999,418,83,335
446109,2,1,418,83,335
446118,1,999,1221,231,990
446118,2,1,1221,231,990
446127,1,999,338,48,290
446127,2,1,338,48,290
446136,1,999,1114,227,887
446136,2,1,1114,227,887
446145,1,999,101,18,83
446145,2,1,101,18,83
446154,1,999,1007,137,870
446154,2,1,1007,137,870
446163,1,999,161,83,78
446163,2,1,161,83,78
446190,1,999,39,0,39
446190,2,1,39,0,39
446206,1,999,25,3,22
446206,2,1,25,3,22
446215,1,999,60,0,60
446215,2,1,60,0,60
446224,1,999,73,20,53
446224,2,1,73,20,53
446233,1,999,202,130,72
446233,2,1,202,130,72
446242,1,999,263,95,168
446242,2,1,263,95,168
446251,1,999,149,54,95
446251,2,1,149,54,95
446260,1,999,291,65,226
446260,2,1,291,65,226
446288,1,999,154,12,142
446288,2,1,154,12,142
446297,1,999,17,14,3
446297,2,1,17,14,3
446303,1,999,200,22,178
446303,2,1,200,22,178
446312,1,999,100,16,84
446312,2,1,100,16,84
446321,1,999,42,0,42
446321,2,1,42,0,42
446349,1,999,40,0,40
446349,2,1,40,0,40
446358,1,999,60,7,53
446358,2,1,60,7,53
446385,1,999,190,144,46
446385,2,1,190,144,46
446394,1,999,142,57,85
446394,2,1,100,41,59
446394,4,3,42,16,26
446400,1,999,360,85,275
446400,2,1,360,85,275
446419,1,999,53,5,48
446419,2,1,53,5,48
446428,1,999,855,79,776
446428,2,1,855,79,776
446437,1,999,273,95,178
446437,2,1,273,95,178
446446,1,999,344,33,311
446446,2,1,344,33,311
446455,1,999,378,315,63
446455,2,1,378,315,63
446464,1,999,77,22,55
446464,2,1,77,22,55
446491,1,999,22,1,21
446491,2,1,22,1,21
446507,1,999,27,7,20
446507,2,1,27,7,20
446516,1,999,79,11,68
446516,2,1,79,11,68
446525,1,999,297,274,23
446525,2,1,297,274,23
446534,1,999,90,32,58
446534,2,1,90,32,58
446543,1,999,38,7,31
446543,2,1,38,7,31
446552,1,999,2025,969,1056
446552,2,1,2025,969,1056
446561,1,999,870,325,545
446561,2,1,870,325,545
446570,1,999,52,33,19
446570,2,1,52,33,19
446589,1,999,99,25,74
446589,2,1,99,25,74
446598,1,999,75,8,67
446598,2,1,75,8,67
446604,1,999,1321,1321,0
446604,2,1,1321,1321,0
446613,1,999,57,30,27
446613,2,1,57,30,27
446640,1,999,516,251,265
446640,2,1,371,185,186
446640,4,3,145,66,79
446668,1,999,1204,571,633
446668,2,1,1204,571,633
446677,1,999,400,155,245
446677,2,1,400,155,245
446710,1,999,223,94,129
446710,2,1,213,90,123
446710,4,3,10,4,6
446729,1,999,33,15,18
446729,2,1,33,15,18
446738,1,999,1550,785,765
446738,2,1,1238,616,622
446738,4,3,312,169,143
446747,1,999,768,350,418
446747,2,1,698,313,385
446747,4,3,70,37,33
446756,1,999,722,321,401
446756,2,1,661,297,364
446756,4,3,61,24,37
446765,1,999,801,325,476
446765,2,1,634,262,372
446765,4,3,167,63,104
446774,1,999,5139,1884,3255
446774,2,1,5139,1884,3255
446783,1,999,311,149,162
446783,2,1,311,149,162
446792,1,999,1141,672,469
446792,2,1,1141,672,469
446808,1,999,733,332,401
446808,2,1,733,332,401
446817,1,999,1051,583,468
446817,2,1,1051,583,468
446835,1,999,2068,1136,932
446835,2,1,2068,1136,932
446844,1,999,1439,860,579
446844,2,1,1439,860,579
446853,1,999,873,148,725
446853,2,1,873,148,725
446880,1,999,674,94,580
446880,2,1,674,94,580
446899,1,999,1277,973,304
446899,2,1,1277,973,304
446905,1,999,1079,857,222
446905,2,1,1079,857,222
446914,1,999,2224,1839,385
446914,2,1,2224,1839,385
446923,1,999,914,716,198
446923,2,1,914,716,198
446932,1,999,698,367,331
446932,4,3,698,367,331
446996,1,999,167,10,157
446996,2,1,167,10,157
447014,1,999,369,43,326
447014,2,1,369,43,326
447023,1,999,926,293,633
447023,2,1,926,293,633
447050,1,999,508,156,352
447050,2,1,469,142,327
447050,4,3,39,14,25
447069,1,999,852,482,370
447069,2,1,852,482,370
447102,1,999,1166,308,858
447102,2,1,1166,308,858
447120,1,999,856,201,655
447120,2,1,856,201,655
447148,1,999,470,16,454
447148,2,1,470,16,454
447157,1,999,191,14,177
447157,2,1,191,14,177
447166,1,999,178,2,176
447166,2,1,178,2,176
447175,1,999,223,21,202
447175,2,1,223,21,202
447209,1,999,1636,183,1453
447209,2,1,1636,183,1453
447218,1,999,1462,112,1350
447218,2,1,1462,112,1350
447227,1,999,1508,245,1263
447227,2,1,1508,245,1263
447236,1,999,908,167,741
447236,2,1,908,167,741
447245,1,999,1328,160,1168
447245,2,1,1328,160,1168
447254,1,999,39,3,36
447254,2,1,39,3,36
447263,1,999,630,133,497
447263,2,1,630,133,497
447272,1,999,881,259,622
447272,2,1,276,86,190
447272,4,3,605,173,432
447290,1,999,1752,553,1199
447290,2,1,1752,553,1199
447315,1,999,126,4,122
447315,2,1,126,4,122
447324,1,999,220,9,211
447324,2,1,220,9,211
447333,1,999,151,17,134
447333,2,1,151,17,134
447342,1,999,159,13,146
447342,2,1,159,13,146
447351,1,999,1059,346,713
447351,2,1,1059,346,713
447360,1,999,532,230,302
447360,2,1,532,230,302
447379,1,999,242,202,40
447379,2,1,242,202,40
447388,1,999,586,82,504
447388,2,1,586,82,504
447397,1,999,460,73,387
447397,2,1,460,73,387
447403,1,999,1892,1836,56
447403,2,1,1892,1836,56
447421,1,999,784,264,520
447421,2,1,784,264,520
447430,1,999,160,40,120
447430,2,1,160,40,120
447449,1,999,59,7,52
447449,2,1,59,7,52
447458,1,999,1198,1028,170
447458,2,1,1198,1028,170
447467,1,999,385,43,342
447467,2,1,385,43,342
447476,1,999,830,293,537
447476,2,1,830,293,537
447485,1,999,297,174,123
447485,2,1,297,174,123
447494,1,999,652,56,596
447494,2,1,652,56,596
447519,1,999,950,93,857
447519,2,1,950,93,857
447528,1,999,229,81,148
447528,2,1,229,81,148
447582,1,999,4758,1687,3071
447582,2,1,4758,1687,3071
447591,1,999,176,31,145
447591,2,1,176,31,145
447625,1,999,538,179,359
447625,2,1,538,179,359
447634,1,999,893,244,649
447634,2,1,893,244,649
447652,1,999,1126,331,795
447652,2,1,1049,304,745
447652,4,3,77,27,50
447661,1,999,721,259,462
447661,2,1,521,201,320
447661,4,3,200,58,142
447670,1,999,864,254,610
447670,2,1,864,254,610
447689,1,999,6890,3118,3772
447689,2,1,6890,3118,3772
447698,1,999,153,60,93
447698,4,3,153,60,93
447704,1,999,127,5,122
447704,2,1,127,5,122
447713,1,999,145,34,111
447713,2,1,145,34,111
447722,1,999,98,16,82
447722,2,1,98,16,82
447731,1,999,259,6,253
447731,2,1,259,6,253
447759,1,999,516,120,396
447759,2,1,516,120,396
447768,1,999,2911,646,2265
447768,2,1,2911,646,2265
447777,1,999,550,341,209
447777,2,1,550,341,209
447795,1,999,43,11,32
447795,2,1,43,11,32
447801,1,999,209,72,137
447801,4,3,209,72,137
447810,1,999,282,21,261
447810,2,1,282,21,261
447829,1,999,101,70,31
447829,2,1,101,70,31
447838,1,999,73,37,36
447838,2,1,73,37,36
447847,1,999,100,89,11
447847,2,1,100,89,11
447856,1,999,279,59,220
447856,2,1,279,59,220
447865,1,999,58,40,18
447865,2,1,58,40,18
447874,1,999,460,457,3
447874,2,1,460,457,3
447883,1,999,182,93,89
447883,2,1,182,93,89
447892,1,999,274,63,211
447892,2,1,274,63,211
447908,1,999,72,8,64
447908,2,1,72,8,64
447917,1,999,92,21,71
447917,2,1,92,21,71
447935,1,999,986,63,923
447935,2,1,986,63,923
447953,1,999,289,164,125
447953,2,1,289,164,125
447962,1,999,340,24,316
447962,2,1,340,24,316
447971,1,999,138,15,123
447971,2,1,138,15,123
447980,1,999,93,13,80
447980,2,1,93,13,80
447999,1,999,294,75,219
447999,2,1,294,75,219
448008,1,999,35,1,34
448008,2,1,35,1,34
448017,1,999,76,10,66
448017,2,1,76,10,66
448026,1,999,173,3,170
448026,2,1,173,3,170
448035,1,999,46,8,38
448035,2,1,46,8,38
448044,1,999,24,0,24
448044,2,1,24,0,24
448053,1,999,111,5,106
448053,2,1,111,5,106
448071,1,999,251,32,219
448071,2,1,251,32,219
448080,1,999,78,14,64
448080,2,1,78,14,64
448105,1,999,83,37,46
448105,2,1,83,37,46
448114,1,999,1449,477,972
448114,2,1,1449,477,972
448123,1,999,245,51,194
448123,2,1,245,51,194
448141,1,999,78,2,76
448141,2,1,78,2,76
448150,1,999,259,19,240
448150,2,1,259,19,240
448196,1,999,406,64,342
448196,2,1,406,64,342
448202,1,999,117,17,100
448202,2,1,117,17,100
448211,1,999,127,8,119
448211,2,1,127,8,119
448220,1,999,75,2,73
448220,2,1,75,2,73
448239,1,999,120,1,119
448239,2,1,120,1,119
448248,1,999,2811,991,1820
448248,2,1,2811,991,1820
448257,1,999,55,0,55
448257,2,1,55,0,55
448266,1,999,65,2,63
448266,2,1,65,2,63
448275,1,999,55,18,37
448275,2,1,55,18,37
448284,1,999,3129,876,2253
448284,2,1,1080,435,645
448284,4,3,2049,441,1608
448309,1,999,3031,654,2377
448309,2,1,2537,474,2063
448309,4,3,494,180,314
448345,1,999,1764,729,1035
448345,2,1,1764,729,1035
448354,1,999,223,26,197
448354,2,1,223,26,197
448363,1,999,1488,212,1276
448363,2,1,1488,212,1276
448372,1,999,324,147,177
448372,2,1,324,147,177
448406,1,999,462,31,431
448406,2,1,462,31,431
448415,1,999,1825,158,1667
448415,2,1,1825,158,1667
448424,1,999,153,6,147
448424,2,1,153,6,147
448433,1,999,2633,2574,59
448433,2,1,2633,2574,59
448442,1,999,1287,918,369
448442,2,1,1287,918,369
448451,1,999,1055,787,268
448451,2,1,1055,787,268
448460,1,999,523,424,99
448460,2,1,523,424,99
448479,1,999,1492,1071,421
448479,2,1,1492,1071,421
448488,1,999,1006,741,265
448488,2,1,1006,741,265
448497,1,999,1049,753,296
448497,2,1,1049,753,296
448503,1,999,972,657,315
448503,2,1,972,657,315
448512,1,999,1004,631,373
448512,2,1,1004,631,373
448521,1,999,103,61,42
448521,2,1,78,46,32
448521,4,3,25,15,10
448530,1,999,951,385,566
448530,2,1,910,364,546
448530,4,3,41,21,20
448549,1,999,211,79,132
448549,2,1,198,73,125
448549,4,3,13,6,7
448558,1,999,287,127,160
448558,2,1,269,116,153
448558,4,3,18,11,7
448567,1,999,1285,459,826
448567,2,1,1157,400,757
448567,4,3,128,59,69
448576,1,999,2809,1487,1322
448576,2,1,2809,1487,1322
448585,1,999,791,100,691
448585,2,1,791,100,691
448594,1,999,5704,2182,3522
448594,2,1,5704,2182,3522
448600,1,999,544,62,482
448600,2,1,544,62,482
448619,1,999,313,37,276
448619,2,1,313,37,276
448628,1,999,775,478,297
448628,2,1,775,478,297
448646,1,999,305,16,289
448646,2,1,305,16,289
448655,1,999,726,191,535
448655,2,1,726,191,535
448664,1,999,986,699,287
448664,2,1,986,699,287
448673,1,999,3508,895,2613
448673,2,1,3508,895,2613
448691,1,999,176,34,142
448691,4,3,176,34,142
448707,1,999,393,145,248
448707,2,1,393,145,248
448716,1,999,424,128,296
448716,2,1,424,128,296
448734,1,999,789,243,546
448734,2,1,244,81,163
448734,4,3,545,162,383
448752,1,999,1150,386,764
448752,2,1,1150,386,764
448761,1,999,568,178,390
448761,2,1,568,178,390
448770,1,999,581,566,15
448770,2,1,581,566,15
448789,1,999,2742,441,2301
448789,2,1,2742,441,2301
448798,1,999,607,124,483
448798,2,1,607,124,483
448804,1,999,503,121,382
448804,2,1,503,121,382
448822,1,999,50,24,26
448822,2,1,38,20,18
448822,4,3,12,4,8
448831,1,999,149,66,83
448831,2,1,131,56,75
448831,4,3,18,10,8
448840,1,999,5081,1975,3106
448840,2,1,4415,1750,2665
448840,4,3,666,225,441
448859,1,999,223,220,3
448859,2,1,223,220,3
448877,1,999,243,156,87
448877,2,1,243,156,87
448895,1,999,748,78,670
448895,2,1,748,78,670
448965,1,999,322,41,281
448965,2,1,322,41,281
448974,1,999,553,67,486
448974,2,1,553,67,486
448983,1,999,492,98,394
448983,2,1,492,98,394
449010,1,999,1431,756,675
449010,2,1,1431,756,675
449038,1,999,5745,2334,3411
449038,2,1,4405,1819,2586
449038,4,3,1340,515,825
449074,1,999,1642,304,1338
449074,2,1,1642,304,1338
449083,1,999,515,467,48
449083,2,1,515,467,48
449092,1,999,572,437,135
449092,2,1,572,437,135
449117,1,999,1093,157,936
449117,2,1,1093,157,936
449126,1,999,603,95,508
449126,2,1,603,95,508
449135,1,999,366,126,240
449135,2,1,366,126,240
449144,1,999,425,218,207
449144,2,1,425,218,207
449153,1,999,489,201,288
449153,2,1,489,201,288
449162,1,999,189,8,181
449162,2,1,189,8,181
449171,1,999,156,5,151
449171,2,1,156,5,151
449180,1,999,208,5,203
449180,2,1,208,5,203
449199,1,999,191,7,184
449199,2,1,191,7,184
449205,1,999,109,5,104
449205,2,1,109,5,104
449214,1,999,116,0,116
449214,2,1,116,0,116
449223,1,999,241,14,227
449223,2,1,241,14,227
449232,1,999,237,15,222
449232,2,1,237,15,222
449241,1,999,127,2,125
449241,2,1,127,2,125
449250,1,999,268,65,203
449250,2,1,268,65,203
449269,1,999,1318,410,908
449269,2,1,1318,410,908
449278,1,999,958,187,771
449278,2,1,958,187,771
449302,1,999,110,17,93
449302,2,1,110,17,93
449311,1,999,386,15,371
449311,2,1,386,15,371
449320,1,999,1318,1284,34
449320,2,1,1318,1284,34
449339,1,999,88029,58107,29922
449339,2,1,68845,45524,23321
449339,4,3,19184,12583,6601
449348,1,999,99,57,42
449348,2,1,99,57,42
449357,1,999,127,18,109
449357,2,1,127,18,109
449366,1,999,612,15,597
449366,2,1,612,15,597
449375,1,999,257,206,51
449375,2,1,257,206,51
449384,1,999,145,113,32
449384,2,1,145,113,32
449393,1,999,181,17,164
449393,2,1,181,17,164
449418,1,999,197,163,34
449418,2,1,197,163,34
449436,1,999,187,12,175
449436,2,1,187,12,175
449445,1,999,309,73,236
449445,2,1,309,73,236
449454,1,999,56,13,43
449454,2,1,56,13,43
449463,1,999,74,4,70
449463,2,1,74,4,70
449472,1,999,154,11,143
449472,2,1,154,11,143
449481,1,999,62,22,40
449481,4,3,62,22,40
449490,1,999,149,18,131
449490,2,1,149,18,131
449506,1,999,437,91,346
449506,2,1,437,91,346
449524,1,999,240,39,201
449524,2,1,240,39,201
449533,1,999,226,45,181
449533,2,1,226,45,181
449551,1,999,23,4,19
449551,2,1,23,4,19
449579,1,999,38,9,29
449579,4,3,38,9,29
449597,1,999,138,5,133
449597,2,1,138,5,133
449603,1,999,272,246,26
449603,2,1,272,246,26
449612,1,999,191,117,74
449612,2,1,191,117,74
449658,1,999,110,110,0
449658,2,1,110,110,0
449667,1,999,243,42,201
449667,2,1,243,42,201
449676,1,999,72,57,15
449676,2,1,72,57,15
449685,1,999,215,31,184
449685,2,1,215,31,184
449700,1,999,1059,211,848
449700,2,1,1059,211,848
449719,1,999,479,57,422
449719,2,1,479,57,422
449728,1,999,108,7,101
449728,2,1,108,7,101
449746,1,999,462,321,141
449746,2,1,462,321,141
449755,1,999,13,13,0
449755,2,1,13,13,0
449764,1,999,114,75,39
449764,2,1,114,75,39
449773,1,999,265,75,190
449773,2,1,265,75,190
449782,1,999,65,5,60
449782,2,1,65,5,60
449791,1,999,449,47,402
449791,2,1,449,47,402
449807,1,999,217,6,211
449807,2,1,217,6,211
449816,1,999,957,579,378
449816,2,1,957,579,378
449825,1,999,89,3,86
449825,2,1,89,3,86
449852,1,999,92,10,82
449852,2,1,92,10,82
449861,1,999,575,63,512
449861,2,1,575,63,512
449870,1,999,268,130,138
449870,2,1,94,35,59
449870,4,3,174,95,79
449889,1,999,5521,1580,3941
449889,4,3,5521,1580,3941
449898,1,999,1336,330,1006
449898,2,1,1183,300,883
449898,4,3,153,30,123
449904,1,999,439,31,408
449904,2,1,439,31,408
449913,1,999,162,21,141
449913,2,1,162,21,141
449922,1,999,207,99,108
449922,4,3,207,99,108
449931,1,999,2513,928,1585
449931,2,1,1498,604,894
449931,4,3,1015,324,691
449940,1,999,103,77,26
449940,2,1,103,77,26
449959,1,999,335,29,306
449959,2,1,335,29,306
449968,1,999,451,40,411
449968,2,1,451,40,411
449977,1,999,413,29,384
449977,2,1,413,29,384
449986,1,999,386,38,348
449986,2,1,386,38,348
449995,1,999,360,30,330
449995,2,1,360,30,330
450003,1,999,965,218,747
450003,2,1,965,218,747
450012,1,999,144,27,117
450012,2,1,144,27,117
450021,1,999,460,50,410
450021,2,1,460,50,410
450049,1,999,1063,552,511
450049,2,1,1063,552,511
450058,1,999,1212,138,1074
450058,2,1,1212,138,1074
450067,1,999,885,137,748
450067,2,1,885,137,748
450076,1,999,1677,167,1510
450076,2,1,1677,167,1510
450085,1,999,920,376,544
450085,2,1,920,376,544
450094,1,999,1481,827,654
450094,2,1,1481,827,654
450119,1,999,308,42,266
450119,2,1,308,42,266
450128,1,999,691,81,610
450128,2,1,691,81,610
450146,1,999,132,15,117
450146,2,1,132,15,117
450155,1,999,542,98,444
450155,2,1,542,98,444
450173,1,999,11073,1404,9669
450173,2,1,11073,1404,9669
450182,1,999,758,204,554
450182,2,1,758,204,554
450191,1,999,960,122,838
450191,2,1,960,122,838
450207,1,999,549,463,86
450207,2,1,549,463,86
450216,1,999,1106,788,318
450216,2,1,1106,788,318
450225,1,999,1052,757,295
450225,2,1,1052,757,295
450234,1,999,781,553,228
450234,2,1,781,553,228
450243,1,999,1312,980,332
450243,2,1,1312,980,332
450252,1,999,1128,809,319
450252,2,1,1128,809,319
450261,1,999,613,483,130
450261,2,1,613,483,130
450270,1,999,913,575,338
450270,2,1,913,575,338
450289,1,999,722,114,608
450289,2,1,722,114,608
450298,1,999,699,245,454
450298,2,1,568,201,367
450298,4,3,131,44,87
450304,1,999,248,120,128
450304,4,3,248,120,128
450377,1,999,1926,467,1459
450377,2,1,1100,301,799
450377,4,3,826,166,660
450386,1,999,577,105,472
450386,2,1,577,105,472
450395,1,999,241,11,230
450395,2,1,241,11,230
450401,1,999,539,9,530
450401,2,1,539,9,530
450429,1,999,565,134,431
450429,2,1,565,134,431
450438,1,999,121,30,91
450438,2,1,121,30,91
450447,1,999,915,260,655
450447,2,1,915,260,655
450456,1,999,760,185,575
450456,2,1,659,157,502
450456,4,3,101,28,73
450465,1,999,1165,531,634
450465,2,1,1165,531,634
450474,1,999,1726,493,1233
450474,2,1,1618,454,1164
450474,4,3,108,39,69
450483,1,999,191,74,117
450483,2,1,178,68,110
450483,4,3,13,6,7
450492,1,999,821,289,532
450492,2,1,790,277,513
450492,4,3,31,12,19
450508,1,999,271,140,131
450508,2,1,271,140,131
450517,1,999,479,224,255
450517,2,1,479,224,255
450526,1,999,1143,324,819
450526,2,1,514,150,364
450526,4,3,629,174,455
450535,1,999,852,218,634
450535,2,1,238,67,171
450535,4,3,614,151,463
450544,1,999,608,206,402
450544,2,1,236,107,129
450544,4,3,372,99,273
450553,1,999,607,328,279
450553,2,1,607,328,279
450562,1,999,674,97,577
450562,2,1,674,97,577
450571,1,999,2174,502,1672
450571,2,1,2174,502,1672
450580,1,999,283,20,263
450580,2,1,283,20,263
450599,1,999,321,35,286
450599,2,1,321,35,286
450605,1,999,282,34,248
450605,2,1,282,34,248
450614,1,999,285,19,266
450614,2,1,285,19,266
450623,1,999,263,13,250
450623,2,1,263,13,250
450632,1,999,222,60,162
450632,2,1,222,60,162
450641,1,999,188,10,178
450641,2,1,188,10,178
450650,1,999,267,16,251
450650,2,1,267,16,251
450669,1,999,312,166,146
450669,2,1,312,166,146
450678,1,999,291,112,179
450678,2,1,291,112,179
450696,1,999,941,180,761
450696,2,1,941,180,761
450702,1,999,1179,160,1019
450702,2,1,1179,160,1019
450720,1,999,462,21,441
450720,2,1,462,21,441
450739,1,999,434,15,419
450739,2,1,434,15,419
450757,1,999,161,11,150
450757,2,1,161,11,150
450766,1,999,389,145,244
450766,2,1,39,6,33
450766,4,3,350,139,211
450775,1,999,397,57,340
450775,2,1,397,57,340
450784,1,999,170,11,159
450784,2,1,170,11,159
450793,1,999,223,8,215
450793,2,1,223,8,215
450809,1,999,168,7,161
450809,2,1,168,7,161
450818,1,999,235,8,227
450818,2,1,235,8,227
450827,1,999,224,14,210
450827,2,1,224,14,210
450836,1,999,196,21,175
450836,2,1,196,21,175
450845,1,999,155,5,150
450845,2,1,155,5,150
450854,1,999,171,9,162
450854,2,1,171,9,162
450863,1,999,156,8,148
450863,2,1,156,8,148
450872,1,999,138,4,134
450872,2,1,138,4,134
450881,1,999,94,4,90
450881,2,1,94,4,90
450933,1,999,28460,18938,9522
450933,2,1,22315,15279,7036
450933,4,3,6145,3659,2486
450942,1,999,815,449,366
450942,4,3,815,449,366
450951,1,999,248,149,99
450951,2,1,248,149,99
450960,1,999,394,37,357
450960,2,1,394,37,357
450979,1,999,18882,12751,6131
450979,2,1,10417,7125,3292
450979,4,3,8465,5626,2839
450988,1,999,407,70,337
450988,2,1,407,70,337
450997,1,999,164,99,65
450997,2,1,164,99,65
451006,1,999,90,21,69
451006,2,1,90,21,69
451015,1,999,299,94,205
451015,2,1,299,94,205
451024,1,999,61,11,50
451024,2,1,61,11,50
451033,1,999,24,0,24
451033,2,1,24,0,24
451042,1,999,63,10,53
451042,2,1,63,10,53
451051,1,999,74,11,63
451051,2,1,74,11,63
451060,1,999,402,291,111
451060,2,1,353,258,95
451060,4,3,49,33,16
451079,1,999,77,16,61
451079,4,3,77,16,61
451088,1,999,295,199,96
451088,2,1,295,199,96
451097,1,999,174,42,132
451097,2,1,174,42,132
451103,1,999,954,319,635
451103,2,1,954,319,635
451112,1,999,160,122,38
451112,2,1,160,122,38
451121,1,999,260,25,235
451121,2,1,260,25,235
451130,1,999,285,143,142
451130,4,3,285,143,142
451149,1,999,875,196,679
451149,2,1,875,196,679
451158,1,999,187,10,177
451158,2,1,187,10,177
451167,1,999,150,97,53
451167,2,1,150,97,53
451194,1,999,49,11,38
451194,2,1,49,11,38
451200,1,999,32,2,30
451200,2,1,32,2,30
451219,1,999,48,15,33
451219,2,1,48,15,33
451228,1,999,388,230,158
451228,2,1,388,230,158
451237,1,999,47,2,45
451237,2,1,47,2,45
451246,1,999,62,22,40
451246,2,1,62,22,40
451255,1,999,70,1,69
451255,2,1,70,1,69
451264,1,999,287,93,194
451264,2,1,287,93,194
451282,1,999,450,24,426
451282,2,1,450,24,426
451291,1,999,43,4,39
451291,2,1,43,4,39
451307,1,999,109,5,104
451307,2,1,109,5,104
451316,1,999,88,4,84
451316,2,1,88,4,84
451325,1,999,28,3,25
451325,2,1,28,3,25
451334,1,999,186,42,144
451334,2,1,186,42,144
451343,1,999,145,4,141
451343,2,1,145,4,141
451352,1,999,898,164,734
451352,2,1,898,164,734
451361,1,999,60,11,49
451361,2,1,60,11,49
451370,1,999,70,70,0
451370,2,1,70,70,0
451398,1,999,265,265,0
451398,2,1,265,265,0
451404,1,999,200,200,0
451404,2,1,200,200,0
451413,1,999,321,175,146
451413,2,1,321,175,146
451422,1,999,172,26,146
451422,2,1,172,26,146
451431,1,999,78,15,63
451431,2,1,78,15,63
451440,1,999,445,139,306
451440,2,1,445,139,306
451459,1,999,172,85,87
451459,2,1,172,85,87
451468,1,999,182,10,172
451468,2,1,182,10,172
451477,1,999,552,424,128
451477,2,1,552,424,128
451486,1,999,55,39,16
451486,2,1,55,39,16
451495,1,999,94,14,80
451495,2,1,94,14,80
451501,1,999,168,63,105
451501,2,1,168,63,105
451510,1,999,709,384,325
451510,4,3,709,384,325
451529,1,999,110,3,107
451529,2,1,110,3,107
451538,1,999,257,222,35
451538,2,1,257,222,35
451547,1,999,71,8,63
451547,2,1,71,8,63
451556,1,999,1577,628,949
451556,2,1,1577,628,949
451565,1,999,327,29,298
451565,2,1,327,29,298
451574,1,999,104,7,97
451574,2,1,104,7,97
451583,1,999,493,249,244
451583,2,1,493,249,244
451592,1,999,131,37,94
451592,2,1,131,37,94
451608,1,999,143,79,64
451608,2,1,143,79,64
451617,1,999,37,1,36
451617,2,1,37,1,36
451626,1,999,122,14,108
451626,2,1,122,14,108
451635,1,999,80,13,67
451635,2,1,80,13,67
451644,1,999,13,1,12
451644,2,1,13,1,12
451653,1,999,26,1,25
451653,2,1,26,1,25
451662,1,999,29835,11176,18659
451662,2,1,29835,11176,18659
451671,1,999,2503,849,1654
451671,2,1,2213,781,1432
451671,4,3,290,68,222
451680,1,999,1683,742,941
451680,2,1,1431,658,773
451680,4,3,252,84,168
451699,1,999,2970,561,2409
451699,2,1,2970,561,2409
451705,1,999,181,58,123
451705,2,1,181,58,123
451714,1,999,413,32,381
451714,2,1,413,32,381
451741,1,999,1343,397,946
451741,2,1,1343,397,946
451750,1,999,1488,241,1247
451750,2,1,1488,241,1247
451769,1,999,1356,372,984
451769,2,1,1356,372,984
451778,1,999,118,9,109
451778,2,1,118,9,109
451796,1,999,1347,569,778
451796,2,1,1347,569,778
451802,1,999,35,3,32
451802,2,1,35,3,32
451811,1,999,54,1,53
451811,2,1,54,1,53
451820,1,999,1964,1050,914
451820,2,1,1964,1050,914
451848,1,999,1075,601,474
451848,2,1,1075,601,474
451857,1,999,676,93,583
451857,2,1,676,93,583
451866,1,999,756,151,605
451866,2,1,756,151,605
451875,1,999,512,159,353
451875,2,1,512,159,353
451884,1,999,832,183,649
451884,2,1,832,183,649
451893,1,999,152,18,134
451893,2,1,152,18,134
451909,1,999,715,108,607
451909,2,1,715,108,607
451918,1,999,204,11,193
451918,2,1,204,11,193
451936,1,999,852,648,204
451936,2,1,852,648,204
451945,1,999,854,623,231
451945,2,1,854,623,231
451954,1,999,506,423,83
451954,2,1,506,423,83
451963,1,999,786,581,205
451963,2,1,786,581,205
451972,1,999,964,653,311
451972,2,1,964,653,311
451981,1,999,720,492,228
451981,2,1,720,492,228
451990,1,999,871,640,231
451990,2,1,871,640,231
452009,1,999,97,0,97
452009,2,1,97,0,97
452018,1,999,849,361,488
452018,2,1,849,361,488
452027,1,999,1041,471,570
452027,2,1,1041,471,570
452036,1,999,1144,627,517
452036,2,1,1144,627,517
452045,1,999,799,430,369
452045,2,1,799,430,369
452054,1,999,1342,739,603
452054,2,1,1342,739,603
452063,1,999,1498,807,691
452063,2,1,1498,807,691
452072,1,999,234,12,222
452072,2,1,234,12,222
452081,1,999,369,14,355
452081,2,1,369,14,355
452090,1,999,499,225,274
452090,2,1,204,91,113
452090,4,3,295,134,161
452106,1,999,86,84,2
452106,2,1,86,84,2
452115,1,999,1446,81,1365
452115,2,1,1446,81,1365
452124,1,999,1133,239,894
452124,2,1,1133,239,894
452133,1,999,2127,419,1708
452133,2,1,1797,251,1546
452133,4,3,330,168,162
452230,1,999,59,58,1
452230,2,1,59,58,1
452373,1,999,613,140,473
452373,2,1,613,140,473
452540,1,999,27,12,15
452540,2,1,27,12,15
452692,1,999,6,0,6
452692,2,1,6,0,6
452771,1,999,37,2,35
452771,2,1,37,2,35
452780,1,999,42,0,42
452780,2,1,42,0,42
452841,1,999,255,56,199
452841,2,1,255,56,199
452948,1,999,679,104,575
452948,2,1,679,104,575
453075,1,999,128,23,105
453075,2,1,128,23,105
453109,1,999,405,203,202
453109,2,1,405,203,202
453127,1,999,1739,628,1111
453127,2,1,1525,542,983
453127,4,3,214,86,128
453163,1,999,8404,2277,6127
453163,2,1,5365,1542,3823
453163,4,3,3039,735,2304
453215,1,999,1162,457,705
453215,2,1,930,373,557
453215,4,3,232,84,148
453297,1,999,76,38,38
453297,2,1,76,38,38
453349,1,999,773,294,479
453349,2,1,773,294,479
453455,1,999,577,122,455
453455,2,1,577,122,455
453464,1,999,893,194,699
453464,2,1,893,194,699
453473,1,999,634,173,461
453473,2,1,634,173,461
453482,1,999,462,110,352
453482,2,1,462,110,352
453507,1,999,39,29,10
453507,2,1,39,29,10
453516,1,999,29,18,11
453516,2,1,29,18,11
453552,1,999,748,136,612
453552,2,1,748,136,612
453570,1,999,95,4,91
453570,2,1,95,4,91
453747,1,999,365,52,313
453747,2,1,365,52,313
453756,1,999,262,178,84
453756,2,1,262,178,84
453792,1,999,648,93,555
453792,2,1,648,93,555
453817,1,999,416,403,13
453817,2,1,416,403,13
453923,1,999,3,2,1
453923,2,1,3,2,1
454032,1,999,587,516,71
454032,2,1,587,516,71
454078,1,999,25,9,16
454078,2,1,25,9,16
454175,1,999,706,125,581
454175,2,1,706,125,581
454184,1,999,412,161,251
454184,2,1,412,161,251
454209,1,999,219,121,98
454209,2,1,219,121,98
454227,1,999,2343,224,2119
454227,2,1,1270,155,1115
454227,4,3,1073,69,1004
454236,1,999,959,99,860
454236,2,1,959,99,860
454245,1,999,408,72,336
454245,2,1,408,72,336
454263,1,999,236,32,204
454263,2,1,236,32,204
454281,1,999,39,3,36
454281,2,1,39,3,36
454290,1,999,109,5,104
454290,2,1,109,5,104
454306,1,999,384,39,345
454306,2,1,384,39,345
454315,1,999,190,9,181
454315,2,1,190,9,181
454324,1,999,156,11,145
454324,2,1,156,11,145
454333,1,999,113,5,108
454333,2,1,113,5,108
454342,1,999,213,6,207
454342,2,1,213,6,207
454351,1,999,263,13,250
454351,2,1,263,13,250
454360,1,999,269,10,259
454360,2,1,269,10,259
454379,1,999,216,6,210
454379,2,1,216,6,210
454388,1,999,199,12,187
454388,2,1,199,12,187
454397,1,999,170,6,164
454397,2,1,170,6,164
454403,1,999,275,160,115
454403,2,1,275,160,115
454412,1,999,298,135,163
454412,2,1,298,135,163
454421,1,999,231,156,75
454421,2,1,231,156,75
454430,1,999,145,105,40
454430,2,1,145,105,40
454449,1,999,60,51,9
454449,2,1,60,51,9
454458,1,999,363,92,271
454458,2,1,363,92,271
454467,1,999,201,17,184
454467,2,1,201,17,184
454476,1,999,179,9,170
454476,2,1,179,9,170
454485,1,999,84,5,79
454485,2,1,84,5,79
454494,1,999,178,17,161
454494,2,1,178,17,161
454500,1,999,196,21,175
454500,2,1,196,21,175
454519,1,999,205,7,198
454519,2,1,205,7,198
454528,1,999,134,2,132
454528,2,1,134,2,132
454537,1,999,120,5,115
454537,2,1,120,5,115
454546,1,999,364,32,332
454546,2,1,364,32,332
454555,1,999,418,18,400
454555,2,1,418,18,400
454564,1,999,991,200,791
454564,2,1,991,200,791
454573,1,999,490,10,480
454573,2,1,490,10,480
454582,1,999,747,289,458
454582,2,1,627,242,385
454582,4,3,120,47,73
454591,1,999,409,111,298
454591,2,1,409,111,298
454607,1,999,356,19,337
454607,2,1,356,19,337
454616,1,999,597,519,78
454616,2,1,597,519,78
454625,1,999,1434,136,1298
454625,2,1,1434,136,1298
454634,1,999,1401,974,427
454634,2,1,1401,974,427
454652,1,999,240,19,221
454652,2,1,240,19,221
454689,1,999,583,319,264
454689,2,1,4,2,2
454689,4,3,579,317,262
454698,1,999,401,188,213
454698,2,1,401,188,213
454704,1,999,73,59,14
454704,2,1,73,59,14
454713,1,999,596,122,474
454713,2,1,596,122,474
454722,1,999,66,4,62
454722,2,1,66,4,62
454731,1,999,247,113,134
454731,2,1,247,113,134
454740,1,999,317,79,238
454740,2,1,317,79,238
454759,1,999,31,25,6
454759,2,1,31,25,6
454768,1,999,239,24,215
454768,2,1,239,24,215
454777,1,999,288,26,262
454777,2,1,288,26,262
454786,1,999,585,272,313
454786,2,1,585,272,313
454795,1,999,175,38,137
454795,2,1,175,38,137
454801,1,999,282,41,241
454801,2,1,282,41,241
454810,1,999,57,22,35
454810,2,1,57,22,35
454829,1,999,1359,900,459
454829,2,1,163,110,53
454829,4,3,1196,790,406
454838,1,999,40,13,27
454838,4,3,40,13,27
454847,1,999,171,25,146
454847,2,1,171,25,146
454856,1,999,715,76,639
454856,2,1,715,76,639
454865,1,999,497,113,384
454865,2,1,497,113,384
454874,1,999,159,16,143
454874,2,1,159,16,143
454883,1,999,845,54,791
454883,2,1,845,54,791
454892,1,999,50,6,44
454892,2,1,50,6,44
454908,1,999,632,276,356
454908,2,1,632,276,356
454917,1,999,262,30,232
454917,2,1,262,30,232
454926,1,999,387,43,344
454926,2,1,387,43,344
454935,1,999,104,2,102
454935,2,1,104,2,102
454944,1,999,279,18,261
454944,2,1,279,18,261
454953,1,999,54,0,54
454953,2,1,54,0,54
454962,1,999,21,0,21
454962,2,1,21,0,21
454971,1,999,330,10,320
454971,2,1,330,10,320
454980,1,999,127,8,119
454980,2,1,127,8,119
454999,1,999,127,2,125
454999,2,1,127,2,125
455008,1,999,249,12,237
455008,2,1,249,12,237
455017,1,999,37,3,34
455017,2,1,37,3,34
455026,1,999,98,95,3
455026,2,1,98,95,3
455035,1,999,38,27,11
455035,2,1,38,27,11
455053,1,999,186,49,137
455053,2,1,186,49,137
455062,1,999,74,5,69
455062,2,1,74,5,69
455071,1,999,183,35,148
455071,2,1,183,35,148
455080,1,999,260,17,243
455080,2,1,260,17,243
455099,1,999,77,46,31
455099,4,3,77,46,31
455105,1,999,118,3,115
455105,2,1,118,3,115
455114,1,999,9787,4600,5187
455114,2,1,9787,4600,5187
455141,1,999,401,32,369
455141,2,1,401,32,369
455169,1,999,886,431,455
455169,4,3,886,431,455
455178,1,999,62,16,46
455178,4,3,62,16,46
455187,1,999,175,0,175
455187,2,1,175,0,175
455196,1,999,1294,165,1129
455196,2,1,1294,165,1129
455202,1,999,338,64,274
455202,2,1,338,64,274
455211,1,999,186,16,170
455211,2,1,186,16,170
455220,1,999,89,2,87
455220,2,1,89,2,87
455239,1,999,54,2,52
455239,2,1,54,2,52
455248,1,999,16,0,16
455248,2,1,16,0,16
455257,1,999,277,277,0
455257,2,1,277,277,0
455275,1,999,371,30,341
455275,2,1,371,30,341
455284,1,999,430,20,410
455284,2,1,430,20,410
455293,1,999,30,0,30
455293,2,1,30,0,30
455318,1,999,62,7,55
455318,2,1,62,7,55
455327,1,999,82,20,62
455327,2,1,82,20,62
455336,1,999,280,261,19
455336,2,1,280,261,19
455345,1,999,121,4,117
455345,2,1,121,4,117
455354,1,999,388,33,355
455354,2,1,388,33,355
455372,1,999,38,0,38
455372,2,1,38,0,38
455381,1,999,97,1,96
455381,2,1,97,1,96
455390,1,999,431,71,360
455390,2,1,431,71,360
455406,1,999,224,117,107
455406,4,3,224,117,107
455415,1,999,19,4,15
455415,2,1,19,4,15
455424,1,999,679,578,101
455424,2,1,679,578,101
455433,1,999,166,39,127
455433,4,3,166,39,127
455460,1,999,412,87,325
455460,2,1,412,87,325
455479,1,999,1068,107,961
455479,2,1,1068,107,961
455488,1,999,886,226,660
455488,2,1,886,226,660
455497,1,999,261,31,230
455497,2,1,261,31,230
455503,1,999,130,90,40
455503,2,1,130,90,40
455512,1,999,4581,1689,2892
455512,2,1,4581,1689,2892
455530,1,999,1522,776,746
455530,2,1,1522,776,746
455549,1,999,314,40,274
455549,2,1,314,40,274
455558,1,999,476,247,229
455558,2,1,476,247,229
455567,1,999,538,316,222
455567,2,1,538,316,222
455585,1,999,463,102,361
455585,2,1,463,102,361
455600,1,999,1454,437,1017
455600,2,1,1454,437,1017
455619,1,999,660,149,511
455619,2,1,660,149,511
455628,1,999,1409,339,1070
455628,2,1,1409,339,1070
455646,1,999,250,30,220
455646,2,1,250,30,220
455655,1,999,1142,146,996
455655,2,1,1142,146,996
455664,1,999,506,97,409
455664,4,3,506,97,409
455673,1,999,158,6,152
455673,2,1,158,6,152
455682,1,999,326,75,251
455682,4,3,326,75,251
455707,1,999,56,6,50
455707,2,1,56,6,50
455716,1,999,815,178,637
455716,2,1,815,178,637
455725,1,999,232,11,221
455725,2,1,232,11,221
455734,1,999,292,58,234
455734,2,1,292,58,234
455743,1,999,111,24,87
455743,2,1,111,24,87
455752,1,999,51,51,0
455752,2,1,51,51,0
455761,1,999,460,25,435
455761,2,1,460,25,435
455770,1,999,62,21,41
455770,2,1,62,21,41
455789,1,999,25,3,22
455789,2,1,25,3,22
455798,1,999,84,8,76
455798,2,1,84,8,76
455804,1,999,172,115,57
455804,4,3,172,115,57
455813,1,999,73,39,34
455813,4,3,73,39,34
455822,1,999,72,8,64
455822,2,1,72,8,64
455831,1,999,272,23,249
455831,2,1,272,23,249
455840,1,999,250,25,225
455840,2,1,250,25,225
455859,1,999,194,9,185
455859,2,1,194,9,185
455868,1,999,95,70,25
455868,2,1,95,70,25
455877,1,999,272,30,242
455877,2,1,272,30,242
455886,1,999,224,14,210
455886,2,1,224,14,210
455895,1,999,234,4,230
455895,2,1,234,4,230
455901,1,999,333,17,316
455901,2,1,333,17,316
455910,1,999,83,17,66
455910,2,1,83,17,66
455929,1,999,113,14,99
455929,2,1,113,14,99
455938,1,999,26,0,26
455938,2,1,26,0,26
455947,1,999,248,10,238
455947,2,1,248,10,238
455956,1,999,215,84,131
455956,2,1,215,84,131
455965,1,999,245,20,225
455965,2,1,245,20,225
455974,1,999,59,5,54
455974,2,1,59,5,54
455983,1,999,532,197,335
455983,2,1,532,197,335
455992,1,999,340,82,258
455992,4,3,340,82,258
456001,1,999,47,47,0
456001,2,1,47,47,0
456010,1,999,245,99,146
456010,2,1,245,99,146
456029,1,999,241,17,224
456029,2,1,241,17,224
456038,1,999,998,141,857
456038,2,1,998,141,857
456056,1,999,1101,148,953
456056,2,1,1101,148,953
456065,1,999,285,18,267
456065,2,1,285,18,267
456074,1,999,247,17,230
456074,2,1,247,17,230
456092,1,999,156,7,149
456092,2,1,156,7,149
456117,1,999,172,60,112
456117,2,1,172,60,112
456126,1,999,212,17,195
456126,2,1,212,17,195
456135,1,999,243,3,240
456135,2,1,243,3,240
456144,1,999,137,134,3
456144,2,1,137,134,3
456153,1,999,190,171,19
456153,2,1,190,171,19
456171,1,999,41,27,14
456171,4,3,41,27,14
456180,1,999,425,103,322
456180,2,1,425,103,322
456205,1,999,1122,131,991
456205,2,1,1122,131,991
456214,1,999,651,266,385
456214,2,1,651,266,385
456250,1,999,407,10,397
456250,2,1,407,10,397
456278,1,999,1256,237,1019
456278,2,1,1256,237,1019
456287,1,999,220,8,212
456287,2,1,220,8,212
456296,1,999,3762,1740,2022
456296,2,1,3762,1740,2022
456302,1,999,871,475,396
456302,2,1,871,475,396
456311,1,999,846,114,732
456311,2,1,846,114,732
456320,1,999,1286,294,992
456320,2,1,1286,294,992
456339,1,999,947,242,705
456339,2,1,947,242,705
456348,1,999,24129,6102,18027
456348,2,1,17537,4463,13074
456348,4,3,6592,1639,4953
456357,1,999,1168,125,1043
456357,2,1,1168,125,1043
456366,1,999,900,80,820
456366,2,1,900,80,820
456375,1,999,434,41,393
456375,2,1,434,41,393
456393,1,999,485,372,113
456393,2,1,485,372,113
456409,1,999,568,433,135
456409,2,1,568,433,135
456418,1,999,649,392,257
456418,2,1,649,392,257
456427,1,999,654,511,143
456427,2,1,654,511,143
456436,1,999,567,449,118
456436,2,1,567,449,118
456445,1,999,750,561,189
456445,2,1,750,561,189
456454,1,999,420,176,244
456454,2,1,420,176,244
456481,1,999,218,89,129
456481,2,1,118,46,72
456481,4,3,100,43,57
456490,1,999,240,157,83
456490,2,1,177,119,58
456490,4,3,63,38,25
456506,1,999,209,10,199
456506,2,1,209,10,199
456515,1,999,238,16,222
456515,2,1,238,16,222
456542,1,999,169,97,72
456542,4,3,169,97,72
456551,1,999,89,0,89
456551,2,1,89,0,89
456560,1,999,135,70,65
456560,2,1,135,70,65
456588,1,999,73,4,69
456588,2,1,73,4,69
456597,1,999,256,13,243
456597,2,1,256,13,243
456612,1,999,1009,319,690
456612,2,1,1009,319,690
456621,1,999,415,163,252
456621,2,1,356,142,214
456621,4,3,59,21,38
456630,1,999,335,162,173
456630,2,1,269,127,142
456630,4,3,66,35,31
456667,1,999,1497,538,959
456667,2,1,1261,437,824
456667,4,3,236,101,135
456719,1,999,248,8,240
456719,2,1,248,8,240
456728,1,999,126,6,120
456728,2,1,126,6,120
456737,1,999,195,13,182
456737,2,1,195,13,182
456746,1,999,176,8,168
456746,2,1,176,8,168
456755,1,999,102,11,91
456755,2,1,102,11,91
456764,1,999,249,11,238
456764,2,1,249,11,238
456773,1,999,144,7,137
456773,2,1,144,7,137
456782,1,999,746,202,544
456782,2,1,746,202,544
456791,1,999,1272,249,1023
456791,2,1,1272,249,1023
456807,1,999,541,107,434
456807,2,1,538,105,433
456807,4,3,3,2,1
456816,1,999,990,223,767
456816,2,1,978,216,762
456816,4,3,12,7,5
456825,1,999,180,16,164
456825,2,1,180,16,164
456834,1,999,394,201,193
456834,2,1,278,129,149
456834,4,3,116,72,44
456852,1,999,1149,302,847
456852,2,1,1149,302,847
456861,1,999,1431,315,1116
456861,2,1,1431,315,1116
456870,1,999,1716,786,930
456870,2,1,1716,786,930
456889,1,999,845,172,673
456889,2,1,845,172,673
456898,1,999,1091,698,393
456898,2,1,1091,698,393
456904,1,999,1180,559,621
456904,2,1,1180,559,621
456913,1,999,1101,158,943
456913,2,1,1101,158,943
456922,1,999,1648,512,1136
456922,2,1,1648,512,1136
456931,1,999,1983,1226,757
456931,2,1,1983,1226,757
456940,1,999,675,382,293
456940,2,1,675,382,293
456959,1,999,150,44,106
456959,2,1,150,44,106
456968,1,999,62,4,58
456968,2,1,62,4,58
456977,1,999,467,52,415
456977,2,1,467,52,415
456995,1,999,302,167,135
456995,2,1,302,167,135
457004,1,999,235,64,171
457004,2,1,235,64,171
457013,1,999,449,67,382
457013,2,1,449,67,382
457022,1,999,504,119,385
457022,2,1,504,119,385
457031,1,999,84,2,82
457031,2,1,84,2,82
457068,1,999,300,2,298
457068,2,1,300,2,298
457077,1,999,550,37,513
457077,2,1,550,37,513
457086,1,999,242,46,196
457086,2,1,242,46,196
457101,1,999,383,127,256
457101,2,1,383,127,256
457110,1,999,313,53,260
457110,2,1,313,53,260
457129,1,999,230,30,200
457129,2,1,230,30,200
457174,1,999,677,32,645
457174,2,1,677,32,645
457183,1,999,133,19,114
457183,2,1,133,19,114
457192,1,999,36,20,16
457192,2,1,36,20,16
457208,1,999,199,80,119
457208,2,1,199,80,119
457217,1,999,69,68,1
457217,2,1,69,68,1
457226,1,999,109,67,42
457226,2,1,109,67,42
457235,1,999,55,29,26
457235,2,1,55,29,26
457244,1,999,156,71,85
457244,2,1,156,71,85
457253,1,999,78,4,74
457253,2,1,78,4,74
457262,1,999,235,49,186
457262,2,1,235,49,186
457271,1,999,61,20,41
457271,4,3,61,20,41
457280,1,999,431,11,420
457280,2,1,431,11,420
457299,1,999,179,45,134
457299,2,1,179,45,134
457305,1,999,75,62,13
457305,2,1,75,62,13
457314,1,999,146,38,108
457314,2,1,146,38,108
457323,1,999,395,14,381
457323,2,1,395,14,381
457332,1,999,36,1,35
457332,2,1,36,1,35
457341,1,999,170,8,162
457341,2,1,170,8,162
457350,1,999,53,1,52
457350,2,1,53,1,52
457378,1,999,149,28,121
457378,2,1,149,28,121
457387,1,999,406,189,217
457387,2,1,406,189,217
457396,1,999,99,29,70
457396,2,1,99,29,70
457402,1,999,77,26,51
457402,2,1,57,15,42
457402,4,3,20,11,9
457411,1,999,261,253,8
457411,2,1,261,253,8
457420,1,999,203,20,183
457420,2,1,203,20,183
457439,1,999,103,7,96
457439,2,1,103,7,96
457448,1,999,173,14,159
457448,2,1,173,14,159
457457,1,999,28,3,25
457457,2,1,28,3,25
457466,1,999,86,76,10
457466,2,1,86,76,10
457475,1,999,158,7,151
457475,2,1,158,7,151
457484,1,999,140,79,61
457484,2,1,119,67,52
457484,4,3,21,12,9
457493,1,999,40,4,36
457493,2,1,40,4,36
457509,1,999,58,2,56
457509,2,1,58,2,56
457527,1,999,317,49,268
457527,2,1,317,49,268
457536,1,999,348,92,256
457536,2,1,348,92,256
457545,1,999,218,11,207
457545,2,1,218,11,207
457554,1,999,43,4,39
457554,2,1,43,4,39
457563,1,999,192,9,183
457563,2,1,192,9,183
457572,1,999,191,9,182
457572,2,1,191,9,182
457581,1,999,220,8,212
457581,2,1,220,8,212
457590,1,999,33,2,31
457590,2,1,33,2,31
457606,1,999,166,24,142
457606,2,1,166,24,142
457615,1,999,46,6,40
457615,2,1,46,6,40
457624,1,999,25,1,24
457624,2,1,25,1,24
457633,1,999,142,8,134
457633,2,1,142,8,134
457642,1,999,104,4,100
457642,2,1,104,4,100
457651,1,999,224,56,168
457651,2,1,224,56,168
457660,1,999,59,2,57
457660,2,1,59,2,57
457679,1,999,39,0,39
457679,2,1,39,0,39
457688,1,999,405,272,133
457688,2,1,405,272,133
457697,1,999,78,37,41
457697,2,1,78,37,41
457703,1,999,168,77,91
457703,2,1,168,77,91
457712,1,999,38,6,32
457712,2,1,38,6,32
457721,1,999,35,1,34
457721,2,1,35,1,34
457730,1,999,372,41,331
457730,2,1,372,41,331
457749,1,999,161,4,157
457749,2,1,161,4,157
457758,1,999,187,165,22
457758,2,1,187,165,22
457767,1,999,338,36,302
457767,2,1,338,36,302
457776,1,999,140,13,127
457776,2,1,140,13,127
457785,1,999,148,4,144
457785,2,1,148,4,144
457794,1,999,88,16,72
457794,2,1,88,16,72
457800,1,999,1375,415,960
457800,2,1,1375,415,960
457819,1,999,751,277,474
457819,2,1,751,277,474
457828,1,999,239,93,146
457828,2,1,239,93,146
457837,1,999,154,10,144
457837,2,1,154,10,144
457846,1,999,98,16,82
457846,2,1,98,16,82
457855,1,999,177,11,166
457855,2,1,177,11,166
457864,1,999,120,31,89
457864,2,1,120,31,89
457873,1,999,307,165,142
457873,2,1,307,165,142
457891,1,999,52,2,50
457891,2,1,52,2,50
457907,1,999,97,60,37
457907,2,1,97,60,37
457916,1,999,163,4,159
457916,2,1,163,4,159
457925,1,999,27,12,15
457925,2,1,27,12,15
457943,1,999,43,9,34
457943,2,1,43,9,34
457952,1,999,323,18,305
457952,2,1,323,18,305
457961,1,999,59,1,58
457961,2,1,59,1,58
457970,1,999,20,0,20
457970,2,1,20,0,20
457989,1,999,59,5,54
457989,2,1,59,5,54
457998,1,999,49,1,48
457998,2,1,49,1,48
458007,1,999,102,6,96
458007,2,1,102,6,96
458016,1,999,95,81,14
458016,2,1,95,81,14
458025,1,999,12,5,7
458025,2,1,12,5,7
458034,1,999,80,30,50
458034,2,1,80,30,50
458043,1,999,203,10,193
458043,2,1,203,10,193
458052,1,999,116,7,109
458052,2,1,116,7,109
458061,1,999,146,30,116
458061,2,1,146,30,116
458070,1,999,375,27,348
458070,2,1,375,27,348
458089,1,999,50,1,49
458089,2,1,50,1,49
458098,1,999,182,9,173
458098,2,1,182,9,173
458104,1,999,112,3,109
458104,2,1,112,3,109
458113,1,999,80,35,45
458113,2,1,80,35,45
458122,1,999,36,0,36
458122,2,1,36,0,36
458131,1,999,478,28,450
458131,2,1,478,28,450
458140,1,999,79,69,10
458140,2,1,79,69,10
458159,1,999,226,107,119
458159,4,3,226,107,119
458168,1,999,150,9,141
458168,2,1,150,9,141
458177,1,999,119,9,110
458177,2,1,119,9,110
458186,1,999,544,140,404
458186,2,1,544,140,404
458195,1,999,132,70,62
458195,2,1,132,70,62
458210,1,999,1449,335,1114
458210,2,1,1449,335,1114
458229,1,999,981,267,714
458229,2,1,981,267,714
458238,1,999,149,42,107
458238,2,1,149,42,107
458247,1,999,402,47,355
458247,2,1,402,47,355
458256,1,999,1612,179,1433
458256,2,1,1612,179,1433
458265,1,999,1014,414,600
458265,2,1,1014,414,600
458274,1,999,550,50,500
458274,2,1,550,50,500
458283,1,999,963,203,760
458283,2,1,963,203,760
458292,1,999,113,3,110
458292,2,1,113,3,110
458308,1,999,56,3,53
458308,2,1,56,3,53
458317,1,999,120,3,117
458317,2,1,120,3,117
458326,1,999,102,6,96
458326,2,1,102,6,96
458335,1,999,216,14,202
458335,2,1,216,14,202
458344,1,999,158,10,148
458344,2,1,158,10,148
458353,1,999,123,10,113
458353,2,1,123,10,113
458362,1,999,174,8,166
458362,2,1,174,8,166
458371,1,999,624,330,294
458371,2,1,624,330,294
458380,1,999,665,112,553
458380,2,1,665,112,553
458399,1,999,58,4,54
458399,2,1,58,4,54
458405,1,999,1237,170,1067
458405,2,1,1237,170,1067
458414,1,999,2866,1117,1749
458414,2,1,2866,1117,1749
458423,1,999,111,37,74
458423,2,1,111,37,74
458432,1,999,280,63,217
458432,2,1,280,63,217
458441,1,999,672,94,578
458441,2,1,672,94,578
458469,1,999,954,220,734
458469,2,1,954,220,734
458478,1,999,820,162,658
458478,2,1,820,162,658
458487,1,999,272,22,250
458487,2,1,272,22,250
458496,1,999,431,191,240
458496,2,1,431,191,240
458502,1,999,660,126,534
458502,2,1,660,126,534
458511,1,999,52,24,28
458511,4,3,52,24,28
458557,1,999,841,89,752
458557,2,1,841,89,752
458593,1,999,621,69,552
458593,2,1,621,69,552
458609,1,999,1237,128,1109
458609,2,1,1237,128,1109
458618,1,999,886,77,809
458618,2,1,886,77,809
458627,1,999,750,50,700
458627,2,1,750,50,700
458636,1,999,554,52,502
458636,2,1,554,52,502
458645,1,999,516,34,482
458645,2,1,516,34,482
458654,1,999,1039,189,850
458654,2,1,1039,189,850
458663,1,999,1048,107,941
458663,2,1,1048,107,941
458672,1,999,32,14,18
458672,2,1,32,14,18
458681,1,999,242,108,134
458681,2,1,242,108,134
458690,1,999,854,177,677
458690,2,1,854,177,677
458706,1,999,750,38,712
458706,2,1,750,38,712
458715,1,999,193,69,124
458715,2,1,193,69,124
458733,1,999,465,117,348
458733,2,1,465,117,348
458742,1,999,367,127,240
458742,2,1,367,127,240
458751,1,999,328,50,278
458751,2,1,328,50,278
458760,1,999,475,102,373
458760,2,1,469,98,371
458760,4,3,6,4,2
458779,1,999,536,99,437
458779,2,1,536,99,437
458797,1,999,612,62,550
458797,2,1,612,62,550
458803,1,999,268,15,253
458803,2,1,268,15,253
458812,1,999,137,11,126
458812,2,1,137,11,126
458821,1,999,157,31,126
458821,2,1,157,31,126
458830,1,999,285,17,268
458830,2,1,285,17,268
458849,1,999,103,7,96
458849,2,1,103,7,96
458858,1,999,176,7,169
458858,2,1,176,7,169
458867,1,999,174,8,166
458867,2,1,174,8,166
458885,1,999,542,148,394
458885,2,1,448,119,329
458885,4,3,94,29,65
458919,1,999,10302,2852,7450
458919,2,1,7614,2166,5448
458919,4,3,2688,686,2002
458937,1,999,308,92,216
458937,2,1,268,77,191
458937,4,3,40,15,25
458955,1,999,427,101,326
458955,2,1,364,84,280
458955,4,3,63,17,46
458964,1,999,5027,1498,3529
458964,2,1,3538,1115,2423
458964,4,3,1489,383,1106
458973,1,999,865,344,521
458973,2,1,710,284,426
458973,4,3,155,60,95
458982,1,999,481,233,248
458982,2,1,481,233,248
458991,1,999,722,179,543
458991,2,1,722,179,543
459000,1,999,312,32,280
459000,2,1,312,32,280
459019,1,999,263,18,245
459019,2,1,263,18,245
459028,1,999,134,13,121
459028,2,1,134,13,121
459037,1,999,254,17,237
459037,2,1,254,17,237
459046,1,999,183,17,166
459046,2,1,183,17,166
459055,1,999,86,11,75
459055,2,1,86,11,75
459064,1,999,249,20,229
459064,2,1,249,20,229
459073,1,999,126,12,114
459073,2,1,126,12,114
459091,1,999,72,44,28
459091,2,1,72,44,28
459107,1,999,556,106,450
459107,2,1,556,106,450
459116,1,999,263,17,246
459116,2,1,263,17,246
459125,1,999,51,3,48
459125,2,1,51,3,48
459134,1,999,58,0,58
459134,2,1,58,0,58
459143,1,999,86,7,79
459143,2,1,86,7,79
459152,1,999,308,118,190
459152,2,1,308,118,190
459161,1,999,514,170,344
459161,2,1,514,170,344
459170,1,999,128,4,124
459170,2,1,128,4,124
459189,1,999,131,22,109
459189,2,1,131,22,109
459198,1,999,207,14,193
459198,2,1,207,14,193
459204,1,999,571,128,443
459204,2,1,571,128,443
459213,1,999,568,85,483
459213,2,1,568,85,483
459222,1,999,89,43,46
459222,4,3,89,43,46
459231,1,999,412,24,388
459231,2,1,412,24,388
459259,1,999,790,99,691
459259,2,1,684,80,604
459259,4,3,106,19,87
459268,1,999,516,126,390
459268,2,1,416,114,302
459268,4,3,100,12,88
459277,1,999,331,15,316
459277,2,1,331,15,316
459286,1,999,335,37,298
459286,2,1,335,37,298
459295,1,999,170,9,161
459295,2,1,170,9,161
459301,1,999,205,10,195
459301,2,1,205,10,195
459310,1,999,57,18,39
459310,2,1,57,18,39
459329,1,999,222,94,128
459329,2,1,222,94,128
459338,1,999,86,20,66
459338,2,1,86,20,66
459347,1,999,129,17,112
459347,2,1,129,17,112
459356,1,999,161,32,129
459356,2,1,161,32,129
459365,1,999,50,1,49
459365,2,1,50,1,49
459374,1,999,55,4,51
459374,2,1,55,4,51
459392,1,999,174,10,164
459392,2,1,174,10,164
459408,1,999,70,6,64
459408,2,1,70,6,64
459417,1,999,33,27,6
459417,2,1,33,27,6
459426,1,999,113,11,102
459426,2,1,113,11,102
459435,1,999,64,64,0
459435,2,1,64,64,0
459444,1,999,105,2,103
459444,2,1,105,2,103
459453,1,999,132,13,119
459453,2,1,132,13,119
459462,1,999,331,297,34
459462,2,1,331,297,34
459471,1,999,48,2,46
459471,2,1,48,2,46
459480,1,999,61,1,60
459480,2,1,61,1,60
459499,1,999,22,4,18
459499,2,1,22,4,18
459514,1,999,39,2,37
459514,2,1,39,2,37
459523,1,999,80,20,60
459523,2,1,80,20,60
459532,1,999,176,6,170
459532,2,1,176,6,170
459541,1,999,77,1,76
459541,2,1,77,1,76
459550,1,999,197,4,193
459550,2,1,197,4,193
459569,1,999,20,1,19
459569,2,1,20,1,19
459578,1,999,250,9,241
459578,2,1,250,9,241
459587,1,999,540,287,253
459587,2,1,540,287,253
459596,1,999,711,399,312
459596,2,1,711,399,312
459602,1,999,433,291,142
459602,2,1,433,291,142
459611,1,999,418,335,83
459611,2,1,418,335,83
459620,1,999,273,208,65
459620,2,1,273,208,65
459639,1,999,626,536,90
459639,2,1,626,536,90
459648,1,999,369,267,102
459648,2,1,369,267,102
459657,1,999,456,323,133
459657,2,1,456,323,133
459666,1,999,393,318,75
459666,2,1,393,318,75
459675,1,999,532,440,92
459675,2,1,532,440,92
459684,1,999,735,537,198
459684,2,1,735,537,198
459693,1,999,551,403,148
459693,2,1,551,403,148
459709,1,999,1026,738,288
459709,2,1,1026,738,288
459718,1,999,892,678,214
459718,2,1,892,678,214
459727,1,999,171,81,90
459727,2,1,118,57,61
459727,4,3,53,24,29
459736,1,999,1501,570,931
459736,4,3,1501,570,931
459745,1,999,72,15,57
459745,4,3,72,15,57
459815,1,999,230,51,179
459815,2,1,230,51,179
459824,1,999,1994,748,1246
459824,2,1,157,36,121
459824,4,3,1837,712,1125
459833,1,999,131,35,96
459833,2,1,131,35,96
459842,1,999,478,100,378
459842,2,1,478,100,378
459851,1,999,156,47,109
459851,2,1,156,47,109
459860,1,999,498,84,414
459860,2,1,498,84,414
459879,1,999,299,135,164
459879,2,1,299,135,164
459888,1,999,341,90,251
459888,2,1,341,90,251
459897,1,999,162,81,81
459897,2,1,162,81,81
459903,1,999,280,79,201
459903,2,1,280,79,201
459912,1,999,304,102,202
459912,2,1,304,102,202
459921,1,999,187,38,149
459921,2,1,187,38,149
459930,1,999,774,182,592
459930,2,1,774,182,592
459958,1,999,1010,133,877
459958,2,1,1010,133,877
459967,1,999,333,40,293
459967,2,1,333,40,293
459976,1,999,222,17,205
459976,2,1,222,17,205
459985,1,999,378,68,310
459985,2,1,378,68,310
459994,1,999,7838,2608,5230
459994,2,1,6156,2132,4024
459994,4,3,1682,476,1206
460002,1,999,93,14,79
460002,2,1,93,14,79
460011,1,999,207,6,201
460011,2,1,207,6,201
460020,1,999,338,138,200
460020,2,1,338,138,200
460039,1,999,709,204,505
460039,2,1,709,204,505
460048,1,999,580,146,434
460048,2,1,580,146,434
460057,1,999,37,2,35
460057,2,1,37,2,35
460066,1,999,166,9,157
460066,2,1,166,9,157
460075,1,999,190,128,62
460075,2,1,40,24,16
460075,4,3,150,104,46
460093,1,999,368,20,348
460093,2,1,368,20,348
460109,1,999,316,12,304
460109,2,1,316,12,304
460118,1,999,289,18,271
460118,2,1,289,18,271
460127,1,999,108,6,102
460127,2,1,108,6,102
460136,1,999,198,61,137
460136,2,1,198,61,137
460145,1,999,221,145,76
460145,2,1,221,145,76
460172,1,999,74,69,5
460172,2,1,74,69,5
460181,1,999,261,27,234
460181,2,1,261,27,234
460190,1,999,286,39,247
460190,2,1,286,39,247
460206,1,999,413,64,349
460206,2,1,413,64,349
460215,1,999,350,324,26
460215,2,1,350,324,26
460330,1,999,252,69,183
460330,2,1,252,69,183
460349,1,999,65,26,39
460349,2,1,65,26,39
460358,1,999,743,88,655
460358,2,1,743,88,655
460367,1,999,360,72,288
460367,2,1,360,72,288
460385,1,999,67,11,56
460385,2,1,67,11,56
460394,1,999,18607,9477,9130
460394,2,1,18607,9477,9130
460446,1,999,466,37,429
460446,2,1,466,37,429
460455,1,999,94,23,71
460455,2,1,94,23,71
460464,1,999,15659,6941,8718
460464,2,1,15659,6941,8718
460473,1,999,252,66,186
460473,2,1,252,66,186
460482,1,999,415,36,379
460482,2,1,415,36,379
460491,1,999,101,11,90
460491,2,1,101,11,90
460507,1,999,105,3,102
460507,2,1,105,3,102
460516,1,999,199,11,188
460516,2,1,199,11,188
460525,1,999,183,24,159
460525,2,1,183,24,159
460534,1,999,222,16,206
460534,2,1,222,16,206
460552,1,999,132,28,104
460552,2,1,132,28,104
460561,1,999,25,2,23
460561,2,1,25,2,23
460570,1,999,277,39,238
460570,2,1,277,39,238
460589,1,999,567,24,543
460589,2,1,567,24,543
460598,1,999,795,109,686
460598,2,1,795,109,686
460604,1,999,26,24,2
460604,2,1,26,24,2
460613,1,999,324,102,222
460613,2,1,324,102,222
460631,1,999,273,31,242
460631,2,1,273,31,242
460640,1,999,152,42,110
460640,2,1,152,42,110
460659,1,999,145,9,136
460659,2,1,145,9,136
460668,1,999,128,32,96
460668,2,1,128,32,96
460677,1,999,361,109,252
460677,2,1,361,109,252
460686,1,999,502,114,388
460686,2,1,502,114,388
460695,1,999,176,19,157
460695,2,1,176,19,157
460701,1,999,188,64,124
460701,2,1,188,64,124
460710,1,999,260,20,240
460710,2,1,260,20,240
460729,1,999,1477,1088,389
460729,2,1,1477,1088,389
460738,1,999,2151,848,1303
460738,2,1,1407,618,789
460738,4,3,744,230,514
460747,1,999,601,527,74
460747,2,1,601,527,74
460756,1,999,310,34,276
460756,2,1,310,34,276
460765,1,999,56,8,48
460765,2,1,56,8,48
460774,1,999,514,41,473
460774,2,1,514,41,473
460783,1,999,258,49,209
460783,2,1,258,49,209
460808,1,999,54,10,44
460808,2,1,54,10,44
460817,1,999,681,64,617
460817,2,1,681,64,617
460826,1,999,257,37,220
460826,2,1,257,37,220
460835,1,999,797,52,745
460835,2,1,797,52,745
460844,1,999,329,53,276
460844,2,1,329,53,276
460853,1,999,491,31,460
460853,2,1,491,31,460
460862,1,999,310,18,292
460862,2,1,310,18,292
460871,1,999,126,18,108
460871,2,1,126,18,108
460899,1,999,1179,453,726
460899,2,1,1179,453,726
460905,1,999,97,0,97
460905,2,1,97,0,97
460914,1,999,286,15,271
460914,2,1,286,15,271
460923,1,999,322,72,250
460923,2,1,322,72,250
460932,1,999,53,0,53
460932,2,1,53,0,53
460941,1,999,30,4,26
460941,4,3,30,4,26
460950,1,999,110,21,89
460950,2,1,110,21,89
460969,1,999,173,46,127
460969,2,1,173,46,127
460978,1,999,381,30,351
460978,2,1,381,30,351
460987,1,999,47,3,44
460987,2,1,47,3,44
460996,1,999,140,5,135
460996,2,1,140,5,135
461005,1,999,97,15,82
461005,2,1,97,15,82
461014,1,999,861,86,775
461014,2,1,861,86,775
461023,1,999,946,424,522
461023,2,1,946,424,522
461032,1,999,123,63,60
461032,2,1,123,63,60
461041,1,999,73,12,61
461041,2,1,73,12,61
461111,1,999,33,29,4
461111,2,1,33,29,4
461120,1,999,110,68,42
461120,4,3,110,68,42
461139,1,999,82,25,57
461139,4,3,82,25,57
461148,1,999,1273,723,550
461148,2,1,480,311,169
461148,4,3,793,412,381
461157,1,999,45,43,2
461157,2,1,45,43,2
461166,1,999,50,20,30
461166,2,1,50,20,30
461175,1,999,238,40,198
461175,2,1,238,40,198
461184,1,999,14,13,1
461184,2,1,14,13,1
461193,1,999,87,3,84
461193,2,1,87,3,84
461209,1,999,932,144,788
461209,2,1,932,144,788
461218,1,999,11,3,8
461218,2,1,11,3,8
461227,1,999,154,7,147
461227,2,1,154,7,147
461236,1,999,329,143,186
461236,2,1,217,96,121
461236,4,3,112,47,65
461245,1,999,562,160,402
461245,2,1,562,160,402
461254,1,999,35,9,26
461254,2,1,35,9,26
461263,1,999,64,23,41
461263,2,1,64,23,41
461272,1,999,62,0,62
461272,2,1,62,0,62
461281,1,999,106,14,92
461281,2,1,98,14,84
461281,4,3,8,0,8
461290,1,999,84,0,84
461290,2,1,84,0,84
461306,1,999,124,65,59
461306,2,1,124,65,59
461315,1,999,88,26,62
461315,2,1,88,26,62
461324,1,999,343,148,195
461324,2,1,343,148,195
461333,1,999,16,15,1
461333,2,1,16,15,1
461342,1,999,69,0,69
461342,2,1,69,0,69
461351,1,999,1674,312,1362
461351,2,1,1674,312,1362
461360,1,999,47,0,47
461360,2,1,47,0,47
461379,1,999,23,2,21
461379,2,1,23,2,21
461388,1,999,53,3,50
461388,2,1,53,3,50
461397,1,999,434,75,359
461397,2,1,434,75,359
461403,1,999,35,5,30
461403,2,1,35,5,30
461412,1,999,99,31,68
461412,2,1,99,31,68
461421,1,999,337,24,313
461421,2,1,337,24,313
461430,1,999,244,241,3
461430,2,1,244,241,3
461449,1,999,93,16,77
461449,2,1,93,16,77
461458,1,999,46,4,42
461458,2,1,46,4,42
461467,1,999,22,2,20
461467,2,1,22,2,20
461476,1,999,46,24,22
461476,2,1,46,24,22
461485,1,999,83,68,15
461485,2,1,9,8,1
461485,4,3,74,60,14
461494,1,999,114,2,112
461494,2,1,114,2,112
461500,1,999,45,1,44
461500,2,1,45,1,44
461519,1,999,44,10,34
461519,2,1,44,10,34
461528,1,999,136,92,44
461528,2,1,136,92,44
461537,1,999,23,0,23
461537,2,1,23,0,23
461546,1,999,74,1,73
461546,2,1,74,1,73
461555,1,999,100,5,95
461555,2,1,100,5,95
461564,1,999,41,27,14
461564,2,1,41,27,14
461573,1,999,162,160,2
461573,2,1,162,160,2
461582,1,999,151,3,148
461582,2,1,151,3,148
461591,1,999,145,14,131
461591,2,1,145,14,131
461607,1,999,86,2,84
461607,2,1,86,2,84
461616,1,999,52,0,52
461616,2,1,52,0,52
461625,1,999,41,39,2
461625,2,1,41,39,2
461634,1,999,674,399,275
461634,2,1,674,399,275
461643,1,999,31,4,27
461643,2,1,15,2,13
461643,4,3,16,2,14
461652,1,999,48,6,42
461652,2,1,48,6,42
461661,1,999,148,31,117
461661,2,1,148,31,117
461670,1,999,39,10,29
461670,2,1,39,10,29
461689,1,999,40,2,38
461689,2,1,40,2,38
461698,1,999,84,71,13
461698,2,1,84,71,13
461704,1,999,156,4,152
461704,2,1,156,4,152
461713,1,999,38,3,35
461713,2,1,38,3,35
461722,1,999,92,5,87
461722,2,1,92,5,87
461731,1,999,91,1,90
461731,2,1,91,1,90
461740,1,999,36,28,8
461740,2,1,36,28,8
461759,1,999,125,65,60
461759,2,1,125,65,60
461768,1,999,132,6,126
461768,2,1,132,6,126
461777,1,999,26,6,20
461777,2,1,26,6,20
461786,1,999,45,0,45
461786,2,1,45,0,45
461795,1,999,22,9,13
461795,2,1,22,9,13
461801,1,999,40,1,39
461801,2,1,40,1,39
461810,1,999,87,15,72
461810,2,1,87,15,72
461829,1,999,212,12,200
461829,2,1,212,12,200
461838,1,999,117,0,117
461838,2,1,117,0,117
461847,1,999,46,46,0
461847,2,1,46,46,0
461856,1,999,54,20,34
461856,2,1,54,20,34
461865,1,999,230,58,172
461865,2,1,230,58,172
461874,1,999,27,4,23
461874,2,1,27,4,23
461883,1,999,59,35,24
461883,2,1,44,24,20
461883,4,3,15,11,4
461892,1,999,84,14,70
461892,2,1,84,14,70
461908,1,999,145,6,139
461908,2,1,145,6,139
461917,1,999,228,15,213
461917,2,1,228,15,213
461926,1,999,147,4,143
461926,2,1,147,4,143
461935,1,999,20,0,20
461935,2,1,20,0,20
461944,1,999,60,1,59
461944,2,1,60,1,59
461953,1,999,24,4,20
461953,2,1,24,4,20
461962,1,999,127,61,66
461962,2,1,127,61,66
461971,1,999,36,4,32
461971,2,1,36,4,32
461980,1,999,171,5,166
461980,2,1,171,5,166
461999,1,999,49,2,47
461999,2,1,49,2,47
462008,1,999,200,17,183
462008,2,1,200,17,183
462017,1,999,132,4,128
462017,2,1,132,4,128
462026,1,999,18,2,16
462026,2,1,18,2,16
462035,1,999,136,34,102
462035,2,1,136,34,102
462044,1,999,34,6,28
462044,4,3,34,6,28
462062,1,999,44,3,41
462062,2,1,44,3,41
462071,1,999,213,9,204
462071,2,1,213,9,204
462080,1,999,166,87,79
462080,4,3,166,87,79
462099,1,999,583,206,377
462099,4,3,583,206,377
462105,1,999,1747,821,926
462105,4,3,1747,821,926
462114,1,999,1270,634,636
462114,4,3,1270,634,636
462123,1,999,493,167,326
462123,4,3,493,167,326
462132,1,999,208,104,104
462132,4,3,208,104,104
462141,1,999,486,246,240
462141,4,3,486,246,240
462150,1,999,327,174,153
462150,4,3,327,174,153
462169,1,999,118,53,65
462169,4,3,118,53,65
462178,1,999,141,89,52
462178,4,3,141,89,52
462187,1,999,311,99,212
462187,4,3,311,99,212
462196,1,999,15,8,7
462196,4,3,15,8,7
462202,1,999,14,5,9
462202,4,3,14,5,9
462211,1,999,294,137,157
462211,4,3,294,137,157
462220,1,999,179,96,83
462220,4,3,179,96,83
462239,1,999,26,10,16
462239,2,1,26,10,16
462257,1,999,25,7,18
462257,2,1,25,7,18
462293,1,999,515,121,394
462293,2,1,515,121,394
462309,1,999,109,18,91
462309,2,1,109,18,91
462318,1,999,122,70,52
462318,2,1,122,70,52
462327,1,999,50,0,50
462327,2,1,50,0,50
462336,1,999,7,0,7
462336,2,1,7,0,7
462345,1,999,76,0,76
462345,2,1,76,0,76
462354,1,999,219,128,91
462354,2,1,170,98,72
462354,4,3,49,30,19
462390,1,999,19,3,16
462390,2,1,19,3,16
463621,1,999,660,90,570
463621,2,1,660,90,570
465812,1,999,859,306,553
465812,2,1,806,278,528
465812,4,3,53,28,25
466152,1,999,77,12,65
466152,2,1,77,12,65
466161,1,999,96,25,71
466161,2,1,96,25,71
466170,1,999,429,80,349
466170,2,1,429,80,349
466189,1,999,149,49,100
466189,2,1,149,49,100
466514,1,999,162,26,136
466514,2,1,162,26,136
466921,1,999,10252,799,9453
466921,2,1,10252,799,9453
466930,1,999,29,5,24
466930,2,1,29,5,24
467058,1,999,141,119,22
467058,2,1,141,119,22
467094,1,999,385,16,369
467094,2,1,385,16,369
467155,1,999,315,43,272
467155,2,1,315,43,272
467340,1,999,193,187,6
467340,2,1,193,187,6
467368,1,999,101,13,88
467368,2,1,101,13,88
467508,1,999,104,5,99
467508,2,1,104,5,99
467517,1,999,146,8,138
467517,2,1,146,8,138
467526,1,999,171,9,162
467526,2,1,171,9,162
467535,1,999,210,25,185
467535,2,1,210,25,185
467544,1,999,63,6,57
467544,2,1,63,6,57
467553,1,999,161,11,150
467553,2,1,161,11,150
467562,1,999,105,10,95
467562,2,1,105,10,95
467571,1,999,124,5,119
467571,2,1,124,5,119
467580,1,999,41,4,37
467580,2,1,41,4,37
467599,1,999,79,6,73
467599,2,1,79,6,73
467605,1,999,104,6,98
467605,2,1,104,6,98
467614,1,999,126,5,121
467614,2,1,126,5,121
467623,1,999,130,5,125
467623,2,1,130,5,125
467632,1,999,121,3,118
467632,2,1,121,3,118
467641,1,999,190,7,183
467641,2,1,190,7,183
467650,1,999,129,10,119
467650,2,1,129,10,119
467669,1,999,72,8,64
467669,2,1,72,8,64
467678,1,999,74,4,70
467678,2,1,74,4,70
467784,1,999,316,44,272
467784,2,1,316,44,272
467793,1,999,80,23,57
467793,2,1,80,23,57
467809,1,999,126,11,115
467809,2,1,126,11,115
467863,1,999,177,15,162
467863,2,1,177,15,162
467872,1,999,112,13,99
467872,2,1,112,13,99
467881,1,999,223,17,206
467881,2,1,223,17,206
467906,1,999,108,3,105
467906,2,1,108,3,105
468006,1,999,99,45,54
468006,4,3,99,45,54
468015,1,999,364,158,206
468015,2,1,364,158,206
468024,1,999,161,42,119
468024,2,1,127,27,100
468024,4,3,34,15,19
468246,1,999,182,10,172
468246,2,1,182,10,172
468255,1,999,122,9,113
468255,2,1,122,9,113
468705,1,999,89,22,67
468705,2,1,89,22,67
468732,1,999,39,5,34
468732,2,1,39,5,34
468769,1,999,225,99,126
468769,2,1,225,99,126
468875,1,999,186,7,179
468875,2,1,186,7,179
468893,1,999,73,5,68
468893,2,1,73,5,68
469054,1,999,36,5,31
469054,2,1,36,5,31
469124,1,999,870,285,585
469124,2,1,870,285,585
469133,1,999,842,225,617
469133,2,1,842,225,617
469142,1,999,895,228,667
469142,2,1,895,228,667
469151,1,999,613,167,446
469151,2,1,613,167,446
469160,1,999,522,144,378
469160,2,1,522,144,378
469188,1,999,244,44,200
469188,2,1,244,44,200
469197,1,999,159,5,154
469197,2,1,159,5,154
469391,1,999,281,127,154
469391,2,1,281,127,154
469407,1,999,607,243,364
469407,2,1,607,243,364
469416,1,999,663,265,398
469416,2,1,663,265,398
469568,1,999,236,33,203
469568,2,1,236,33,203
469586,1,999,334,85,249
469586,2,1,334,85,249
469610,1,999,882,38,844
469610,2,1,882,38,844
469629,1,999,196,187,9
469629,2,1,196,187,9
469638,1,999,61,39,22
469638,2,1,61,39,22
469647,1,999,520,90,430
469647,2,1,520,90,430
469911,1,999,445,52,393
469911,2,1,445,52,393
469920,1,999,416,33,383
469920,2,1,416,33,383
469957,1,999,212,16,196
469957,2,1,212,16,196
469975,1,999,75,19,56
469975,2,1,75,19,56
469993,1,999,57,3,54
469993,2,1,57,3,54
470047,1,999,66,16,50
470047,2,1,66,16,50
470092,1,999,254,118,136
470092,2,1,254,118,136
470162,1,999,203,42,161
470162,2,1,203,42,161
470223,1,999,20,0,20
470223,2,1,20,0,20
470269,1,999,859,531,328
470269,2,1,859,531,328
470296,1,999,23,5,18
470296,2,1,23,5,18
470393,1,999,30,1,29
470393,2,1,30,1,29
470852,1,999,144,121,23
470852,2,1,144,121,23
470861,1,999,202,171,31
470861,2,1,202,171,31
470870,1,999,85,78,7
470870,2,1,85,78,7
470889,1,999,228,188,40
470889,2,1,228,188,40
470898,1,999,185,120,65
470898,2,1,185,120,65
470904,1,999,56,45,11
470904,2,1,56,45,11
474872,1,999,481,216,265
474872,2,1,481,216,265
474881,1,999,11,11,0
474881,2,1,11,11,0
474890,1,999,470,116,354
474890,2,1,470,116,354
474915,1,999,388,34,354
474915,2,1,388,34,354
474924,1,999,164,4,160
474924,2,1,164,4,160
474933,1,999,130,10,120
474933,2,1,130,10,120
474942,1,999,161,11,150
474942,2,1,161,11,150
474997,1,999,908,389,519
474997,2,1,908,389,519
475015,1,999,220,11,209
475015,2,1,220,11,209
475024,1,999,148,48,100
475024,2,1,148,48,100
475051,1,999,17,2,15
475051,2,1,17,2,15
475060,1,999,120,19,101
475060,2,1,120,19,101
475079,1,999,40,8,32
475079,2,1,40,8,32
475088,1,999,3,1,2
475088,2,1,3,1,2
475121,1,999,37390,8555,28835
475121,2,1,35289,8081,27208
475121,4,3,2101,474,1627
475130,1,999,67,17,50
475130,2,1,67,17,50
475185,1,999,151,92,59
475185,2,1,151,92,59
475194,1,999,186,29,157
475194,2,1,186,29,157
475200,1,999,486,135,351
475200,2,1,486,135,351
475228,1,999,104,40,64
475228,4,3,104,40,64
475237,1,999,24,17,7
475237,2,1,14,11,3
475237,4,3,10,6,4
475246,1,999,78,13,65
475246,2,1,78,13,65
475255,1,999,88,56,32
475255,2,1,88,56,32
475273,1,999,2714,568,2146
475273,2,1,1781,360,1421
475273,4,3,933,208,725
475282,1,999,156,43,113
475282,2,1,156,43,113
475291,1,999,369,152,217
475291,2,1,369,152,217
