UNITID,EFFYLEV,LSTUDY,EFYTOTLM,EFYTOTLW,EFYTOTLT
100654,1,999,2800,3373,6173
100654,2,1,2474,2634,5108
100654,4,3,326,739,1065
100663,1,999,8098,12297,20395
100663,2,1,5368,7305,12673
100663,4,3,2730,4992,7722
100690,1,999,516,581,1097
100690,2,1,293,277,570
100690,4,3,223,304,527
100706,1,999,4986,4116,9102
100706,2,1,3802,3392,7194
100706,4,3,1184,724,1908
100724,1,999,2579,4046,6625
100724,2,1,2271,3222,5493
100724,4,3,308,824,1132
100751,1,999,14382,16231,30613
100751,2,1,11988,12977,24965
100751,4,3,2394,3254,5648
100760,1,999,1175,2248,3423
100760,2,1,1175,2248,3423
100812,1,999,1741,3177,4918
100812,2,1,1741,3177,4918
100830,1,999,2633,4594,7227
100830,2,1,2245,3696,5941
100830,4,3,388,898,1286
100858,1,999,13648,12816,26464
100858,2,1,10965,10074,21039
100858,4,3,2683,2742,5425
100937,1,999,803,808,1611
100937,2,1,781,785,1566
100937,4,3,22,23,45
101028,1,999,919,1818,2737
101028,2,1,919,1818,2737
101073,1,999,415,313,728
101073,2,1,415,313,728
101116,1,999,261,812,1073
101116,2,1,250,752,1002
101116,4,3,11,60,71
101143,1,999,2414,1698,4112
101143,2,1,2414,1698,4112
101161,1,999,2409,4148,6557
101161,2,1,2409,4148,6557
101189,1,999,1526,2549,4075
101189,2,1,1237,2269,3506
101189,4,3,289,280,569
101240,1,999,3926,6093,10019
101240,2,1,3926,6093,10019
101286,1,999,2291,4550,6841
101286,2,1,2291,4550,6841
101295,1,999,3217,5541,8758
101295,2,1,3217,5541,8758
101301,1,999,1095,2134,3229
101301,2,1,1095,2134,3229
101365,1,999,214,502,716
101365,2,1,214,502,716
101435,1,999,584,649,1233
101435,2,1,584,649,1233
101453,1,999,112,12,124
101453,2,1,73,10,83
101453,4,3,39,2,41
101462,1,999,916,1152,2068
101462,2,1,916,1152,2068
101471,1,999,700,353,1053
101471,2,1,700,353,1053
101480,1,999,4727,6652,11379
101480,2,1,4026,5385,9411
101480,4,3,701,1267,1968
101499,1,999,922,1206,2128
101499,2,1,922,1206,2128
101505,1,999,5498,8390,13888
101505,2,1,5498,8390,13888
101514,1,999,7287,9430,16717
101514,2,1,7287,9430,16717
101541,1,999,22,320,342
101541,2,1,22,320,342
101569,1,999,2508,4129,6637
101569,2,1,2508,4129,6637
101587,1,999,1505,4885,6390
101587,2,1,886,1347,2233
101587,4,3,619,3538,4157
101602,1,999,917,1655,2572
101602,2,1,917,1655,2572
101648,1,999,389,159,548
101648,2,1,389,159,548
101675,1,999,963,1126,2089
101675,2,1,963,1126,2089
101693,1,999,616,1368,1984
101693,2,1,561,1172,1733
101693,4,3,55,196,251
101709,1,999,1069,2424,3493
101709,2,1,924,1909,2833
101709,4,3,145,515,660
101736,1,999,2627,3635,6262
101736,2,1,2627,3635,6262
101879,1,999,3794,4891,8685
101879,2,1,3130,4076,7206
101879,4,3,664,815,1479
101897,1,999,1751,2906,4657
101897,2,1,1751,2906,4657
101912,1,999,852,1157,2009
101912,2,1,821,1127,1948
101912,4,3,31,30,61
101949,1,999,735,1331,2066
101949,2,1,735,1331,2066
101958,1,999,7,126,133
101958,2,1,7,126,133
101994,1,999,458,653,1111
101994,2,1,458,653,1111
102030,1,999,2138,3773,5911
102030,2,1,2138,3773,5911
102049,1,999,2073,3072,5145
102049,2,1,1120,1966,3086
102049,4,3,953,1106,2059
102058,1,999,256,311,567
102058,2,1,233,303,536
102058,4,3,23,8,31
102067,1,999,4573,5116,9689
102067,2,1,4573,5116,9689
102076,1,999,1169,2218,3387
102076,2,1,1169,2218,3387
102094,1,999,6863,10509,17372
102094,2,1,5832,7718,13550
102094,4,3,1031,2791,3822
102234,1,999,666,1083,1749
102234,2,1,561,890,1451
102234,4,3,105,193,298
102261,1,999,145,94,239
102261,2,1,145,94,239
102270,1,999,520,665,1185
102270,2,1,520,665,1185
102298,1,999,315,465,780
102298,2,1,315,465,780
102313,1,999,1330,1252,2582
102313,2,1,1330,1252,2582
102368,1,999,14788,23252,38040
102368,2,1,11365,16408,27773
102368,4,3,3423,6844,10267
102377,1,999,1593,2240,3833
102377,2,1,1400,1840,3240
102377,4,3,193,400,593
102395,1,999,736,343,1079
102395,2,1,200,51,251
102395,4,3,536,292,828
102429,1,999,2399,4225,6624
102429,2,1,2399,4225,6624
102553,1,999,11061,16848,27909
102553,2,1,10548,15808,26356
102553,4,3,513,1040,1553
102580,1,999,21,16,37
102580,2,1,21,16,37
102614,1,999,6298,9366,15664
102614,2,1,5693,8496,14189
102614,4,3,605,870,1475
102632,1,999,2243,4193,6436
102632,2,1,2054,3754,5808
102632,4,3,189,439,628
102669,1,999,281,608,889
102669,2,1,184,404,588
102669,4,3,97,204,301
102711,1,999,845,258,1103
102711,2,1,845,258,1103
102845,1,999,940,2716,3656
102845,2,1,940,2716,3656
103361,1,999,1358,907,2265
103361,2,1,1358,907,2265
103501,1,999,86,469,555
103501,2,1,86,469,555
103644,1,999,3834,8411,12245
103644,2,1,3834,8411,12245
103723,1,999,1434,422,1856
103723,2,1,1434,422,1856
103732,1,999,15,158,173
103732,2,1,15,158,173
103741,1,999,26,364,390
103741,2,1,26,364,390
103778,1,999,1022,465,1487
103778,2,1,3,1,4
103778,4,3,1019,464,1483
103787,1,999,53,49,102
103787,2,1,53,49,102
103811,1,999,1404,159,1563
103811,2,1,1404,159,1563
103893,1,999,319,1499,1818
103893,2,1,319,1499,1818
103909,1,999,424,1541,1965
103909,2,1,424,1541,1965
103927,1,999,343,1050,1393
103927,2,1,343,1050,1393
103945,1,999,74,275,349
103945,2,1,74,275,349
103954,1,999,7,118,125
103954,2,1,7,118,125
103963,1,999,2399,153,2552
103963,2,1,2399,153,2552
104090,1,999,429,2259,2688
104090,2,1,429,2259,2688
104151,1,999,37016,39422,76438
104151,2,1,29401,30803,60204
104151,4,3,7615,8619,16234
104160,1,999,5265,7188,12453
104160,2,1,5265,7188,12453
104179,1,999,20283,22500,42783
104179,2,1,15690,17212,32902
104179,4,3,4593,5288,9881
104188,1,999,127,206,333
104188,2,1,127,206,333
104294,1,999,47,357,404
104294,2,1,47,357,404
104346,1,999,6901,8128,15029
104346,2,1,6901,8128,15029
104364,1,999,438,715,1153
104364,2,1,438,715,1153
104391,1,999,14,76,90
104391,2,1,14,76,90
104425,1,999,9152,5481,14633
104425,2,1,9152,5481,14633
104434,1,999,7,101,108
104434,2,1,7,101,108
104443,1,999,30,275,305
104443,2,1,30,275,305
104504,1,999,72,237,309
104504,2,1,72,237,309
104531,1,999,2303,1207,3510
104531,2,1,1895,821,2716
104531,4,3,408,386,794
104568,1,999,40,385,425
104568,2,1,40,385,425
104577,1,999,4705,5542,10247
104577,2,1,4705,5542,10247
104586,1,999,1454,328,1782
104586,2,1,1420,313,1733
104586,4,3,34,15,49
104665,1,999,18,13,31
104665,2,1,5,4,9
104665,4,3,13,9,22
104708,1,999,14940,17438,32378
104708,2,1,14940,17438,32378
104717,1,999,12799,40219,53018
104717,2,1,7355,22746,30101
104717,4,3,5444,17473,22917
104805,1,999,422,1340,1762
104805,2,1,422,1340,1762
104911,1,999,16,281,297
104911,2,1,16,281,297
104984,1,999,134,627,761
104984,2,1,134,627,761
105118,1,999,264,782,1046
105118,2,1,264,782,1046
105127,1,999,9,145,154
105127,2,1,9,145,154
105145,1,999,6574,7585,14159
105145,2,1,6574,7585,14159
105154,1,999,19622,22137,41759
105154,2,1,19622,22137,41759
105163,1,999,718,178,896
105163,2,1,718,178,896
105172,1,999,1046,348,1394
105172,2,1,1046,348,1394
105206,1,999,3649,5973,9622
105206,2,1,3649,5973,9622
105215,1,999,3199,129,3328
105215,2,1,3199,129,3328
105297,1,999,949,1880,2829
105297,2,1,949,1880,2829
105330,1,999,9889,15924,25813
105330,2,1,8043,11543,19586
105330,4,3,1846,4381,6227
105349,1,999,3397,6076,9473
105349,2,1,3397,6076,9473
105367,1,999,729,2153,2882
105367,2,1,357,801,1158
105367,4,3,372,1352,1724
105428,1,999,7995,12252,20247
105428,2,1,7995,12252,20247
105482,1,999,56,192,248
105482,2,1,56,192,248
105516,1,999,3479,4655,8134
105516,2,1,2495,3224,5719
105516,4,3,984,1431,2415
105525,1,999,27965,33047,61012
105525,2,1,27965,33047,61012
105534,1,999,496,1885,2381
105534,2,1,496,1885,2381
105543,1,999,355,1440,1795
105543,2,1,355,1440,1795
105589,1,999,545,915,1460
105589,2,1,410,577,987
105589,4,3,135,338,473
105659,1,999,1104,10,1114
105659,2,1,1104,10,1114
105668,1,999,19448,33186,52634
105668,2,1,19448,33186,52634
105677,1,999,59,2,61
105677,2,1,59,2,61
105701,1,999,10,103,113
105701,2,1,10,103,113
105747,1,999,8038,9454,17492
105747,2,1,8038,9454,17492
105792,1,999,3714,5776,9490
105792,2,1,3714,5776,9490
105899,1,999,230,205,435
105899,2,1,230,205,435
105987,1,999,379,704,1083
105987,2,1,379,704,1083
106041,1,999,3021,68,3089
106041,2,1,3021,68,3089
106102,1,999,1935,2878,4813
106102,2,1,1334,2275,3609
106102,4,3,601,603,1204
106111,1,999,37,457,494
106111,2,1,37,457,494
106148,1,999,5488,7950,13438
106148,2,1,5488,7950,13438
106245,1,999,6267,10311,16578
106245,2,1,5096,7939,13035
106245,4,3,1171,2372,3543
106263,1,999,1008,2244,3252
106263,2,1,261,1003,1264
106263,4,3,747,1241,1988
106281,1,999,38,41,79
106281,2,1,38,41,79
106306,1,999,661,387,1048
106306,2,1,661,387,1048
106315,1,999,4,50,54
106315,2,1,4,50,54
106324,1,999,2,62,64
106324,2,1,2,62,64
106342,1,999,294,356,650
106342,2,1,294,356,650
106351,1,999,113,69,182
106351,2,1,113,69,182
106360,1,999,6,49,55
106360,2,1,6,49,55
106397,1,999,11649,11041,22690
106397,2,1,9111,8581,17692
106397,4,3,2538,2460,4998
106412,1,999,1761,2497,4258
106412,2,1,1688,2363,4051
106412,4,3,73,134,207
106449,1,999,2722,4123,6845
106449,2,1,2722,4123,6845
106458,1,999,6157,10131,16288
106458,2,1,4903,7009,11912
106458,4,3,1254,3122,4376
106467,1,999,4874,6044,10918
106467,2,1,4600,5377,9977
106467,4,3,274,667,941
106485,1,999,1820,2684,4504
106485,2,1,1761,2527,4288
106485,4,3,59,157,216
106494,1,999,5,92,97
106494,2,1,5,92,97
106546,1,999,192,1007,1199
106546,2,1,192,1007,1199
106607,1,999,10,90,100
106607,2,1,10,90,100
106625,1,999,1362,2102,3464
106625,2,1,1362,2102,3464
106704,1,999,5578,8188,13766
106704,2,1,5097,6488,11585
106704,4,3,481,1700,2181
106713,1,999,444,376,820
106713,2,1,444,376,820
106795,1,999,696,1565,2261
106795,2,1,696,1565,2261
106810,1,999,104,76,180
106810,2,1,104,76,180
106829,1,999,202,141,343
106829,2,1,202,141,343
106883,1,999,752,1540,2292
106883,2,1,752,1540,2292
106892,1,999,34,439,473
106892,2,1,34,439,473
106908,1,999,23,311,334
106908,2,1,23,311,334
106980,1,999,1956,3166,5122
106980,2,1,1956,3166,5122
106999,1,999,713,1602,2315
106999,2,1,713,1602,2315
107044,1,999,3004,4394,7398
107044,2,1,2139,2429,4568
107044,4,3,865,1965,2830
107071,1,999,1837,2626,4463
107071,2,1,1636,1923,3559
107071,4,3,201,703,904
107080,1,999,654,829,1483
107080,2,1,649,827,1476
107080,4,3,5,2,7
107099,1,999,7,108,115
107099,2,1,7,108,115
107123,1,999,12,60,72
107123,2,1,12,60,72
107141,1,999,1069,1362,2431
107141,2,1,851,1082,1933
107141,4,3,218,280,498
107211,1,999,5,33,38
107211,2,1,5,33,38
107220,1,999,26,582,608
107220,2,1,26,582,608
107275,1,999,2,35,37
107275,2,1,2,35,37
107293,1,999,7,121,128
107293,2,1,7,121,128
107318,1,999,1498,2308,3806
107318,2,1,1498,2308,3806
107327,1,999,1110,2058,3168
107327,2,1,1110,2058,3168
107363,1,999,12,90,102
107363,2,1,12,90,102
107442,1,999,65,42,107
107442,2,1,65,42,107
107460,1,999,1317,1904,3221
107460,2,1,1317,1904,3221
107488,1,999,185,132,317
107488,2,1,185,132,317
107512,1,999,710,818,1528
107512,2,1,710,818,1528
107521,1,999,863,1218,2081
107521,2,1,863,1218,2081
107549,1,999,570,1322,1892
107549,2,1,570,1322,1892
107558,1,999,322,337,659
107558,2,1,322,337,659
107585,1,999,1323,1965,3288
107585,2,1,1323,1965,3288
107600,1,999,267,469,736
107600,2,1,267,469,736
107619,1,999,1025,1995,3020
107619,2,1,1025,1995,3020
107637,1,999,1517,2555,4072
107637,2,1,1517,2555,4072
107655,1,999,5,51,56
107655,2,1,5,51,56
107664,1,999,5338,9847,15185
107664,2,1,5338,9847,15185
107725,1,999,809,1420,2229
107725,2,1,809,1420,2229
107743,1,999,541,1054,1595
107743,2,1,541,1054,1595
107789,1,999,11,118,129
107789,2,1,11,118,129
107831,1,999,5,170,175
107831,2,1,5,170,175
107877,1,999,311,398,709
107877,2,1,311,398,709
107974,1,999,689,1898,2587
107974,2,1,689,1898,2587
107983,1,999,1508,2410,3918
107983,2,1,1335,1912,3247
107983,4,3,173,498,671
107992,1,999,1881,1870,3751
107992,2,1,1881,1870,3751
108065,1,999,1,28,29
108065,2,1,1,28,29
108092,1,999,3837,5249,9086
108092,2,1,3837,5249,9086
108199,1,999,7718,8689,16407
108199,2,1,7718,8689,16407
108232,1,999,8942,12107,21049
108232,2,1,6475,8442,14917
108232,4,3,2467,3665,6132
108250,1,999,1256,277,1533
108250,2,1,1256,277,1533
108269,1,999,51,71,122
108269,4,3,51,71,122
108348,1,999,52,42,94
108348,2,1,52,42,94
108649,1,999,11,297,308
108649,2,1,11,297,308
108667,1,999,5532,7204,12736
108667,2,1,5532,7204,12736
108807,1,999,9113,8854,17967
108807,2,1,9113,8854,17967
108852,1,999,93,115,208
108852,2,1,93,115,208
108861,1,999,58,36,94
108861,4,3,58,36,94
108870,1,999,225,113,338
108870,4,3,225,113,338
108977,1,999,2,48,50
108977,2,1,2,48,50
109013,1,999,46,47,93
109013,2,1,46,47,93
109040,1,999,499,1637,2136
109040,2,1,499,1637,2136
109086,1,999,52,83,135
109086,2,1,34,66,100
109086,4,3,18,17,35
109208,1,999,26578,29066,55644
109208,2,1,26578,29066,55644
109332,1,999,261,745,1006
109332,2,1,261,745,1006
109350,1,999,8496,12158,20654
109350,2,1,8496,12158,20654
109651,1,999,1226,909,2135
109651,2,1,1121,836,1957
109651,4,3,105,73,178
109721,1,999,628,435,1063
109721,2,1,628,435,1063
109730,1,999,99,27,126
109730,2,1,99,27,126
109785,1,999,3703,6855,10558
109785,2,1,2015,3343,5358
109785,4,3,1688,3512,5200
109819,1,999,12964,15167,28131
109819,2,1,12964,15167,28131
109891,1,999,1,32,33
109891,2,1,1,32,33
109907,1,999,3353,5058,8411
109907,2,1,3353,5058,8411
109934,1,999,28,349,377
109934,2,1,28,349,377
110051,1,999,228,376,604
110051,2,1,195,297,492
110051,4,3,33,79,112
110060,1,999,178,125,303
110060,2,1,92,93,185
110060,4,3,86,32,118
110097,1,999,3229,3429,6658
110097,2,1,1770,2615,4385
110097,4,3,1459,814,2273
110185,1,999,776,644,1420
110185,2,1,747,617,1364
110185,4,3,29,27,56
110194,1,999,377,2,379
110194,2,1,377,2,379
110219,1,999,136,975,1111
110219,2,1,136,975,1111
110246,1,999,8785,9650,18435
110246,2,1,8785,9650,18435
110307,1,999,63,273,336
110307,4,3,63,273,336
110316,1,999,415,1068,1483
110316,2,1,41,83,124
110316,4,3,374,985,1359
110334,1,999,10141,11736,21877
110334,2,1,10141,11736,21877
110361,1,999,1718,3216,4934
110361,2,1,1416,2295,3711
110361,4,3,302,921,1223
110370,1,999,716,1127,1843
110370,2,1,552,865,1417
110370,4,3,164,262,426
110398,1,999,665,711,1376
110398,4,3,665,711,1376
110404,1,999,1507,737,2244
110404,2,1,618,364,982
110404,4,3,889,373,1262
110413,1,999,1873,2604,4477
110413,2,1,1135,1478,2613
110413,4,3,738,1126,1864
110422,1,999,11281,8913,20194
110422,2,1,10564,8300,18864
110422,4,3,717,613,1330
110468,1,999,1360,3296,4656
110468,2,1,72,133,205
110468,4,3,1288,3163,4451
110486,1,999,3412,6164,9576
110486,2,1,2844,4824,7668
110486,4,3,568,1340,1908
110495,1,999,3102,5932,9034
110495,2,1,2605,4709,7314
110495,4,3,497,1223,1720
110510,1,999,7137,12592,19729
110510,2,1,5879,10170,16049
110510,4,3,1258,2422,3680
110529,1,999,12972,10245,23217
110529,2,1,11866,8891,20757
110529,4,3,1106,1354,2460
110538,1,999,8523,9369,17892
110538,2,1,8023,8385,16408
110538,4,3,500,984,1484
110547,1,999,5055,10869,15924
110547,2,1,4130,8061,12191
110547,4,3,925,2808,3733
110556,1,999,8918,12837,21755
110556,2,1,7861,10568,18429
110556,4,3,1057,2269,3326
110565,1,999,16017,22534,38551
110565,2,1,13846,18775,32621
110565,4,3,2171,3759,5930
110574,1,999,6580,10299,16879
110574,2,1,5201,7956,13157
110574,4,3,1379,2343,3722
110583,1,999,14929,22362,37291
110583,2,1,12481,18108,30589
110583,4,3,2448,4254,6702
110592,1,999,9240,14275,23515
110592,2,1,7221,10786,18007
110592,4,3,2019,3489,5508
110608,1,999,16000,22028,38028
110608,2,1,13619,17743,31362
110608,4,3,2381,4285,6666
110617,1,999,12800,18073,30873
110617,2,1,11093,14848,25941
110617,4,3,1707,3225,4932
110635,1,999,19150,19820,38970
110635,2,1,13279,14978,28257
110635,4,3,5871,4842,10713
110644,1,999,15056,18457,33513
110644,2,1,11762,14919,26681
110644,4,3,3294,3538,6832
110653,1,999,14297,14940,29237
110653,2,1,11229,12577,23806
110653,4,3,3068,2363,5431
110662,1,999,19442,22046,41488
110662,2,1,12842,16213,29055
110662,4,3,6600,5833,12433
110671,1,999,10246,10649,20895
110671,2,1,8881,9417,18298
110671,4,3,1365,1232,2597
110680,1,999,15431,15366,30797
110680,2,1,12214,13012,25226
110680,4,3,3217,2354,5571
110699,1,999,1155,2011,3166
110699,4,3,1155,2011,3166
110705,1,999,11754,12948,24702
110705,2,1,10025,11380,21405
110705,4,3,1729,1568,3297
110714,1,999,8787,9509,18296
110714,2,1,7925,8700,16625
110714,4,3,862,809,1671
110778,1,999,115,435,550
110778,4,3,115,435,550
110875,1,999,2,136,138
110875,2,1,2,136,138
110918,1,999,16,14,30
110918,2,1,16,14,30
110945,1,999,703,1226,1929
110945,2,1,703,1226,1929
111009,1,999,725,601,1326
111009,2,1,725,601,1326
111054,1,999,25,204,229
111054,2,1,25,204,229
111081,1,999,697,718,1415
111081,2,1,466,440,906
111081,4,3,231,278,509
111188,1,999,716,120,836
111188,2,1,716,120,836
111391,1,999,466,570,1036
111391,4,3,466,570,1036
111434,1,999,4120,7477,11597
111434,2,1,4120,7477,11597
111461,1,999,21601,14090,35691
111461,2,1,21601,14090,35691
111513,1,999,25,354,379
111513,2,1,25,354,379
111638,1,999,176,671,847
111638,2,1,176,671,847
111708,1,999,348,94,442
111708,2,1,348,94,442
111717,1,999,555,512,1067
111717,2,1,555,512,1067
111726,1,999,382,148,530
111726,2,1,382,148,530
111744,1,999,326,18,344
111744,2,1,326,18,344
111762,1,999,134,88,222
111762,2,1,134,88,222
111771,1,999,228,123,351
111771,2,1,228,123,351
111799,1,999,154,191,345
111799,2,1,154,191,345
111887,1,999,13846,17634,31480
111887,2,1,13846,17634,31480
111896,1,999,4448,6718,11166
111896,2,1,4448,6718,11166
111920,1,999,10329,12681,23010
111920,2,1,10329,12681,23010
111939,1,999,12003,17054,29057
111939,2,1,12003,17054,29057
111948,1,999,2932,4001,6933
111948,2,1,2021,2817,4838
111948,4,3,911,1184,2095
111966,1,999,113,191,304
111966,2,1,104,163,267
111966,4,3,9,28,37
112075,1,999,1463,2028,3491
112075,2,1,615,948,1563
112075,4,3,848,1080,1928
112084,1,999,245,239,484
112084,2,1,244,216,460
112084,4,3,1,23,24
112127,1,999,40,56,96
112127,4,3,40,56,96
112172,1,999,7847,9488,17335
112172,2,1,7847,9488,17335
112190,1,999,22483,26698,49181
112190,2,1,22483,26698,49181
112251,1,999,1183,1334,2517
112251,4,3,1183,1334,2517
112260,1,999,704,564,1268
112260,2,1,687,561,1248
112260,4,3,17,3,20
112288,1,999,91,504,595
112288,2,1,91,504,595
112312,1,999,237,174,411
112312,2,1,27,48,75
112312,4,3,210,126,336
112367,1,999,841,1745,2586
112367,2,1,841,1745,2586
112385,1,999,8828,9692,18520
112385,2,1,8828,9692,18520
112394,1,999,202,39,241
112394,2,1,202,39,241
112446,1,999,826,153,979
112446,2,1,715,118,833
112446,4,3,111,35,146
112455,1,999,15,121,136
112455,2,1,15,121,136
112525,1,999,996,1785,2781
112525,4,3,996,1785,2781
112561,1,999,3567,2677,6244
112561,2,1,3567,2677,6244
112570,1,999,300,112,412
112570,2,1,300,112,412
112686,1,999,4765,8011,12776
112686,2,1,4765,8011,12776
112783,1,999,159,924,1083
112783,2,1,159,924,1083
112826,1,999,5120,7917,13037
112826,2,1,5120,7917,13037
113096,1,999,10379,13670,24049
113096,2,1,10379,13670,24049
113111,1,999,4145,4384,8529
113111,2,1,4145,4384,8529
113193,1,999,8314,8763,17077
113193,2,1,8314,8763,17077
113218,1,999,6860,8572,15432
113218,2,1,6860,8572,15432
113227,1,999,7,284,291
113227,2,1,7,284,291
113236,1,999,9956,12364,22320
113236,2,1,9956,12364,22320
113333,1,999,20228,20678,40906
113333,2,1,20228,20678,40906
113397,1,999,44,732,776
113397,2,1,44,732,776
113449,1,999,57,238,295
113449,2,1,57,238,295
113537,1,999,18,26,44
113537,2,1,14,13,27
113537,4,3,4,13,17
113573,1,999,5808,7346,13154
113573,2,1,5808,7346,13154
113582,1,999,29,364,393
113582,2,1,29,364,393
113607,1,999,10418,6136,16554
113607,2,1,8934,4831,13765
113607,4,3,1484,1305,2789
113634,1,999,16137,18286,34423
113634,2,1,16137,18286,34423
113698,1,999,664,1706,2370
113698,2,1,424,1151,1575
113698,4,3,240,555,795
113704,1,999,73,17,90
113704,4,3,73,17,90
113856,1,999,30027,30624,60651
113856,2,1,30027,30624,60651
113908,1,999,43,1146,1189
113908,2,1,43,1146,1189
113953,1,999,3491,5330,8821
113953,2,1,3491,5330,8821
113980,1,999,18615,21102,39717
113980,2,1,18615,21102,39717
114044,1,999,6,114,120
114044,2,1,6,114,120
114062,1,999,17,291,308
114062,2,1,17,291,308
114071,1,999,41,659,700
114071,2,1,41,659,700
114080,1,999,25,611,636
114080,2,1,25,611,636
114114,1,999,44,165,209
114114,4,3,44,165,209
114123,1,999,209,714,923
114123,2,1,209,714,923
114266,1,999,9535,8798,18333
114266,2,1,9535,8798,18333
114354,1,999,622,5303,5925
114354,2,1,622,5303,5925
114372,1,999,29,153,182
114372,2,1,29,153,182
114390,1,999,117,1100,1217
114390,2,1,117,1100,1217
114415,1,999,55,544,599
114415,2,1,55,544,599
114433,1,999,1669,2136,3805
114433,2,1,1669,2136,3805
114460,1,999,16,381,397
114460,2,1,16,381,397
114549,1,999,640,1536,2176
114549,4,3,640,1536,2176
114585,1,999,126,231,357
114585,4,3,126,231,357
114628,1,999,24,134,158
114628,2,1,24,134,158
114716,1,999,15529,17600,33129
114716,2,1,15529,17600,33129
114734,1,999,30,38,68
114734,4,3,30,38,68
114761,1,999,6,119,125
114761,2,1,6,119,125
114789,1,999,17048,18352,35400
114789,2,1,17048,18352,35400
114813,1,999,1598,2719,4317
114813,2,1,1293,1756,3049
114813,4,3,305,963,1268
114840,1,999,2939,1531,4470
114840,4,3,2939,1531,4470
114859,1,999,15602,16878,32480
114859,2,1,15602,16878,32480
114895,1,999,21,196,217
114895,2,1,21,196,217
114938,1,999,10006,6485,16491
114938,2,1,10006,6485,16491
114947,1,999,1373,2497,3870
114947,2,1,1373,2497,3870
115001,1,999,10945,13659,24604
115001,2,1,10945,13659,24604
115010,1,999,112,299,411
115010,2,1,112,299,411
115083,1,999,2210,2746,4956
115083,2,1,263,334,597
115083,4,3,1947,2412,4359
115126,1,999,9368,11432,20800
115126,2,1,9368,11432,20800
115214,1,999,140,122,262
115214,4,3,140,122,262
115296,1,999,13260,17839,31099
115296,2,1,13260,17839,31099
115357,1,999,3,53,56
115357,2,1,3,53,56
115393,1,999,8611,8226,16837
115393,2,1,8611,8226,16837
115409,1,999,490,278,768
115409,2,1,490,278,768
115454,1,999,583,1305,1888
115454,2,1,583,1305,1888
115472,1,999,836,1787,2623
115472,2,1,836,1787,2623
115490,1,999,784,1525,2309
115490,2,1,784,1525,2309
115515,1,999,684,1390,2074
115515,2,1,684,1390,2074
115533,1,999,751,1716,2467
115533,2,1,751,1716,2467
115658,1,999,22,236,258
115658,2,1,22,236,258
115728,1,999,343,1040,1383
115728,2,1,210,592,802
115728,4,3,133,448,581
115746,1,999,191,531,722
115746,4,3,191,531,722
115755,1,999,3745,4492,8237
115755,2,1,3498,4043,7541
115755,4,3,247,449,696
115773,1,999,252,1039,1291
115773,2,1,192,903,1095
115773,4,3,60,136,196
115861,1,999,4951,6395,11346
115861,2,1,4951,6395,11346
115931,1,999,433,473,906
115931,2,1,433,473,906
116040,1,999,268,1494,1762
116040,2,1,268,1494,1762
116226,1,999,32,478,510
116226,2,1,32,478,510
116350,1,999,19,130,149
116350,2,1,19,130,149
116439,1,999,10766,13238,24004
116439,2,1,10766,13238,24004
116466,1,999,2126,490,2616
116466,2,1,2126,490,2616
116475,1,999,1337,366,1703
116475,2,1,1337,366,1703
116484,1,999,1529,468,1997
116484,2,1,1529,468,1997
116563,1,999,7,185,192
116563,2,1,7,185,192
116624,1,999,102,54,156
116624,4,3,102,54,156
116712,1,999,536,1503,2039
116712,2,1,86,250,336
116712,4,3,450,1253,1703
116846,1,999,133,124,257
116846,2,1,52,66,118
116846,4,3,81,58,139
117052,1,999,8943,12643,21586
117052,2,1,8943,12643,21586
117104,1,999,320,282,602
117104,2,1,320,282,602
117113,1,999,1453,1423,2876
117113,2,1,1453,1423,2876
117140,1,999,3706,6027,9733
117140,2,1,2000,3029,5029
117140,4,3,1706,2998,4704
117168,1,999,172,272,444
117168,2,1,159,248,407
117168,4,3,13,24,37
117195,1,999,2741,3751,6492
117195,2,1,2741,3751,6492
117238,1,999,28,191,219
117238,2,1,28,191,219
117247,1,999,10099,12490,22589
117247,2,1,10099,12490,22589
117274,1,999,3514,1379,4893
117274,2,1,3514,1379,4893
117520,1,999,251,198,449
117520,4,3,251,198,449
117557,1,999,350,312,662
117557,2,1,86,115,201
117557,4,3,264,197,461
117575,1,999,163,87,250
117575,2,1,65,26,91
117575,4,3,98,61,159
117627,1,999,1118,1477,2595
117627,2,1,780,1006,1786
117627,4,3,338,471,809
117636,1,999,1915,3099,5014
117636,2,1,397,1042,1439
117636,4,3,1518,2057,3575
117645,1,999,18931,20988,39919
117645,2,1,18931,20988,39919
117672,1,999,308,226,534
117672,4,3,308,226,534
117690,1,999,6153,9079,15232
117690,2,1,6153,9079,15232
117706,1,999,14508,17534,32042
117706,2,1,14508,17534,32042
117715,1,999,3663,8590,12253
117715,2,1,3663,8590,12253
117724,1,999,13254,11523,24777
117724,2,1,13254,11523,24777
117733,1,999,12501,17180,29681
117733,2,1,12501,17180,29681
117751,1,999,996,673,1669
117751,2,1,565,542,1107
117751,4,3,431,131,562
117788,1,999,13184,17950,31134
117788,2,1,13184,17950,31134
117803,1,999,91,303,394
117803,2,1,91,303,394
117867,1,999,6421,10239,16660
117867,2,1,6421,10239,16660
117894,1,999,7282,9324,16606
117894,2,1,7282,9324,16606
117928,1,999,1095,997,2092
117928,2,1,1087,988,2075
117928,4,3,8,9,17
117946,1,999,4184,5750,9934
117946,2,1,2657,3538,6195
117946,4,3,1527,2212,3739
117955,1,999,11,252,263
117955,2,1,11,252,263
118116,1,999,17,164,181
118116,2,1,17,164,181
118125,1,999,3,146,149
118125,2,1,3,146,149
118134,1,999,7,255,262
118134,2,1,7,255,262
118143,1,999,10,104,114
118143,2,1,10,104,114
118161,1,999,6,176,182
118161,2,1,6,176,182
118189,1,999,34,201,235
118189,2,1,34,201,235
118198,1,999,237,675,912
118198,2,1,237,675,912
118259,1,999,221,990,1211
118259,2,1,221,990,1211
118277,1,999,507,1682,2189
118277,2,1,507,1682,2189
118286,1,999,447,1626,2073
118286,2,1,447,1626,2073
118347,1,999,4569,6542,11111
118347,2,1,4569,6542,11111
118356,1,999,241,3732,3973
118356,2,1,241,3732,3973
118541,1,999,332,330,662
118541,2,1,332,330,662
118684,1,999,2834,4544,7378
118684,2,1,2834,4544,7378
118693,1,999,432,272,704
118693,2,1,432,272,704
118709,1,999,90,76,166
118709,4,3,90,76,166
118718,1,999,6453,8507,14960
118718,2,1,6453,8507,14960
118772,1,999,4421,7981,12402
118772,2,1,4421,7981,12402
118888,1,999,117,1518,1635
118888,2,1,0,1008,1008
118888,4,3,117,510,627
118912,1,999,8923,12237,21160
118912,2,1,8923,12237,21160
118921,1,999,55,587,642
118921,2,1,55,587,642
118930,1,999,7687,9928,17615
118930,2,1,7687,9928,17615
118958,1,999,12,78,90
118958,2,1,12,78,90
118967,1,999,906,992,1898
118967,2,1,906,992,1898
118976,1,999,10510,14431,24941
118976,2,1,10510,14431,24941
118994,1,999,46,5,51
118994,2,1,46,5,51
119058,1,999,368,579,947
119058,2,1,4,8,12
119058,4,3,364,571,935
119067,1,999,8315,8287,16602
119067,2,1,8315,8287,16602
119137,1,999,11361,13697,25058
119137,2,1,11361,13697,25058
119164,1,999,18780,19961,38741
119164,2,1,18780,19961,38741
119173,1,999,336,2618,2954
119173,2,1,202,2144,2346
119173,4,3,134,474,608
119216,1,999,9910,14050,23960
119216,2,1,9910,14050,23960
119234,1,999,66,203,269
119234,2,1,66,203,269
119270,1,999,1867,441,2308
119270,2,1,1867,441,2308
119331,1,999,4583,6091,10674
119331,2,1,4583,6091,10674
119340,1,999,522,568,1090
119340,2,1,522,568,1090
119359,1,999,575,1253,1828
119359,2,1,575,1253,1828
119368,1,999,715,406,1121
119368,2,1,715,406,1121
119438,1,999,186,915,1101
119438,2,1,186,915,1101
119456,1,999,808,872,1680
119456,2,1,808,872,1680
119465,1,999,455,874,1329
119465,2,1,455,874,1329
119508,1,999,1008,1136,2144
119508,2,1,1008,1136,2144
119544,1,999,261,475,736
119544,2,1,163,315,478
119544,4,3,98,160,258
119553,1,999,236,523,759
119553,2,1,236,523,759
119605,1,999,9965,17367,27332
119605,2,1,3921,5818,9739
119605,4,3,6044,11549,17593
119678,1,999,3305,549,3854
119678,4,3,3305,549,3854
119775,1,999,484,231,715
119775,2,1,312,120,432
119775,4,3,172,111,283
119845,1,999,14,321,335
119845,2,1,14,321,335
119951,1,999,30,551,581
119951,2,1,30,551,581
120069,1,999,83,419,502
120069,2,1,83,419,502
120078,1,999,184,704,888
120078,2,1,184,704,888
120087,1,999,28,245,273
120087,2,1,28,245,273
120166,1,999,935,568,1503
120166,2,1,163,119,282
120166,4,3,772,449,1221
120184,1,999,581,1433,2014
120184,2,1,346,703,1049
120184,4,3,235,730,965
120254,1,999,898,1166,2064
120254,2,1,893,1141,2034
120254,4,3,5,25,30
120272,1,999,22,174,196
120272,2,1,22,174,196
120290,1,999,8821,8678,17499
120290,2,1,8821,8678,17499
120342,1,999,16915,16388,33303
120342,2,1,16915,16388,33303
120403,1,999,422,877,1299
120403,2,1,388,809,1197
120403,4,3,34,68,102
120421,1,999,5840,7545,13385
120421,2,1,5840,7545,13385
120537,1,999,580,709,1289
120537,2,1,386,464,850
120537,4,3,194,245,439
120661,1,999,227,732,959
120661,2,1,227,732,959
120698,1,999,116,458,574
120698,2,1,16,50,66
120698,4,3,100,408,508
120740,1,999,95,78,173
120740,4,3,95,78,173
120768,1,999,60,655,715
120768,2,1,12,119,131
120768,4,3,48,536,584
120795,1,999,93,120,213
120795,4,3,93,120,213
120838,1,999,126,115,241
120838,2,1,28,31,59
120838,4,3,98,84,182
120865,1,999,754,926,1680
120865,2,1,741,908,1649
120865,4,3,13,18,31
120883,1,999,3055,3919,6974
120883,2,1,1671,2039,3710
120883,4,3,1384,1880,3264
120944,1,999,230,131,361
120944,4,3,230,131,361
120953,1,999,4328,1294,5622
120953,2,1,4328,1294,5622
120971,1,999,20828,20069,40897
120971,2,1,20828,20069,40897
121008,1,999,13,361,374
121008,2,1,13,361,374
121017,1,999,21,468,489
121017,2,1,21,468,489
121044,1,999,17771,19881,37652
121044,2,1,17771,19881,37652
121071,1,999,820,609,1429
121071,2,1,804,546,1350
121071,4,3,16,63,79
121150,1,999,3697,4779,8476
121150,2,1,1651,1988,3639
121150,4,3,2046,2791,4837
121257,1,999,438,631,1069
121257,2,1,438,631,1069
121275,1,999,239,84,323
121275,2,1,239,84,323
121309,1,999,1458,2772,4230
121309,2,1,952,1538,2490
121309,4,3,506,1234,1740
121345,1,999,795,775,1570
121345,2,1,795,775,1570
121363,1,999,2432,4121,6553
121363,2,1,2432,4121,6553
121381,1,999,583,766,1349
121381,2,1,583,766,1349
121433,1,999,11,220,231
121433,2,1,11,220,231
121619,1,999,31002,17550,48552
121619,2,1,31002,17550,48552
121628,1,999,64,51,115
121628,4,3,64,51,115
121637,1,999,5,74,79
121637,2,1,5,74,79
121691,1,999,2378,2923,5301
121691,2,1,1327,1665,2992
121691,4,3,1051,1258,2309
121707,1,999,4982,6195,11177
121707,2,1,4982,6195,11177
121859,1,999,5,247,252
121859,2,1,5,247,252
121868,1,999,5,120,125
121868,2,1,5,120,125
121877,1,999,9,195,204
121877,2,1,9,195,204
121886,1,999,20431,15841,36272
121886,2,1,20431,15841,36272
121901,1,999,24809,29942,54751
121901,2,1,24809,29942,54751
121983,1,999,326,898,1224
121983,2,1,50,125,175
121983,4,3,276,773,1049
121992,1,999,113,164,277
121992,2,1,113,164,277
122117,1,999,101,132,233
122117,4,3,101,132,233
122180,1,999,17134,23652,40786
122180,2,1,17134,23652,40786
122205,1,999,15886,20294,36180
122205,2,1,15886,20294,36180
122296,1,999,384,1400,1784
122296,2,1,129,769,898
122296,4,3,255,631,886
122339,1,999,13724,16286,30010
122339,2,1,13724,16286,30010
122366,1,999,484,24,508
122366,2,1,484,24,508
122375,1,999,18122,20684,38806
122375,2,1,18122,20684,38806
122384,1,999,12136,9686,21822
122384,2,1,12136,9686,21822
122409,1,999,14914,20083,34997
122409,2,1,12225,16141,28366
122409,4,3,2689,3942,6631
122436,1,999,3742,5077,8819
122436,2,1,2356,3041,5397
122436,4,3,1386,2036,3422
122454,1,999,272,406,678
122454,2,1,183,236,419
122454,4,3,89,170,259
122506,1,999,211,217,428
122506,2,1,117,94,211
122506,4,3,94,123,217
122597,1,999,13264,19648,32912
122597,2,1,11326,16096,27422
122597,4,3,1938,3552,5490
122603,1,999,227,214,441
122603,4,3,227,214,441
122612,1,999,4102,6587,10689
122612,2,1,2437,3902,6339
122612,4,3,1665,2685,4350
122649,1,999,119,93,212
122649,4,3,119,93,212
122658,1,999,11463,15903,27366
122658,2,1,11463,15903,27366
122685,1,999,707,1667,2374
122685,2,1,707,1667,2374
122694,1,999,633,1035,1668
122694,2,1,633,1035,1668
122728,1,999,306,414,720
122728,2,1,296,399,695
122728,4,3,10,15,25
122746,1,999,8464,10391,18855
122746,2,1,8464,10391,18855
122755,1,999,15232,17877,33109
122755,2,1,12288,13228,25516
122755,4,3,2944,4649,7593
122791,1,999,8727,9888,18615
122791,2,1,8727,9888,18615
122834,1,999,475,1045,1520
122834,2,1,475,1045,1520
122843,1,999,7026,5837,12863
122843,2,1,6870,5673,12543
122843,4,3,156,164,320
122852,1,999,92,428,520
122852,2,1,92,428,520
122889,1,999,13277,15486,28763
122889,2,1,13277,15486,28763
122931,1,999,5101,4782,9883
122931,2,1,2589,2884,5473
122931,4,3,2512,1898,4410
122977,1,999,22030,27556,49586
122977,2,1,22030,27556,49586
123013,1,999,16743,20790,37533
123013,2,1,16743,20790,37533
123095,1,999,208,546,754
123095,4,3,208,546,754
123165,1,999,23,975,998
123165,2,1,13,961,974
123165,4,3,10,14,24
123208,1,999,3220,76,3296
123208,2,1,3220,76,3296
123217,1,999,8831,10529,19360
123217,2,1,8831,10529,19360
123280,1,999,32,43,75
123280,2,1,25,31,56
123280,4,3,7,12,19
123299,1,999,6074,8666,14740
123299,2,1,6074,8666,14740
123341,1,999,13349,15234,28583
123341,2,1,13349,15234,28583
123350,1,999,24,192,216
123350,2,1,24,192,216
123396,1,999,13,233,246
123396,2,1,13,233,246
123448,1,999,91,99,190
123448,4,3,91,99,190
123457,1,999,502,878,1380
123457,2,1,387,686,1073
123457,4,3,115,192,307
123484,1,999,2801,2770,5571
123484,2,1,2801,2770,5571
123493,1,999,846,1196,2042
123493,2,1,846,1196,2042
123509,1,999,7909,9510,17419
123509,2,1,7909,9510,17419
123527,1,999,9853,13127,22980
123527,2,1,9853,13127,22980
123554,1,999,1512,2751,4263
123554,2,1,1005,1655,2660
123554,4,3,507,1096,1603
123563,1,999,7607,11081,18688
123563,2,1,7607,11081,18688
123572,1,999,3290,5682,8972
123572,2,1,2916,4741,7657
123572,4,3,374,941,1315
123581,1,999,174,13,187
123581,2,1,174,13,187
123633,1,999,453,417,870
123633,2,1,210,213,423
123633,4,3,243,204,447
123642,1,999,45,525,570
123642,2,1,45,525,570
123651,1,999,900,1799,2699
123651,2,1,772,1600,2372
123651,4,3,128,199,327
123679,1,999,237,624,861
123679,2,1,237,624,861
123800,1,999,13353,15431,28784
123800,2,1,13353,15431,28784
123855,1,999,85,10,95
123855,4,3,85,10,95
123916,1,999,29,52,81
123916,4,3,29,52,81
123943,1,999,151,346,497
123943,4,3,151,346,497
123952,1,999,312,181,493
123952,2,1,169,86,255
123952,4,3,143,95,238
123961,1,999,19970,18890,38860
123961,2,1,9203,9113,18316
123961,4,3,10767,9777,20544
123970,1,999,535,620,1155
123970,4,3,535,620,1155
124113,1,999,10888,3699,14587
124113,2,1,10888,3699,14587
124283,1,999,247,219,466
124283,4,3,247,219,466
124292,1,999,163,185,348
124292,2,1,163,185,348
124344,1,999,16,264,280
124344,2,1,16,264,280
124487,1,999,187,176,363
124487,2,1,187,176,363
124681,1,999,4092,9325,13417
124681,2,1,4092,9325,13417
124706,1,999,217,762,979
124706,2,1,217,762,979
124779,1,999,4,35,39
124779,2,1,4,35,39
124937,1,999,238,564,802
124937,2,1,238,564,802
125028,1,999,9923,13019,22942
125028,2,1,9923,13019,22942
125082,1,999,5,252,257
125082,2,1,5,252,257
125091,1,999,8388,11043,19431
125091,2,1,8388,11043,19431
125170,1,999,5021,7140,12161
125170,2,1,5021,7140,12161
125231,1,999,14617,49258,63875
125231,2,1,2870,7856,10726
125231,4,3,11747,41402,53149
125301,1,999,2553,3419,5972
125301,2,1,2553,3419,5972
125462,1,999,2057,2721,4778
125462,2,1,2057,2721,4778
125471,1,999,7132,11056,18188
125471,2,1,7132,11056,18188
125480,1,999,154,142,296
125480,4,3,154,142,296
125499,1,999,9312,10903,20215
125499,2,1,9312,10903,20215
125532,1,999,384,2306,2690
125532,2,1,384,2306,2690
125718,1,999,138,12,150
125718,4,3,138,12,150
125727,1,999,521,846,1367
125727,2,1,520,839,1359
125727,4,3,1,7,8
125763,1,999,995,1271,2266
125763,2,1,654,756,1410
125763,4,3,341,515,856
125897,1,999,1015,1068,2083
125897,2,1,781,791,1572
125897,4,3,234,277,511
126012,1,999,121,302,423
126012,4,3,121,302,423
126030,1,999,237,228,465
126030,4,3,237,228,465
126049,1,999,606,468,1074
126049,4,3,606,468,1074
126076,1,999,132,0,132
126076,2,1,132,0,132
126119,1,999,5078,7297,12375
126119,2,1,5078,7297,12375
126164,1,999,5,136,141
126164,2,1,5,136,141
126182,1,999,1563,2273,3836
126182,2,1,1308,1598,2906
126182,4,3,255,675,930
126207,1,999,3577,4681,8258
126207,2,1,3577,4681,8258
126289,1,999,6994,9839,16833
126289,2,1,6994,9839,16833
126359,1,999,113,788,901
126359,2,1,113,788,901
126401,1,999,408,1232,1640
126401,2,1,408,1232,1640
126410,1,999,50,182,232
126410,2,1,50,182,232
126562,1,999,12790,19816,32606
126562,2,1,7562,9890,17452
126562,4,3,5228,9926,15154
126580,1,999,5769,7250,13019
126580,2,1,3960,4734,8694
126580,4,3,1809,2516,4325
126605,1,999,1266,65,1331
126605,2,1,1266,65,1331
126614,1,999,19688,17660,37348
126614,2,1,16084,14576,30660
126614,4,3,3604,3084,6688
126669,1,999,1456,2306,3762
126669,2,1,1250,1797,3047
126669,4,3,206,509,715
126678,1,999,1155,1443,2598
126678,2,1,1101,1332,2433
126678,4,3,54,111,165
126687,1,999,155,699,854
126687,2,1,155,699,854
126702,1,999,1519,1635,3154
126702,2,1,1519,1635,3154
126711,1,999,6171,4763,10934
126711,2,1,6171,4763,10934
126748,1,999,1021,1340,2361
126748,2,1,1021,1340,2361
126775,1,999,2477,4193,6670
126775,2,1,944,2914,3858
126775,4,3,1533,1279,2812
126784,1,999,164,2,166
126784,2,1,164,2,166
126818,1,999,16735,18402,35137
126818,2,1,12141,13090,25231
126818,4,3,4594,5312,9906
126827,1,999,2490,1795,4285
126827,2,1,1719,1373,3092
126827,4,3,771,422,1193
126854,1,999,20,192,212
126854,2,1,20,192,212
126863,1,999,4167,6021,10188
126863,2,1,4167,6021,10188
126872,1,999,199,526,725
126872,2,1,199,526,725
126915,1,999,1193,1300,2493
126915,2,1,1193,1300,2493
126924,1,999,15,179,194
126924,2,1,15,179,194
126942,1,999,7143,10131,17274
126942,2,1,7143,10131,17274
126951,1,999,1628,104,1732
126951,2,1,1628,104,1732
126979,1,999,650,424,1074
126979,4,3,650,424,1074
127024,1,999,931,576,1507
127024,2,1,931,576,1507
127060,1,999,6053,7709,13762
127060,2,1,2536,3284,5820
127060,4,3,3517,4425,7942
127158,1,999,2937,1426,4363
127158,2,1,2937,1426,4363
127185,1,999,2211,2196,4407
127185,2,1,2211,2196,4407
127200,1,999,11997,16239,28236
127200,2,1,11997,16239,28236
127219,1,999,4,55,59
127219,2,1,4,55,59
127228,1,999,10,346,356
127228,2,1,10,346,356
127273,1,999,130,182,312
127273,4,3,130,182,312
127316,1,999,60,310,370
127316,2,1,60,310,370
127389,1,999,600,902,1502
127389,2,1,600,902,1502
127556,1,999,3845,4955,8800
127556,2,1,3783,4835,8618
127556,4,3,62,120,182
127565,1,999,13233,15841,29074
127565,2,1,13233,15841,29074
127617,1,999,1117,1818,2935
127617,2,1,1117,1818,2935
127653,1,999,404,775,1179
127653,2,1,205,313,518
127653,4,3,199,462,661
127680,1,999,250,362,612
127680,2,1,250,362,612
127699,1,999,142,549,691
127699,2,1,142,549,691
127714,1,999,909,574,1483
127714,2,1,909,574,1483
127732,1,999,1485,2438,3923
127732,2,1,1485,2438,3923
127741,1,999,5447,9885,15332
127741,2,1,4493,7022,11515
127741,4,3,954,2863,3817
127778,1,999,875,1339,2214
127778,2,1,875,1339,2214
127787,1,999,402,1531,1933
127787,2,1,402,1531,1933
127820,1,999,8410,11821,20231
127820,2,1,8410,11821,20231
127839,1,999,115,506,621
127839,2,1,115,506,621
127884,1,999,5078,5761,10839
127884,2,1,5078,5761,10839
127909,1,999,7306,7316,14622
127909,2,1,7306,7316,14622
127918,1,999,5204,9405,14609
127918,2,1,2518,4601,7119
127918,4,3,2686,4804,7490
127945,1,999,262,434,696
127945,2,1,262,434,696
127954,1,999,3,57,60
127954,2,1,0,18,18
127954,4,3,3,39,42
128106,1,999,4680,9924,14604
128106,2,1,3683,4752,8435
128106,4,3,997,5172,6169
128151,1,999,921,763,1684
128151,2,1,921,763,1684
128179,1,999,583,55,638
128179,2,1,583,55,638
128188,1,999,227,763,990
128188,2,1,227,763,990
128258,1,999,1274,1500,2774
128258,2,1,1274,1500,2774
128328,1,999,3691,929,4620
128328,2,1,3691,929,4620
128337,1,999,15,282,297
128337,2,1,15,282,297
128391,1,999,1428,974,2402
128391,2,1,1428,974,2402
128425,1,999,35,0,35
128425,2,1,29,0,29
128425,4,3,6,0,6
128498,1,999,897,1812,2709
128498,2,1,682,1428,2110
128498,4,3,215,384,599
128540,1,999,8,145,153
128540,2,1,8,145,153
128577,1,999,1205,1518,2723
128577,2,1,1205,1518,2723
128586,1,999,59,0,59
128586,2,1,59,0,59
128674,1,999,218,908,1126
128674,2,1,218,908,1126
128683,1,999,255,782,1037
128683,2,1,255,782,1037
128726,1,999,45,196,241
128726,2,1,45,196,241
128744,1,999,2709,3586,6295
128744,2,1,930,1833,2763
128744,4,3,1779,1753,3532
128762,1,999,52,438,490
128762,2,1,52,438,490
128771,1,999,7297,8238,15535
128771,2,1,6036,5781,11817
128771,4,3,1261,2457,3718
128780,1,999,1236,2207,3443
128780,2,1,1236,2207,3443
128896,1,999,101,397,498
128896,2,1,101,397,498
128902,1,999,849,1329,2178
128902,2,1,849,1324,2173
128902,4,3,0,5,5
128957,1,999,76,226,302
128957,2,1,76,226,302
129002,1,999,584,147,731
129002,2,1,584,147,731
129020,1,999,13462,13860,27322
129020,2,1,9125,9026,18151
129020,4,3,4337,4834,9171
129154,1,999,497,2696,3193
129154,2,1,497,2696,3193
129181,1,999,1907,74,1981
129181,2,1,1907,74,1981
129215,1,999,2966,3684,6650
129215,2,1,2810,3308,6118
129215,4,3,156,376,532
129242,1,999,2423,3678,6101
129242,2,1,1901,2628,4529
129242,4,3,522,1050,1572
129349,1,999,30,297,327
129349,2,1,30,297,327
129367,1,999,1786,4364,6150
129367,2,1,1786,4364,6150
129428,1,999,655,176,831
129428,4,3,655,176,831
129446,1,999,30,15,45
129446,2,1,30,15,45
129482,1,999,132,607,739
129482,2,1,132,607,739
129491,1,999,107,115,222
129491,4,3,107,115,222
129525,1,999,3914,4844,8758
129525,2,1,2956,3432,6388
129525,4,3,958,1412,2370
129534,1,999,294,134,428
129534,2,1,33,31,64
129534,4,3,261,103,364
129543,1,999,3069,5297,8366
129543,2,1,3069,5297,8366
129613,1,999,93,218,311
129613,2,1,93,218,311
129640,1,999,15,41,56
129640,2,1,15,41,56
129686,1,999,38,65,103
129686,2,1,37,64,101
129686,4,3,1,1,2
129695,1,999,4771,5555,10326
129695,2,1,4771,5555,10326
129729,1,999,3847,5604,9451
129729,2,1,3847,5604,9451
129756,1,999,1776,2658,4434
129756,2,1,1776,2658,4434
129774,1,999,540,517,1057
129774,2,1,540,517,1057
129808,1,999,2249,3381,5630
129808,2,1,2249,3381,5630
129923,1,999,665,917,1582
129923,2,1,665,917,1582
129932,1,999,1075,100,1175
129932,2,1,1075,100,1175
129941,1,999,3316,3389,6705
129941,2,1,2248,2223,4471
129941,4,3,1068,1166,2234
129969,1,999,111,384,495
129969,2,1,111,384,495
130004,1,999,3854,6148,10002
130004,2,1,3854,6148,10002
130040,1,999,773,1606,2379
130040,2,1,773,1606,2379
130110,1,999,88,163,251
130110,2,1,88,163,251
130129,1,999,36,136,172
130129,2,1,36,136,172
130174,1,999,3348,1715,5063
130174,2,1,3348,1715,5063
130183,1,999,2295,3413,5708
130183,2,1,2008,2761,4769
130183,4,3,287,652,939
130217,1,999,994,1974,2968
130217,2,1,994,1974,2968
130226,1,999,3239,5406,8645
130226,2,1,2387,3859,6246
130226,4,3,852,1547,2399
130253,1,999,2731,4689,7420
130253,2,1,1914,2914,4828
130253,4,3,817,1775,2592
130314,1,999,215,2365,2580
130314,2,1,11,1089,1100
130314,4,3,204,1276,1480
130396,1,999,4068,6297,10365
130396,2,1,4068,6297,10365
130448,1,999,92,523,615
130448,2,1,92,523,615
130493,1,999,4829,9346,14175
130493,2,1,3715,6099,9814
130493,4,3,1114,3247,4361
130509,1,999,80,622,702
130509,2,1,80,622,702
130581,1,999,41,121,162
130581,4,3,41,121,162
130590,1,999,1329,1337,2666
130590,2,1,1225,1249,2474
130590,4,3,104,88,192
130606,1,999,2736,3962,6698
130606,2,1,2736,3962,6698
130624,1,999,710,265,975
130624,2,1,710,265,975
130697,1,999,1677,1749,3426
130697,2,1,1471,1517,2988
130697,4,3,206,232,438
130776,1,999,3504,4423,7927
130776,2,1,3190,3735,6925
130776,4,3,314,688,1002
130785,1,999,1,11,12
130785,4,3,1,11,12
130794,1,999,6128,6334,12462
130794,2,1,2974,3082,6056
130794,4,3,3154,3252,6406
130837,1,999,7,47,54
130837,2,1,7,47,54
130873,1,999,74,595,669
130873,2,1,74,595,669
130891,1,999,2221,4145,6366
130891,2,1,2221,4145,6366
130907,1,999,1603,3157,4760
130907,2,1,1603,3157,4760
130916,1,999,4254,6134,10388
130916,2,1,4254,6134,10388
130934,1,999,1683,2487,4170
130934,2,1,1504,2181,3685
130934,4,3,179,306,485
130943,1,999,10256,13424,23680
130943,2,1,8265,11289,19554
130943,4,3,1991,2135,4126
130989,1,999,767,751,1518
130989,2,1,322,426,748
130989,4,3,445,325,770
131061,1,999,12,210,222
131061,2,1,12,210,222
131098,1,999,1110,1403,2513
131098,2,1,1033,1221,2254
131098,4,3,77,182,259
131113,1,999,4664,8780,13444
131113,2,1,2904,4897,7801
131113,4,3,1760,3883,5643
131159,1,999,5570,8594,14164
131159,2,1,3067,4638,7705
131159,4,3,2503,3956,6459
131283,1,999,3395,3893,7288
131283,2,1,1674,1947,3621
131283,4,3,1721,1946,3667
131308,1,999,209,730,939
131308,2,1,187,514,701
131308,4,3,22,216,238
131399,1,999,4420,7482,11902
131399,2,1,4259,7198,11457
131399,4,3,161,284,445
131405,1,999,85,16,101
131405,4,3,85,16,101
131450,1,999,608,914,1522
131450,2,1,519,586,1105
131450,4,3,89,328,417
131469,1,999,13248,16728,29976
131469,2,1,5397,6499,11896
131469,4,3,7851,10229,18080
131496,1,999,9570,10109,19679
131496,2,1,4278,5132,9410
131496,4,3,5292,4977,10269
131520,1,999,3922,7115,11037
131520,2,1,2499,4906,7405
131520,4,3,1423,2209,3632
131566,1,999,7,120,127
131566,2,1,7,120,127
131742,1,999,419,1563,1982
131742,2,1,419,1563,1982
131803,1,999,1435,2333,3768
131803,2,1,1047,1764,2811
131803,4,3,388,569,957
131830,1,999,13,19,32
131830,2,1,13,19,32
131876,1,999,249,2339,2588
131876,2,1,98,1615,1713
131876,4,3,151,724,875
131973,1,999,366,415,781
131973,4,3,366,415,781
132268,1,999,1540,56,1596
132268,2,1,1540,56,1596
132338,1,999,1927,2402,4329
132338,2,1,1927,2402,4329
132374,1,999,866,860,1726
132374,2,1,866,860,1726
132408,1,999,475,283,758
132408,2,1,475,283,758
132471,1,999,3023,6516,9539
132471,2,1,1610,3544,5154
132471,4,3,1413,2972,4385
132523,1,999,34,18,52
132523,4,3,34,18,52
132602,1,999,1557,2274,3831
132602,2,1,1536,2255,3791
132602,4,3,21,19,40
132657,1,999,1295,1287,2582
132657,2,1,1009,972,1981
132657,4,3,286,315,601
132666,1,999,82,183,265
132666,2,1,82,183,265
132675,1,999,186,160,346
132675,2,1,186,160,346
132693,1,999,10580,14353,24933
132693,2,1,10580,14353,24933
132709,1,999,22938,33399,56337
132709,2,1,22938,33399,56337
132806,1,999,168,570,738
132806,2,1,168,570,738
132842,1,999,273,1061,1334
132842,2,1,103,376,479
132842,4,3,170,685,855
132851,1,999,4589,7127,11716
132851,2,1,4589,7127,11716
132879,1,999,175,132,307
132879,2,1,175,132,307
132903,1,999,27785,35368,63153
132903,2,1,23543,28980,52523
132903,4,3,4242,6388,10630
132976,1,999,188,419,607
132976,2,1,188,419,607
133021,1,999,1229,1849,3078
133021,2,1,1229,1849,3078
133085,1,999,310,307,617
133085,2,1,306,300,606
133085,4,3,4,7,11
133155,1,999,346,470,816
133155,2,1,346,470,816
133386,1,999,9590,14687,24277
133386,2,1,9590,14687,24277
133465,1,999,305,1121,1426
133465,2,1,286,1067,1353
133465,4,3,19,54,73
133492,1,999,1141,1717,2858
133492,2,1,1141,1717,2858
133508,1,999,8885,13823,22708
133508,2,1,8885,13823,22708
133526,1,999,537,406,943
133526,2,1,537,406,943
133553,1,999,4503,986,5489
133553,2,1,4054,834,4888
133553,4,3,449,152,601
133650,1,999,5592,8050,13642
133650,2,1,4714,6593,11307
133650,4,3,878,1457,2335
133669,1,999,14391,21130,35521
133669,2,1,11972,16662,28634
133669,4,3,2419,4468,6887
133702,1,999,19154,28320,47474
133702,2,1,19154,28320,47474
133711,1,999,1194,1747,2941
133711,2,1,1194,1747,2941
133809,1,999,234,265,499
133809,2,1,234,265,499
133845,1,999,120,860,980
133845,2,1,120,860,980
133854,1,999,119,569,688
133854,2,1,119,569,688
133863,1,999,132,618,750
133863,2,1,132,618,750
133872,1,999,711,2863,3574
133872,2,1,690,2819,3509
133872,4,3,21,44,65
133881,1,999,6856,7185,14041
133881,2,1,4185,5162,9347
133881,4,3,2671,2023,4694
133942,1,999,15,89,104
133942,2,1,15,89,104
133951,1,999,22453,29339,51792
133951,2,1,18269,22869,41138
133951,4,3,4184,6470,10654
133960,1,999,1072,1440,2512
133960,2,1,1072,1440,2512
133979,1,999,916,1371,2287
133979,2,1,890,1299,2189
133979,4,3,26,72,98
133997,1,999,3099,5715,8814
133997,2,1,3099,5715,8814
134024,1,999,58,143,201
134024,2,1,58,143,201
134079,1,999,1088,1839,2927
134079,2,1,1034,1709,2743
134079,4,3,54,130,184
134097,1,999,20232,24928,45160
134097,2,1,15542,18673,34215
134097,4,3,4690,6255,10945
134112,1,999,769,1992,2761
134112,2,1,769,1992,2761
134121,1,999,110,206,316
134121,2,1,110,206,316
134130,1,999,27218,31408,58626
134130,2,1,17124,20532,37656
134130,4,3,10094,10876,20970
134149,1,999,1079,2324,3403
134149,2,1,967,1972,2939
134149,4,3,112,352,464
134228,1,999,14,28,42
134228,2,1,14,28,42
134237,1,999,11758,4086,15844
134237,2,1,10288,2734,13022
134237,4,3,1470,1352,2822
134291,1,999,921,380,1301
134291,2,1,921,380,1301
134307,1,999,1173,72,1245
134307,2,1,1173,72,1245
134343,1,999,4474,6435,10909
134343,2,1,4474,6435,10909
134422,1,999,20,97,117
134422,2,1,20,97,117
134495,1,999,16883,22456,39339
134495,2,1,16883,22456,39339
134510,1,999,59,62,121
134510,2,1,59,62,121
134529,1,999,8,220,228
134529,2,1,8,220,228
134574,1,999,73,158,231
134574,2,1,73,158,231
134608,1,999,10491,15942,26433
134608,2,1,10491,15942,26433
134680,1,999,1057,1185,2242
134680,2,1,1052,1171,2223
134680,4,3,5,14,19
134714,1,999,74,418,492
134714,2,1,74,418,492
134811,1,999,2376,2982,5358
134811,2,1,2311,2918,5229
134811,4,3,65,64,129
134875,1,999,351,1134,1485
134875,2,1,351,1134,1485
134909,1,999,1213,285,1498
134909,2,1,1213,285,1498
134945,1,999,1766,3122,4888
134945,2,1,1536,2814,4350
134945,4,3,230,308,538
135063,1,999,228,827,1055
135063,2,1,228,827,1055
135081,1,999,8557,20665,29222
135081,2,1,8329,20175,28504
135081,4,3,228,490,718
135124,1,999,482,1096,1578
135124,2,1,482,1096,1578
135142,1,999,9,640,649
135142,2,1,9,640,649
135160,1,999,1623,2963,4586
135160,2,1,1623,2963,4586
135179,1,999,392,472,864
135179,2,1,392,472,864
135188,1,999,2430,4155,6585
135188,2,1,2430,4155,6585
135267,1,999,563,770,1333
135267,2,1,563,770,1333
135276,1,999,958,937,1895
135276,2,1,958,937,1895
135294,1,999,975,768,1743
135294,2,1,975,768,1743
135337,1,999,56,335,391
135337,2,1,56,335,391
135364,1,999,1050,374,1424
135364,2,1,345,139,484
135364,4,3,705,235,940
135391,1,999,7136,11170,18306
135391,2,1,7136,11170,18306
135407,1,999,1045,984,2029
135407,2,1,1045,984,2029
135416,1,999,212,951,1163
135416,2,1,212,951,1163
135434,1,999,241,845,1086
135434,2,1,241,845,1086
135522,1,999,394,384,778
135522,2,1,394,384,778
135610,1,999,146,277,423
135610,2,1,82,199,281
135610,4,3,64,78,142
135647,1,999,1529,637,2166
135647,2,1,1529,637,2166
135717,1,999,39322,55844,95166
135717,2,1,39322,55844,95166
135726,1,999,8491,9217,17708
135726,2,1,5537,6151,11688
135726,4,3,2954,3066,6020
135735,1,999,2724,373,3097
135735,2,1,2724,373,3097
135771,1,999,337,945,1282
135771,2,1,337,945,1282
135939,1,999,237,335,572
135939,2,1,237,335,572
135957,1,999,962,1331,2293
135957,2,1,962,1331,2293
136011,1,999,530,1678,2208
136011,2,1,530,1678,2208
136048,1,999,34,167,201
136048,2,1,34,167,201
136066,1,999,1782,2425,4207
136066,2,1,1782,2425,4207
136075,1,999,46,429,475
136075,2,1,46,429,475
136109,1,999,25,223,248
136109,2,1,25,223,248
136145,1,999,598,1147,1745
136145,2,1,598,1147,1745
136172,1,999,8469,11112,19581
136172,2,1,7532,9596,17128
136172,4,3,937,1516,2453
136206,1,999,465,355,820
136206,2,1,465,355,820
136215,1,999,11014,26183,37197
136215,2,1,2002,5233,7235
136215,4,3,9012,20950,29962
136233,1,999,4797,6733,11530
136233,2,1,4797,6733,11530
136251,1,999,10,101,111
136251,2,1,10,101,111
136288,1,999,929,2159,3088
136288,2,1,878,2100,2978
136288,4,3,51,59,110
136303,1,999,339,930,1269
136303,2,1,339,930,1269
136330,1,999,1268,2331,3599
136330,2,1,977,1696,2673
136330,4,3,291,635,926
136358,1,999,17921,24518,42439
136358,2,1,17921,24518,42439
136400,1,999,5357,8708,14065
136400,2,1,5357,8708,14065
136473,1,999,6794,10338,17132
136473,2,1,6794,10338,17132
136491,1,999,1361,692,2053
136491,2,1,1361,692,2053
136516,1,999,5347,8849,14196
136516,2,1,5347,8849,14196
136659,1,999,228,151,379
136659,2,1,228,151,379
136701,1,999,75,4,79
136701,4,3,75,4,79
136738,1,999,1708,281,1989
136738,2,1,1708,281,1989
136747,1,999,2269,120,2389
136747,2,1,2269,120,2389
136765,1,999,536,465,1001
136765,2,1,536,465,1001
136774,1,999,572,763,1335
136774,2,1,572,763,1335
136783,1,999,8,84,92
136783,2,1,8,84,92
136826,1,999,793,1188,1981
136826,2,1,793,1188,1981
136950,1,999,1616,2095,3711
136950,2,1,1188,1642,2830
136950,4,3,428,453,881
137023,1,999,676,622,1298
137023,2,1,676,622,1298
137032,1,999,9208,13087,22295
137032,2,1,7777,10890,18667
137032,4,3,1431,2197,3628
137078,1,999,16380,24476,40856
137078,2,1,16380,24476,40856
137087,1,999,1021,1089,2110
137087,2,1,1021,1089,2110
137096,1,999,9574,11456,21030
137096,2,1,9574,11456,21030
137120,1,999,523,587,1110
137120,2,1,523,587,1110
137148,1,999,647,2044,2691
137148,2,1,40,109,149
137148,4,3,607,1935,2542
137209,1,999,10474,14191,24665
137209,2,1,10474,14191,24665
137245,1,999,1277,1701,2978
137245,2,1,1277,1701,2978
137272,1,999,78,0,78
137272,2,1,62,0,62
137272,4,3,16,0,16
137281,1,999,3632,5579,9211
137281,2,1,3632,5579,9211
137315,1,999,1827,2501,4328
137315,2,1,1827,2501,4328
137351,1,999,19898,27839,47737
137351,2,1,15392,20106,35498
137351,4,3,4506,7733,12239
137476,1,999,1810,2617,4427
137476,2,1,1070,1591,2661
137476,4,3,740,1026,1766
137537,1,999,30,364,394
137537,2,1,30,364,394
137546,1,999,1803,2333,4136
137546,2,1,966,1265,2231
137546,4,3,837,1068,1905
137564,1,999,1398,1924,3322
137564,2,1,1240,1679,2919
137564,4,3,158,245,403
137591,1,999,126,341,467
137591,2,1,126,341,467
137713,1,999,56,217,273
137713,2,1,56,217,273
137759,1,999,9173,11535,20708
137759,2,1,9173,11535,20708
137777,1,999,55,0,55
137777,2,1,33,0,33
137777,4,3,22,0,22
137801,1,999,1662,1746,3408
137801,2,1,1647,1712,3359
137801,4,3,15,34,49
137810,1,999,570,1467,2037
137810,2,1,554,1440,1994
137810,4,3,16,27,43
137847,1,999,3143,4045,7188
137847,2,1,2662,3501,6163
137847,4,3,481,544,1025
137856,1,999,218,212,430
137856,2,1,218,212,430
137865,1,999,414,370,784
137865,2,1,414,370,784
137892,1,999,646,782,1428
137892,2,1,646,782,1428
137953,1,999,163,132,295
137953,2,1,146,126,272
137953,4,3,17,6,23
137962,1,999,138,93,231
137962,2,1,138,93,231
138132,1,999,18,120,138
138132,2,1,18,120,138
138187,1,999,24103,31442,55545
138187,2,1,24103,31442,55545
138275,1,999,524,764,1288
138275,2,1,469,659,1128
138275,4,3,55,105,160
138284,1,999,659,734,1393
138284,2,1,659,734,1393
138293,1,999,584,281,865
138293,2,1,549,229,778
138293,4,3,35,52,87
138309,1,999,1870,5437,7307
138309,2,1,1870,5437,7307
138354,1,999,5618,8482,14100
138354,2,1,4706,6727,11433
138354,4,3,912,1755,2667
138372,1,999,619,804,1423
138372,2,1,619,804,1423
138479,1,999,1142,906,2048
138479,2,1,1142,906,2048
138488,1,999,324,701,1025
138488,2,1,324,701,1025
138497,1,999,315,238,553
138497,2,1,315,238,553
138558,1,999,1787,2315,4102
138558,2,1,1787,2315,4102
138594,1,999,674,2643,3317
138594,2,1,674,2643,3317
138600,1,999,30,948,978
138600,2,1,20,912,932
138600,4,3,10,36,46
138655,1,999,338,75,413
138655,2,1,338,75,413
138664,1,999,36,37,73
138664,2,1,36,37,73
138682,1,999,2726,3716,6442
138682,2,1,2726,3716,6442
138691,1,999,2553,5849,8402
138691,2,1,2553,5849,8402
138716,1,999,1673,3517,5190
138716,2,1,1539,3048,4587
138716,4,3,134,469,603
138761,1,999,169,219,388
138761,2,1,169,219,388
138789,1,999,3004,5926,8930
138789,2,1,2647,4735,7382
138789,4,3,357,1191,1548
138813,1,999,3110,2567,5677
138813,2,1,3110,2567,5677
138822,1,999,131,1393,1524
138822,2,1,131,1393,1524
138840,1,999,3418,4548,7966
138840,2,1,3418,4548,7966
138868,1,999,440,681,1121
138868,2,1,440,681,1121
138901,1,999,1385,2636,4021
138901,2,1,1385,2636,4021
138929,1,999,272,286,558
138929,4,3,272,286,558
138938,1,999,73,300,373
138938,2,1,73,300,373
138947,1,999,1222,3071,4293
138947,2,1,989,2544,3533
138947,4,3,233,527,760
138956,1,999,2946,4733,7679
138956,2,1,2946,4733,7679
138983,1,999,3144,5666,8810
138983,2,1,2648,4471,7119
138983,4,3,496,1195,1691
139010,1,999,1673,3550,5223
139010,2,1,1673,3550,5223
139074,1,999,536,1310,1846
139074,2,1,536,1310,1846
139092,1,999,8,137,145
139092,2,1,8,137,145
139144,1,999,659,1409,2068
139144,2,1,588,1251,1839
139144,4,3,71,158,229
139153,1,999,437,574,1011
139153,2,1,328,464,792
139153,4,3,109,110,219
139199,1,999,465,3042,3507
139199,2,1,232,2067,2299
139199,4,3,233,975,1208
139205,1,999,683,802,1485
139205,2,1,683,802,1485
139214,1,999,21,349,370
139214,2,1,21,349,370
139250,1,999,1367,2888,4255
139250,2,1,1367,2888,4255
139278,1,999,3947,7937,11884
139278,2,1,3947,7937,11884
139287,1,999,219,90,309
139287,2,1,219,90,309
139311,1,999,2607,5992,8599
139311,2,1,2456,5889,8345
139311,4,3,151,103,254
139348,1,999,230,191,421
139348,4,3,230,191,421
139357,1,999,2266,4521,6787
139357,2,1,2266,4521,6787
139366,1,999,4162,6090,10252
139366,2,1,3506,5100,8606
139366,4,3,656,990,1646
139384,1,999,3742,6052,9794
139384,2,1,3742,6052,9794
139393,1,999,626,897,1523
139393,2,1,601,859,1460
139393,4,3,25,38,63
139463,1,999,2815,4339,7154
139463,2,1,2815,4339,7154
139506,1,999,142,184,326
139506,2,1,142,184,326
139533,1,999,4704,5345,10049
139533,2,1,3697,3729,7426
139533,4,3,1007,1616,2623
139579,1,999,6669,21204,27873
139579,2,1,6019,19226,25245
139579,4,3,650,1978,2628
139621,1,999,1536,2180,3716
139621,2,1,1536,2180,3716
139630,1,999,363,423,786
139630,2,1,363,423,786
139658,1,999,6252,7912,14164
139658,2,1,3326,4086,7412
139658,4,3,2926,3826,6752
139700,1,999,2659,4476,7135
139700,2,1,2659,4476,7135
139719,1,999,1838,2403,4241
139719,2,1,1779,2231,4010
139719,4,3,59,172,231
139746,1,999,18,66,84
139746,2,1,18,66,84
139755,1,999,16091,6304,22395
139755,2,1,10366,4424,14790
139755,4,3,5725,1880,7605
139764,1,999,1219,2458,3677
139764,2,1,1144,2057,3201
139764,4,3,75,401,476
139773,1,999,5194,6244,11438
139773,2,1,5194,6244,11438
139861,1,999,3128,4640,7768
139861,2,1,2583,3731,6314
139861,4,3,545,909,1454
139904,1,999,979,907,1886
139904,2,1,979,907,1886
139931,1,999,10839,11467,22306
139931,2,1,9701,9199,18900
139931,4,3,1138,2268,3406
139940,1,999,14523,22416,36939
139940,2,1,10610,16321,26931
139940,4,3,3913,6095,10008
139959,1,999,16355,22813,39168
139959,2,1,12256,16826,29082
139959,4,3,4099,5987,10086
139968,1,999,1958,3840,5798
139968,2,1,1958,3840,5798
139986,1,999,3419,6742,10161
139986,2,1,3419,6742,10161
139995,1,999,138,119,257
139995,2,1,138,119,257
140003,1,999,121,656,777
140003,2,1,121,656,777
140012,1,999,4436,6247,10683
140012,2,1,4436,6247,10683
140076,1,999,1263,1710,2973
140076,2,1,1263,1710,2973
140085,1,999,3323,3857,7180
140085,2,1,3323,3857,7180
140146,1,999,253,208,461
140146,4,3,253,208,461
140164,1,999,11170,16293,27463
140164,2,1,9942,14615,24557
140164,4,3,1228,1678,2906
140234,1,999,491,731,1222
140234,2,1,417,538,955
140234,4,3,74,193,267
140243,1,999,2534,4316,6850
140243,2,1,2534,4316,6850
140252,1,999,1543,1165,2708
140252,2,1,439,354,793
140252,4,3,1104,811,1915
140304,1,999,4003,7645,11648
140304,2,1,4003,7645,11648
140322,1,999,2989,5908,8897
140322,2,1,2989,5908,8897
140331,1,999,7840,11741,19581
140331,2,1,7840,11741,19581
140340,1,999,365,594,959
140340,2,1,365,594,959
140401,1,999,931,1789,2720
140401,2,1,84,541,625
140401,4,3,847,1248,2095
140447,1,999,3066,6300,9366
140447,2,1,1595,3574,5169
140447,4,3,1471,2726,4197
140483,1,999,2145,2551,4696
140483,2,1,2145,2551,4696
140553,1,999,2840,0,2840
140553,2,1,2840,0,2840
140562,1,999,101,229,330
140562,4,3,101,229,330
140599,1,999,1590,2498,4088
140599,2,1,1590,2498,4088
140669,1,999,2738,3942,6680
140669,2,1,2536,3295,5831
140669,4,3,202,647,849
140678,1,999,1856,2588,4444
140678,2,1,1856,2588,4444
140696,1,999,482,814,1296
140696,2,1,472,730,1202
140696,4,3,10,84,94
140711,1,999,3,99,102
140711,2,1,3,99,102
140720,1,999,426,722,1148
140720,2,1,426,722,1148
140818,1,999,712,2493,3205
140818,2,1,414,971,1385
140818,4,3,298,1522,1820
140827,1,999,70,88,158
140827,2,1,70,88,158
140872,1,999,1056,1568,2624
140872,2,1,1014,1466,2480
140872,4,3,42,102,144
140942,1,999,3378,6259,9637
140942,2,1,3378,6259,9637
140951,1,999,4412,6533,10945
140951,2,1,3509,5243,8752
140951,4,3,903,1290,2193
140960,1,999,1913,2499,4412
140960,2,1,1874,2376,4250
140960,4,3,39,123,162
140988,1,999,746,717,1463
140988,2,1,746,717,1463
140997,1,999,991,1638,2629
140997,2,1,991,1638,2629
141006,1,999,2160,2142,4302
141006,2,1,2160,2142,4302
141015,1,999,189,179,368
141015,2,1,189,179,368
141060,1,999,0,2279,2279
141060,2,1,0,2279,2279
141097,1,999,4889,1410,6299
141097,2,1,4314,1074,5388
141097,4,3,575,336,911
141158,1,999,895,1842,2737
141158,2,1,895,1842,2737
141167,1,999,385,900,1285
141167,2,1,341,708,1049
141167,4,3,44,192,236
141185,1,999,397,483,880
141185,2,1,397,483,880
141237,1,999,273,305,578
141237,2,1,273,305,578
141255,1,999,3314,5834,9148
141255,2,1,3314,5834,9148
141264,1,999,5585,8896,14481
141264,2,1,4859,6762,11621
141264,4,3,726,2134,2860
141307,1,999,536,1173,1709
141307,2,1,536,1173,1709
141325,1,999,39,801,840
141325,2,1,26,707,733
141325,4,3,13,94,107
141334,1,999,5142,8571,13713
141334,2,1,4489,6644,11133
141334,4,3,653,1927,2580
141361,1,999,353,411,764
141361,2,1,353,411,764
141468,1,999,913,1646,2559
141468,2,1,913,1646,2559
141486,1,999,1404,2414,3818
141486,2,1,1111,1680,2791
141486,4,3,293,734,1027
141565,1,999,1955,2892,4847
141565,2,1,1717,2480,4197
141565,4,3,238,412,650
141574,1,999,10998,13969,24967
141574,2,1,7739,9307,17046
141574,4,3,3259,4662,7921
141608,1,999,47,108,155
141608,2,1,47,108,155
141644,1,999,4606,5578,10184
141644,2,1,3926,4729,8655
141644,4,3,680,849,1529
141680,1,999,3514,3093,6607
141680,2,1,3514,3093,6607
141796,1,999,5600,7692,13292
141796,2,1,5600,7692,13292
141802,1,999,676,1082,1758
141802,2,1,676,1082,1758
141811,1,999,4179,6323,10502
141811,2,1,4179,6323,10502
141839,1,999,1981,3668,5649
141839,2,1,1981,3668,5649
141848,1,999,12,226,238
141848,2,1,12,226,238
141936,1,999,22,28,50
141936,4,3,22,28,50
141945,1,999,72,174,246
141945,2,1,72,174,246
141981,1,999,491,1161,1652
141981,2,1,491,1161,1652
141990,1,999,1342,2013,3355
141990,2,1,1342,2013,3355
142054,1,999,238,1070,1308
142054,2,1,238,1070,1308
142090,1,999,106,81,187
142090,2,1,106,81,187
142115,1,999,11835,15627,27462
142115,2,1,9994,11342,21336
142115,4,3,1841,4285,6126
142179,1,999,626,981,1607
142179,2,1,626,981,1607
142276,1,999,8691,11238,19929
142276,2,1,7117,9216,16333
142276,4,3,1574,2022,3596
142285,1,999,8365,8172,16537
142285,2,1,5953,5345,11298
142285,4,3,2412,2827,5239
142294,1,999,449,618,1067
142294,2,1,441,607,1048
142294,4,3,8,11,19
142328,1,999,2138,3198,5336
142328,2,1,2138,3198,5336
142337,1,999,777,273,1050
142337,2,1,777,273,1050
142407,1,999,1,71,72
142407,2,1,1,71,72
142416,1,999,3,40,43
142416,2,1,3,40,43
142443,1,999,3094,4517,7611
142443,2,1,3094,4517,7611
142461,1,999,991,1395,2386
142461,2,1,658,920,1578
142461,4,3,333,475,808
142489,1,999,1,115,116
142489,2,1,1,115,116
142522,1,999,9478,11548,21026
142522,2,1,9478,11548,21026
142559,1,999,4948,8235,13183
142559,2,1,4948,8235,13183
142832,1,999,163,566,729
142832,4,3,163,566,729
142869,1,999,2,60,62
142869,2,1,2,60,62
142878,1,999,4,33,37
142878,2,1,4,33,37
142887,1,999,248,200,448
142887,2,1,248,200,448
143048,1,999,1103,2211,3314
143048,2,1,870,1692,2562
143048,4,3,233,519,752
143075,1,999,125,497,622
143075,2,1,125,497,622
143084,1,999,1071,1403,2474
143084,2,1,1071,1403,2474
143118,1,999,2165,6760,8925
143118,2,1,893,1850,2743
143118,4,3,1272,4910,6182
143181,1,999,7,65,72
143181,2,1,7,65,72
143215,1,999,12703,13374,26077
143215,2,1,12703,13374,26077
143233,1,999,34,35,69
143233,4,3,34,35,69
143279,1,999,6052,7345,13397
143279,2,1,6052,7345,13397
143288,1,999,262,363,625
143288,2,1,262,363,625
143297,1,999,21,213,234
143297,2,1,21,203,224
143297,4,3,0,10,10
143303,1,999,2,18,20
143303,2,1,2,18,20
143358,1,999,2898,3342,6240
143358,2,1,2431,2854,5285
143358,4,3,467,488,955
143376,1,999,7,252,259
143376,2,1,7,252,259
143464,1,999,4,193,197
143464,2,1,4,193,197
143473,1,999,1,89,90
143473,2,1,1,89,90
143482,1,999,1,139,140
143482,2,1,1,139,140
143491,1,999,2,183,185
143491,2,1,2,183,185
143516,1,999,3,126,129
143516,2,1,3,126,129
143534,1,999,2,162,164
143534,2,1,2,162,164
143543,1,999,18,186,204
143543,2,1,18,186,204
143552,1,999,10,182,192
143552,2,1,10,182,192
143613,1,999,1802,2955,4757
143613,2,1,1802,2955,4757
143659,1,999,316,217,533
143659,4,3,316,217,533
143695,1,999,2,59,61
143695,2,1,2,59,61
143853,1,999,833,1382,2215
143853,4,3,833,1382,2215
143978,1,999,583,2479,3062
143978,4,3,583,2479,3062
144005,1,999,2699,6228,8927
144005,2,1,1931,4590,6521
144005,4,3,768,1638,2406
144014,1,999,122,120,242
144014,4,3,122,120,242
144050,1,999,9128,6837,15965
144050,2,1,2643,2575,5218
144050,4,3,6485,4262,10747
144157,1,999,4718,7506,12224
144157,2,1,4718,7506,12224
144166,1,999,5582,9071,14653
144166,2,1,5582,9071,14653
144175,1,999,2807,5553,8360
144175,2,1,2807,5553,8360
144184,1,999,9866,11692,21558
144184,2,1,9866,11692,21558
144193,1,999,6774,8999,15773
144193,2,1,6774,8999,15773
144209,1,999,7853,7819,15672
144209,2,1,7853,7819,15672
144218,1,999,8563,11375,19938
144218,2,1,8563,11375,19938
144281,1,999,6299,7078,13377
144281,2,1,6112,6661,12773
144281,4,3,187,417,604
144351,1,999,1640,4712,6352
144351,2,1,577,771,1348
144351,4,3,1063,3941,5004
144467,1,999,1027,650,1677
144467,2,1,1027,650,1677
144485,1,999,1465,404,1869
144485,2,1,1465,404,1869
144564,1,999,3773,5457,9230
144564,2,1,3773,5457,9230
144573,1,999,6,77,83
144573,2,1,6,77,83
144616,1,999,1,44,45
144616,2,1,1,44,45
144740,1,999,13636,15690,29326
144740,2,1,8628,10427,19055
144740,4,3,5008,5263,10271
144759,1,999,26295,27043,53338
144759,2,1,21153,19596,40749
144759,4,3,5142,7447,12589
144795,1,999,9,270,279
144795,2,1,9,270,279
144865,1,999,23131,27205,50336
144865,2,1,23131,27205,50336
144883,1,999,609,840,1449
144883,2,1,609,840,1449
144892,1,999,5182,7244,12426
144892,2,1,4361,5904,10265
144892,4,3,821,1340,2161
144944,1,999,8554,10608,19162
144944,2,1,8554,10608,19162
144962,1,999,1393,2241,3634
144962,2,1,1264,2072,3336
144962,4,3,129,169,298
144971,1,999,371,472,843
144971,2,1,371,472,843
145099,1,999,13,195,208
145099,2,1,13,195,208
145239,1,999,79,516,595
145239,2,1,79,516,595
145275,1,999,185,233,418
145275,4,3,185,233,418
145309,1,999,22,45,67
145309,2,1,22,45,67
145336,1,999,2272,5377,7649
145336,2,1,1246,2475,3721
145336,4,3,1026,2902,3928
145354,1,999,4,72,76
145354,2,1,4,72,76
145372,1,999,841,1186,2027
145372,2,1,724,844,1568
145372,4,3,117,342,459
145406,1,999,22,447,469
145406,2,1,22,447,469
145424,1,999,3,169,172
145424,2,1,3,169,172
145433,1,999,13,172,185
145433,2,1,13,172,185
145460,1,999,345,1218,1563
145460,2,1,344,1213,1557
145460,4,3,1,5,6
145497,1,999,93,405,498
145497,2,1,77,405,482
145497,4,3,16,0,16
145521,1,999,1281,2421,3702
145521,2,1,1281,2421,3702
145558,1,999,973,1187,2160
145558,4,3,973,1187,2160
145600,1,999,13686,16740,30426
145600,2,1,8626,9354,17980
145600,4,3,5060,7386,12446
145619,1,999,3002,5817,8819
145619,2,1,1775,2540,4315
145619,4,3,1227,3277,4504
145628,1,999,225,415,640
145628,4,3,225,415,640
145637,1,999,25047,22188,47235
145637,2,1,17646,15015,32661
145637,4,3,7401,7173,14574
145646,1,999,862,1228,2090
145646,2,1,862,1228,2090
145682,1,999,8842,10945,19787
145682,2,1,8842,10945,19787
145691,1,999,458,468,926
145691,2,1,458,468,926
145707,1,999,984,1901,2885
145707,2,1,984,1901,2885
145725,1,999,5523,3020,8543
145725,2,1,1998,820,2818
145725,4,3,3525,2200,5725
145770,1,999,521,1321,1842
145770,2,1,95,234,329
145770,4,3,426,1087,1513
145813,1,999,10182,13553,23735
145813,2,1,8800,10970,19770
145813,4,3,1382,2583,3965
145831,1,999,3779,4581,8360
145831,2,1,3779,4581,8360
145886,1,999,14,88,102
145886,4,3,14,88,102
146010,1,999,1094,1671,2765
146010,2,1,1094,1671,2765
146205,1,999,7729,11673,19402
146205,2,1,7729,11673,19402
146241,1,999,1015,852,1867
146241,4,3,1015,852,1867
146278,1,999,1855,2661,4516
146278,2,1,1855,2661,4516
146296,1,999,13579,15618,29197
146296,2,1,13579,15618,29197
146339,1,999,647,910,1557
146339,2,1,580,792,1372
146339,4,3,67,118,185
146348,1,999,4214,5965,10179
146348,2,1,4214,5965,10179
146366,1,999,4281,5779,10060
146366,2,1,4281,5779,10060
146393,1,999,947,2367,3314
146393,2,1,947,2367,3314
146418,1,999,3577,4140,7717
146418,2,1,3577,4140,7717
146427,1,999,577,867,1444
146427,2,1,577,867,1444
146454,1,999,4,95,99
146454,2,1,4,95,99
146472,1,999,14284,16978,31262
146472,2,1,14284,16978,31262
146481,1,999,621,885,1506
146481,2,1,608,869,1477
146481,4,3,13,16,29
146490,1,999,574,408,982
146490,4,3,574,408,982
146506,1,999,12258,7745,20003
146506,2,1,12258,7745,20003
146533,1,999,48,274,322
146533,2,1,48,274,322
146603,1,999,5436,6724,12160
146603,2,1,5436,6724,12160
146612,1,999,2742,4289,7031
146612,2,1,1963,2636,4599
146612,4,3,779,1653,2432
146621,1,999,0,57,57
146621,2,1,0,57,57
146667,1,999,637,521,1158
146667,2,1,367,391,758
146667,4,3,270,130,400
146676,1,999,640,966,1606
146676,2,1,640,966,1606
146685,1,999,6440,8672,15112
146685,2,1,6440,8672,15112
146700,1,999,1881,826,2707
146700,2,1,1881,826,2707
146719,1,999,6546,11623,18169
146719,2,1,4025,7134,11159
146719,4,3,2521,4489,7010
146728,1,999,160,165,325
146728,4,3,160,165,325
146755,1,999,63,264,327
146755,2,1,63,264,327
146791,1,999,396,476,872
146791,2,1,396,476,872
146807,1,999,19,81,100
146807,2,1,19,81,100
146816,1,999,35,191,226
146816,2,1,35,191,226
146825,1,999,209,369,578
146825,2,1,209,369,578
146977,1,999,131,134,265
146977,4,3,131,134,265
147004,1,999,5120,6292,11412
147004,2,1,5120,6292,11412
147013,1,999,1618,2584,4202
147013,2,1,1209,1561,2770
147013,4,3,409,1023,1432
147031,1,999,63,96,159
147031,4,3,63,96,159
147129,1,999,25,264,289
147129,2,1,25,264,289
147165,1,999,168,668,836
147165,2,1,168,668,836
147244,1,999,1034,1619,2653
147244,2,1,1010,1573,2583
147244,4,3,24,46,70
147341,1,999,677,710,1387
147341,2,1,677,710,1387
147369,1,999,2239,1611,3850
147369,2,1,1709,1316,3025
147369,4,3,530,295,825
147378,1,999,14484,16960,31444
147378,2,1,14484,16960,31444
147396,1,999,102,11,113
147396,2,1,102,11,113
147411,1,999,3239,4692,7931
147411,2,1,3239,4692,7931
147439,1,999,6,103,109
147439,2,1,6,103,109
147536,1,999,2485,9157,11642
147536,2,1,628,1804,2432
147536,4,3,1857,7353,9210
147590,1,999,420,532,952
147590,2,1,45,151,196
147590,4,3,375,381,756
147642,1,999,5,136,141
147642,2,1,5,136,141
147660,1,999,1385,1798,3183
147660,2,1,1193,1569,2762
147660,4,3,192,229,421
147679,1,999,1334,2366,3700
147679,2,1,937,1486,2423
147679,4,3,397,880,1277
147697,1,999,88,64,152
147697,4,3,88,64,152
147703,1,999,13133,14993,28126
147703,2,1,9734,10172,19906
147703,4,3,3399,4821,8220
147749,1,999,304,969,1273
147749,2,1,304,969,1273
147767,1,999,11579,11095,22674
147767,2,1,5055,5581,10636
147767,4,3,6524,5514,12038
147776,1,999,6000,8827,14827
147776,2,1,4789,6493,11282
147776,4,3,1211,2334,3545
147800,1,999,12094,18991,31085
147800,2,1,12094,18991,31085
147819,1,999,1,114,115
147819,2,1,1,114,115
147828,1,999,2109,4524,6633
147828,2,1,1281,2242,3523
147828,4,3,828,2282,3110
147916,1,999,8344,9258,17602
147916,2,1,8344,9258,17602
147970,1,999,16,234,250
147970,2,1,16,234,250
148007,1,999,4363,6700,11063
148007,2,1,4363,6700,11063
148016,1,999,264,291,555
148016,2,1,264,291,555
148098,1,999,2,73,75
148098,2,1,2,73,75
148131,1,999,919,1909,2828
148131,2,1,581,770,1351
148131,4,3,338,1139,1477
148140,1,999,332,429,761
148140,2,1,332,429,761
148177,1,999,1731,2375,4106
148177,2,1,1731,2375,4106
148256,1,999,6864,7018,13882
148256,2,1,6864,7018,13882
148292,1,999,3490,4344,7834
148292,2,1,3490,4344,7834
148335,1,999,2259,3652,5911
148335,2,1,1992,3211,5203
148335,4,3,267,441,708
148380,1,999,7446,9774,17220
148380,2,1,7446,9774,17220
148399,1,999,279,1162,1441
148399,2,1,279,1162,1441
148405,1,999,721,1766,2487
148405,2,1,380,614,994
148405,4,3,341,1152,1493
148487,1,999,2839,5982,8821
148487,2,1,1668,3245,4913
148487,4,3,1171,2737,3908
148496,1,999,1286,3425,4711
148496,2,1,609,1388,1997
148496,4,3,677,2037,2714
148511,1,999,528,1655,2183
148511,2,1,25,97,122
148511,4,3,503,1558,2061
148575,1,999,64,548,612
148575,2,1,50,400,450
148575,4,3,14,148,162
148584,1,999,1077,3391,4468
148584,2,1,550,1385,1935
148584,4,3,527,2006,2533
148593,1,999,7,130,137
148593,2,1,7,130,137
148627,1,999,1652,4248,5900
148627,2,1,1033,2354,3387
148627,4,3,619,1894,2513
148654,1,999,2823,3417,6240
148654,2,1,1633,1953,3586
148654,4,3,1190,1464,2654
148672,1,999,2116,2907,5023
148672,2,1,2116,2907,5023
148724,1,999,50,45,95
148724,4,3,50,45,95
148821,1,999,4101,5081,9182
148821,2,1,4101,5081,9182
148849,1,999,60,60,120
148849,2,1,60,60,120
148876,1,999,465,1340,1805
148876,2,1,465,1340,1805
148885,1,999,250,3,253
148885,4,3,250,3,253
148937,1,999,3366,3753,7119
148937,2,1,3366,3753,7119
148955,1,999,21,162,183
148955,2,1,21,162,183
148982,1,999,99,289,388
148982,4,3,99,289,388
148991,1,999,2320,2280,4600
148991,2,1,2320,2280,4600
149019,1,999,211,485,696
149019,2,1,211,485,696
149028,1,999,12,224,236
149028,2,1,12,205,217
149028,4,3,0,19,19
149204,1,999,1,106,107
149204,2,1,1,106,107
149222,1,999,12929,10214,23143
149222,2,1,10432,7648,18080
149222,4,3,2497,2566,5063
149231,1,999,7321,9000,16321
149231,2,1,5869,6711,12580
149231,4,3,1452,2289,3741
149310,1,999,407,449,856
149310,2,1,407,449,856
149329,1,999,82,0,82
149329,2,1,66,0,66
149329,4,3,16,0,16
149365,1,999,6346,10680,17026
149365,2,1,6346,10680,17026
149499,1,999,1,50,51
149499,2,1,1,50,51
149505,1,999,542,1082,1624
149505,2,1,542,1082,1624
149514,1,999,1973,1198,3171
149514,2,1,531,627,1158
149514,4,3,1442,571,2013
149532,1,999,10820,13326,24146
149532,2,1,10820,13326,24146
149550,1,999,14,333,347
149550,2,1,14,333,347
149639,1,999,511,702,1213
149639,2,1,107,83,190
149639,4,3,404,619,1023
149727,1,999,8778,10957,19735
149727,2,1,8778,10957,19735
149763,1,999,41,248,289
149763,2,1,41,232,273
149763,4,3,0,16,16
149772,1,999,7521,7259,14780
149772,2,1,6386,5504,11890
149772,4,3,1135,1755,2890
149781,1,999,1616,1672,3288
149781,2,1,1234,1259,2493
149781,4,3,382,413,795
149842,1,999,12546,15187,27733
149842,2,1,12546,15187,27733
150048,1,999,233,467,700
150048,2,1,233,467,700
150066,1,999,1437,1793,3230
150066,2,1,998,1337,2335
150066,4,3,439,456,895
150075,1,999,1,22,23
150075,2,1,1,22,23
150136,1,999,11560,13913,25473
150136,2,1,9539,10273,19812
150136,4,3,2021,3640,5661
150145,1,999,906,1693,2599
150145,2,1,724,1435,2159
150145,4,3,182,258,440
150163,1,999,1935,2952,4887
150163,2,1,1509,2282,3791
150163,4,3,426,670,1096
150172,1,999,833,783,1616
150172,2,1,650,645,1295
150172,4,3,183,138,321
150215,1,999,99,166,265
150215,4,3,99,166,265
150251,1,999,18,334,352
150251,2,1,18,334,352
150288,1,999,359,47,406
150288,4,3,359,47,406
150303,1,999,7,109,116
150303,2,1,7,109,116
150400,1,999,1045,1378,2423
150400,2,1,1045,1378,2423
150428,1,999,2,96,98
150428,2,1,2,96,98
150437,1,999,1,111,112
150437,2,1,1,111,112
150455,1,999,574,782,1356
150455,2,1,513,671,1184
150455,4,3,61,111,172
150534,1,999,1255,1858,3113
150534,2,1,1195,1727,2922
150534,4,3,60,131,191
150604,1,999,646,729,1375
150604,2,1,646,729,1375
150640,1,999,3,17,20
150640,2,1,3,17,20
150668,1,999,441,729,1170
150668,2,1,437,690,1127
150668,4,3,4,39,43
150677,1,999,1150,829,1979
150677,2,1,923,731,1654
150677,4,3,227,98,325
150695,1,999,8,138,146
150695,2,1,8,138,146
150710,1,999,55,151,206
150710,2,1,55,151,206
150756,1,999,430,515,945
150756,2,1,430,515,945
150765,1,999,3,104,107
150765,2,1,3,104,107
150774,1,999,341,187,528
150774,2,1,341,187,528
150853,1,999,8,277,285
150853,2,1,8,277,285
150941,1,999,623,764,1387
150941,2,1,545,696,1241
150941,4,3,78,68,146
150978,1,999,5619,7137,12756
150978,2,1,5619,7137,12756
150987,1,999,14096,18388,32484
150987,2,1,14096,18388,32484
150996,1,999,3363,5614,8977
150996,2,1,3363,5614,8977
151005,1,999,4887,7901,12788
151005,2,1,4887,7901,12788
151014,1,999,2742,4850,7592
151014,2,1,2742,4850,7592
151023,1,999,6434,6419,12853
151023,2,1,6434,6419,12853
151032,1,999,7005,9298,16303
151032,2,1,7005,9298,16303
151041,1,999,3369,4222,7591
151041,2,1,3369,4222,7591
151050,1,999,5406,5511,10917
151050,2,1,5406,5511,10917
151069,1,999,3972,5433,9405
151069,2,1,3972,5433,9405
151078,1,999,2222,3619,5841
151078,2,1,2222,3619,5841
151087,1,999,6227,8631,14858
151087,2,1,6227,8631,14858
151096,1,999,1868,3375,5243
151096,2,1,1868,3375,5243
151102,1,999,7455,9503,16958
151102,2,1,6960,8705,15665
151102,4,3,495,798,1293
151111,1,999,16782,22434,39216
151111,2,1,11975,16154,28129
151111,4,3,4807,6280,11087
151157,1,999,76,327,403
151157,2,1,76,327,403
151166,1,999,1118,3122,4240
151166,2,1,1118,3122,4240
151184,1,999,6,56,62
151184,2,1,6,56,62
151193,1,999,46,376,422
151193,2,1,46,376,422
151209,1,999,82,262,344
151209,2,1,82,262,344
151236,1,999,87,418,505
151236,2,1,87,418,505
151245,1,999,57,327,384
151245,2,1,57,327,384
151263,1,999,1912,4034,5946
151263,2,1,1455,2926,4381
151263,4,3,457,1108,1565
151290,1,999,2118,2705,4823
151290,2,1,1878,2447,4325
151290,4,3,240,258,498
151306,1,999,5294,7986,13280
151306,2,1,5025,7115,12140
151306,4,3,269,871,1140
151324,1,999,6522,7383,13905
151324,2,1,5395,5443,10838
151324,4,3,1127,1940,3067
151333,1,999,1351,2432,3783
151333,2,1,1245,2285,3530
151333,4,3,106,147,253
151342,1,999,4197,6652,10849
151342,2,1,3774,5709,9483
151342,4,3,423,943,1366
151351,1,999,23906,23945,47851
151351,2,1,18145,18023,36168
151351,4,3,5761,5922,11683
151360,1,999,2397,4985,7382
151360,2,1,2091,4288,6379
151360,4,3,306,697,1003
151379,1,999,3455,5263,8718
151379,2,1,3013,4288,7301
151379,4,3,442,975,1417
151388,1,999,1313,2565,3878
151388,2,1,1265,2435,3700
151388,4,3,48,130,178
151458,1,999,210,530,740
151458,2,1,210,530,740
151467,1,999,100,351,451
151467,2,1,100,351,451
151494,1,999,1380,389,1769
151494,2,1,1380,389,1769
151500,1,999,896,439,1335
151500,2,1,896,439,1335
151519,1,999,9703,6446,16149
151519,2,1,9491,6324,15815
151519,4,3,212,122,334
151537,1,999,11,63,74
151537,2,1,11,63,74
151564,1,999,1,67,68
151564,2,1,1,67,68
151607,1,999,4,105,109
151607,2,1,4,105,109
151616,1,999,216,1280,1496
151616,2,1,216,1280,1496
151625,1,999,201,656,857
151625,2,1,201,656,857
151652,1,999,29,424,453
151652,2,1,29,424,453
151661,1,999,3802,190,3992
151661,2,1,3802,190,3992
151777,1,999,619,636,1255
151777,2,1,619,636,1255
151786,1,999,1037,1911,2948
151786,2,1,883,1612,2495
151786,4,3,154,299,453
151801,1,999,8221,14925,23146
151801,2,1,5315,9908,15223
151801,4,3,2906,5017,7923
151810,1,999,561,1093,1654
151810,2,1,536,991,1527
151810,4,3,25,102,127
151829,1,999,13,191,204
151829,2,1,13,191,204
151865,1,999,97,107,204
151865,4,3,97,107,204
151874,1,999,83,134,217
151874,2,1,83,134,217
151944,1,999,396,1869,2265
151944,2,1,396,1869,2265
151962,1,999,104,80,184
151962,2,1,104,80,184
152044,1,999,80,98,178
152044,2,1,80,98,178
152080,1,999,7078,5682,12760
152080,2,1,4627,3982,8609
152080,4,3,2451,1700,4151
152099,1,999,1648,1869,3517
152099,2,1,1517,1728,3245
152099,4,3,131,141,272
152150,1,999,7,73,80
152150,2,1,7,73,80
152220,1,999,80,1235,1315
152220,2,1,80,1235,1315
152248,1,999,5550,6960,12510
152248,2,1,4948,5921,10869
152248,4,3,602,1039,1641
152266,1,999,2481,3211,5692
152266,2,1,2442,3153,5595
152266,4,3,39,58,97
152275,1,999,108,259,367
152275,2,1,108,259,367
152309,1,999,11,148,159
152309,2,1,11,148,159
152318,1,999,1596,403,1999
152318,2,1,1490,376,1866
152318,4,3,106,27,133
152327,1,999,7,108,115
152327,2,1,7,108,115
152336,1,999,720,1774,2494
152336,2,1,618,1424,2042
152336,4,3,102,350,452
152363,1,999,459,627,1086
152363,2,1,449,615,1064
152363,4,3,10,12,22
152381,1,999,134,1814,1948
152381,2,1,103,1547,1650
152381,4,3,31,267,298
152390,1,999,18,1686,1704
152390,2,1,18,1686,1704
152415,1,999,183,949,1132
152415,2,1,183,949,1132
152424,1,999,81,469,550
152424,2,1,81,469,550
152451,1,999,186,73,259
152451,4,3,186,73,259
152497,1,999,19,245,264
152497,2,1,19,245,264
152530,1,999,1485,1936,3421
152530,2,1,1378,1847,3225
152530,4,3,107,89,196
152567,1,999,1148,662,1810
152567,2,1,1134,662,1796
152567,4,3,14,0,14
152600,1,999,2097,2360,4457
152600,2,1,1455,1620,3075
152600,4,3,642,740,1382
152628,1,999,10,140,150
152628,2,1,10,140,150
152637,1,999,13366,10058,23424
152637,2,1,13366,10058,23424
152673,1,999,891,0,891
152673,2,1,891,0,891
152798,1,999,34,564,598
152798,2,1,27,421,448
152798,4,3,7,143,150
152822,1,999,380,839,1219
152822,2,1,380,839,1219
152992,1,999,561,846,1407
152992,2,1,543,749,1292
152992,4,3,18,97,115
153001,1,999,1213,2529,3742
153001,2,1,1174,2400,3574
153001,4,3,39,129,168
153074,1,999,9,268,277
153074,2,1,9,268,277
153083,1,999,9,312,321
153083,2,1,9,312,321
153092,1,999,14,7,21
153092,2,1,14,7,21
153108,1,999,850,1028,1878
153108,2,1,850,1028,1878
153126,1,999,405,894,1299
153126,2,1,336,696,1032
153126,4,3,69,198,267
153144,1,999,599,710,1309
153144,2,1,585,703,1288
153144,4,3,14,7,21
153162,1,999,547,588,1135
153162,2,1,547,588,1135
153171,1,999,1,43,44
153171,2,1,1,43,44
153214,1,999,16009,19474,35483
153214,2,1,16009,19474,35483
153241,1,999,74,39,113
153241,2,1,74,39,113
153250,1,999,668,724,1392
153250,2,1,658,690,1348
153250,4,3,10,34,44
153269,1,999,5216,9274,14490
153269,2,1,1689,2274,3963
153269,4,3,3527,7000,10527
153278,1,999,1348,1122,2470
153278,2,1,1142,975,2117
153278,4,3,206,147,353
153296,1,999,747,706,1453
153296,2,1,747,706,1453
153302,1,999,111,153,264
153302,2,1,111,153,264
153311,1,999,5776,7676,13452
153311,2,1,5776,7676,13452
153320,1,999,216,243,459
153320,2,1,149,216,365
153320,4,3,67,27,94
153339,1,999,2,44,46
153339,2,1,2,44,46
153366,1,999,1047,2346,3393
153366,2,1,765,1239,2004
153366,4,3,282,1107,1389
153375,1,999,950,1506,2456
153375,2,1,935,1464,2399
153375,4,3,15,42,57
153384,1,999,814,920,1734
153384,2,1,814,920,1734
153409,1,999,189,406,595
153409,2,1,189,406,595
153418,1,999,381,930,1311
153418,2,1,381,930,1311
153427,1,999,325,270,595
153427,2,1,325,270,595
153445,1,999,4301,5163,9464
153445,2,1,4301,5163,9464
153463,1,999,2,66,68
153463,2,1,2,66,68
153472,1,999,3413,4652,8065
153472,2,1,3413,4652,8065
153524,1,999,4216,4441,8657
153524,2,1,4216,4441,8657
153533,1,999,2107,2667,4774
153533,2,1,2107,2667,4774
153542,1,999,4,19,23
153542,2,1,4,19,23
153588,1,999,35,20,55
153588,2,1,35,20,55
153597,1,999,10,271,281
153597,2,1,10,271,281
153603,1,999,17492,13646,31138
153603,2,1,13872,10713,24585
153603,4,3,3620,2933,6553
153621,1,999,393,609,1002
153621,2,1,393,609,1002
153630,1,999,3546,4551,8097
153630,2,1,3546,4551,8097
153658,1,999,16416,17964,34380
153658,2,1,11119,12268,23387
153658,4,3,5297,5696,10993
153737,1,999,8797,10642,19439
153737,2,1,8797,10642,19439
153746,1,999,4,144,148
153746,2,1,4,144,148
153764,1,999,12,300,312
153764,2,1,12,300,312
153773,1,999,9,126,135
153773,2,1,9,126,135
153782,1,999,8,213,221
153782,2,1,8,213,221
153825,1,999,829,841,1670
153825,2,1,798,757,1555
153825,4,3,31,84,115
153834,1,999,1102,1486,2588
153834,2,1,1102,1486,2588
153861,1,999,1056,411,1467
153861,2,1,189,149,338
153861,4,3,867,262,1129
153922,1,999,1219,1790,3009
153922,2,1,1219,1790,3009
153977,1,999,169,817,986
153977,2,1,169,817,986
154004,1,999,881,1987,2868
154004,2,1,605,709,1314
154004,4,3,276,1278,1554
154013,1,999,604,1344,1948
154013,2,1,528,1198,1726
154013,4,3,76,146,222
154022,1,999,36485,81158,117643
154022,2,1,33334,74487,107821
154022,4,3,3151,6671,9822
154059,1,999,2336,2865,5201
154059,2,1,2336,2865,5201
154095,1,999,6611,9967,16578
154095,2,1,5614,7577,13191
154095,4,3,997,2390,3387
154101,1,999,505,751,1256
154101,2,1,505,751,1256
154110,1,999,3101,4640,7741
154110,2,1,3101,4640,7741
154129,1,999,1112,1374,2486
154129,2,1,1112,1374,2486
154156,1,999,888,986,1874
154156,4,3,888,986,1874
154165,1,999,4,93,97
154165,2,1,4,93,97
154174,1,999,1593,896,2489
154174,2,1,43,42,85
154174,4,3,1550,854,2404
154208,1,999,7,207,214
154208,2,1,7,207,214
154235,1,999,1566,2476,4042
154235,2,1,1214,1849,3063
154235,4,3,352,627,979
154262,1,999,26,193,219
154262,2,1,26,193,219
154332,1,999,9,105,114
154332,2,1,9,105,114
154341,1,999,10,163,173
154341,2,1,10,163,173
154350,1,999,1008,1310,2318
154350,2,1,994,1289,2283
154350,4,3,14,21,35
154378,1,999,2010,3220,5230
154378,2,1,2010,3220,5230
154396,1,999,793,1418,2211
154396,2,1,793,1418,2211
154448,1,999,10,293,303
154448,2,1,10,293,303
154457,1,999,1,76,77
154457,2,1,1,76,77
154466,1,999,3,92,95
154466,2,1,3,92,95
154493,1,999,3789,5884,9673
154493,2,1,3450,5300,8750
154493,4,3,339,584,923
154518,1,999,338,271,609
154518,2,1,338,271,609
154527,1,999,898,990,1888
154527,2,1,898,990,1888
154536,1,999,90,104,194
154536,4,3,90,104,194
154545,1,999,12,69,81
154545,2,1,12,69,81
154572,1,999,3441,4755,8196
154572,2,1,3441,4755,8196
154590,1,999,951,1212,2163
154590,2,1,843,952,1795
154590,4,3,108,260,368
154633,1,999,1,100,101
154633,2,1,1,100,101
154642,1,999,1854,3339,5193
154642,2,1,1854,3339,5193
154651,1,999,61,12,73
154651,2,1,61,12,73
154688,1,999,2034,3232,5266
154688,2,1,1171,1591,2762
154688,4,3,863,1641,2504
154697,1,999,8688,5262,13950
154697,2,1,8688,5262,13950
154712,1,999,1032,1139,2171
154712,2,1,980,1094,2074
154712,4,3,52,45,97
154721,1,999,313,299,612
154721,2,1,313,299,612
154749,1,999,246,251,497
154749,2,1,246,251,497
154767,1,999,170,985,1155
154767,2,1,170,985,1155
154776,1,999,236,741,977
154776,2,1,236,741,977
154794,1,999,70,192,262
154794,2,1,70,192,262
154800,1,999,5822,8129,13951
154800,2,1,5822,8129,13951
154819,1,999,60,90,150
154819,2,1,60,90,150
154837,1,999,67,64,131
154837,2,1,8,4,12
154837,4,3,59,60,119
154855,1,999,238,232,470
154855,2,1,238,232,470
154907,1,999,1806,3191,4997
154907,2,1,1806,3191,4997
154925,1,999,1274,1632,2906
154925,2,1,1274,1632,2906
154934,1,999,810,1382,2192
154934,2,1,810,1382,2192
154943,1,999,8,269,277
154943,2,1,8,269,277
154952,1,999,2313,3888,6201
154952,2,1,2313,3888,6201
154970,1,999,11,138,149
154970,2,1,11,138,149
154998,1,999,1166,1511,2677
154998,2,1,1166,1511,2677
155007,1,999,291,728,1019
155007,2,1,291,728,1019
155025,1,999,2908,5155,8063
155025,2,1,1936,2840,4776
155025,4,3,972,2315,3287
155052,1,999,388,416,804
155052,2,1,388,416,804
155061,1,999,5789,8095,13884
155061,2,1,4926,6447,11373
155061,4,3,863,1648,2511
155070,1,999,107,101,208
155070,2,1,107,101,208
155089,1,999,1381,1969,3350
155089,2,1,1018,1382,2400
155089,4,3,363,587,950
155098,1,999,1787,1620,3407
155098,2,1,1787,1620,3407
155104,1,999,1558,1710,3268
155104,2,1,1558,1710,3268
155140,1,999,625,593,1218
155140,2,1,625,593,1218
155159,1,999,3,104,107
155159,2,1,3,104,107
155177,1,999,213,269,482
155177,2,1,213,269,482
155186,1,999,2251,3460,5711
155186,2,1,2251,3460,5711
155195,1,999,4023,5548,9571
155195,2,1,4023,5548,9571
155201,1,999,826,1120,1946
155201,2,1,826,1120,1946
155210,1,999,14883,16367,31250
155210,2,1,14883,16367,31250
155283,1,999,113,864,977
155283,2,1,113,864,977
155292,1,999,4427,6817,11244
155292,2,1,4427,6817,11244
155317,1,999,15506,16622,32128
155317,2,1,11416,11229,22645
155317,4,3,4090,5393,9483
155335,1,999,1134,2415,3549
155335,2,1,881,1645,2526
155335,4,3,253,770,1023
155353,1,999,40,10,50
155353,2,1,40,10,50
155399,1,999,13196,13392,26588
155399,2,1,10810,10023,20833
155399,4,3,2386,3369,5755
155414,1,999,463,575,1038
155414,2,1,418,531,949
155414,4,3,45,44,89
155423,1,999,523,578,1101
155423,2,1,523,578,1101
155441,1,999,6,123,129
155441,2,1,6,123,129
155450,1,999,1339,2004,3343
155450,2,1,1339,2004,3343
155487,1,999,371,447,818
155487,2,1,371,447,818
155496,1,999,233,183,416
155496,2,1,233,183,416
155511,1,999,403,318,721
155511,2,1,403,318,721
155520,1,999,906,1440,2346
155520,2,1,712,987,1699
155520,4,3,194,453,647
155566,1,999,1194,2514,3708
155566,2,1,1194,2514,3708
155593,1,999,656,1157,1813
155593,2,1,656,1157,1813
155618,1,999,298,114,412
155618,2,1,298,114,412
155627,1,999,304,277,581
155627,2,1,304,277,581
155636,1,999,484,1468,1952
155636,2,1,166,372,538
155636,4,3,318,1096,1414
155681,1,999,4442,4679,9121
155681,2,1,3665,3144,6809
155681,4,3,777,1535,2312
155715,1,999,991,1443,2434
155715,2,1,991,1443,2434
155812,1,999,468,1053,1521
155812,2,1,349,804,1153
155812,4,3,119,249,368
155830,1,999,333,357,690
155830,2,1,333,357,690
155858,1,999,1102,1596,2698
155858,2,1,1102,1596,2698
155867,1,999,3,116,119
155867,2,1,3,116,119
155900,1,999,1909,1554,3463
155900,2,1,1628,1148,2776
155900,4,3,281,406,687
155937,1,999,405,375,780
155937,2,1,405,375,780
155973,1,999,367,390,757
155973,2,1,360,375,735
155973,4,3,7,15,22
156082,1,999,3227,4951,8178
156082,2,1,2761,4317,7078
156082,4,3,466,634,1100
156107,1,999,2265,1686,3951
156107,2,1,2265,1686,3951
156125,1,999,8343,10069,18412
156125,2,1,6626,7803,14429
156125,4,3,1717,2266,3983
156134,1,999,1384,1244,2628
156134,2,1,1384,1244,2628
156189,1,999,278,352,630
156189,2,1,278,352,630
156213,1,999,655,1147,1802
156213,2,1,608,989,1597
156213,4,3,47,158,205
156222,1,999,1252,633,1885
156222,4,3,1252,633,1885
156231,1,999,2700,3064,5764
156231,2,1,2700,3064,5764
156277,1,999,13,99,112
156277,2,1,13,99,112
156286,1,999,1239,2421,3660
156286,2,1,907,1757,2664
156286,4,3,332,664,996
156295,1,999,664,944,1608
156295,2,1,664,944,1608
156310,1,999,36,881,917
156310,2,1,36,881,917
156338,1,999,4120,2865,6985
156338,2,1,4120,2865,6985
156356,1,999,332,507,839
156356,2,1,304,465,769
156356,4,3,28,42,70
156365,1,999,1623,2272,3895
156365,2,1,1369,1860,3229
156365,4,3,254,412,666
156392,1,999,7849,10823,18672
156392,2,1,7849,10823,18672
156408,1,999,559,667,1226
156408,2,1,559,667,1226
156417,1,999,168,41,209
156417,2,1,168,41,209
156426,1,999,18,234,252
156426,2,1,18,234,252
156444,1,999,2,26,28
156444,2,1,2,26,28
156471,1,999,197,1173,1370
156471,2,1,197,1173,1370
156541,1,999,1395,2101,3496
156541,2,1,900,935,1835
156541,4,3,495,1166,1661
156620,1,999,8065,11039,19104
156620,2,1,6989,9077,16066
156620,4,3,1076,1962,3038
156648,1,999,4732,5508,10240
156648,2,1,4732,5508,10240
156675,1,999,3,68,71
156675,2,1,3,68,71
156727,1,999,53,1149,1202
156727,4,3,53,1149,1202
156745,1,999,831,1424,2255
156745,2,1,656,801,1457
156745,4,3,175,623,798
156754,1,999,9,115,124
156754,2,1,9,115,124
156790,1,999,3109,2926,6035
156790,2,1,3109,2926,6035
156842,1,999,24,272,296
156842,2,1,24,272,296
156851,1,999,1768,1820,3588
156851,2,1,1768,1820,3588
156860,1,999,1671,3569,5240
156860,2,1,1671,3569,5240
156903,1,999,79,278,357
156903,2,1,79,278,357
156921,1,999,9581,11396,20977
156921,2,1,9581,11396,20977
156949,1,999,3,26,29
156949,2,1,3,26,29
156967,1,999,15,196,211
156967,2,1,15,196,211
157021,1,999,1283,4452,5735
157021,2,1,1283,4452,5735
157030,1,999,51,56,107
157030,2,1,51,56,107
157058,1,999,1453,1944,3397
157058,2,1,1326,1814,3140
157058,4,3,127,130,257
157076,1,999,499,446,945
157076,2,1,499,446,945
157085,1,999,13822,14993,28815
157085,2,1,10426,10376,20802
157085,4,3,3396,4617,8013
157100,1,999,332,294,626
157100,2,1,300,283,583
157100,4,3,32,11,43
157207,1,999,42,47,89
157207,4,3,42,47,89
157216,1,999,978,1790,2768
157216,2,1,843,1312,2155
157216,4,3,135,478,613
157270,1,999,726,316,1042
157270,2,1,726,316,1042
157289,1,999,11375,12849,24224
157289,2,1,8521,9150,17671
157289,4,3,2854,3699,6553
157298,1,999,102,141,243
157298,4,3,102,141,243
157304,1,999,3327,3246,6573
157304,2,1,3327,3246,6573
157331,1,999,2934,3533,6467
157331,2,1,2934,3533,6467
157359,1,999,870,1488,2358
157359,2,1,850,1437,2287
157359,4,3,20,51,71
157377,1,999,405,1582,1987
157377,2,1,368,1540,1908
157377,4,3,37,42,79
157386,1,999,4036,6897,10933
157386,2,1,3207,5197,8404
157386,4,3,829,1700,2529
157395,1,999,2,33,35
157395,2,1,2,33,35
157401,1,999,4646,7095,11741
157401,2,1,3813,5317,9130
157401,4,3,833,1778,2611
157438,1,999,2466,3092,5558
157438,2,1,2466,3092,5558
157447,1,999,7813,10309,18122
157447,2,1,6801,8526,15327
157447,4,3,1012,1783,2795
157456,1,999,0,49,49
157456,2,1,0,49,49
157465,1,999,144,571,715
157465,2,1,144,571,715
157483,1,999,5623,5255,10878
157483,2,1,5623,5255,10878
157508,1,999,1,132,133
157508,2,1,1,132,133
157535,1,999,571,537,1108
157535,2,1,402,402,804
157535,4,3,169,135,304
157553,1,999,3487,3567,7054
157553,2,1,3487,3567,7054
157599,1,999,776,2524,3300
157599,2,1,776,2524,3300
157614,1,999,19,275,294
157614,2,1,19,275,294
157632,1,999,287,649,936
157632,2,1,287,649,936
157650,1,999,23,359,382
157650,2,1,23,359,382
157669,1,999,12,280,292
157669,2,1,12,280,292
157678,1,999,18,309,327
157678,2,1,18,309,327
157696,1,999,295,1009,1304
157696,2,1,295,1009,1304
157711,1,999,5107,6329,11436
157711,2,1,5107,6329,11436
157739,1,999,3597,3120,6717
157739,2,1,3597,3120,6717
157748,1,999,3172,918,4090
157748,2,1,438,489,927
157748,4,3,2734,429,3163
157757,1,999,609,1869,2478
157757,2,1,347,1008,1355
157757,4,3,262,861,1123
157766,1,999,266,1900,2166
157766,2,1,266,1900,2166
157793,1,999,3345,4628,7973
157793,2,1,2797,4088,6885
157793,4,3,548,540,1088
157809,1,999,1041,1194,2235
157809,2,1,940,1100,2040
157809,4,3,101,94,195
157818,1,999,453,654,1107
157818,2,1,453,654,1107
157827,1,999,18,107,125
157827,2,1,18,107,125
157863,1,999,783,1113,1896
157863,2,1,494,450,944
157863,4,3,289,663,952
157951,1,999,10056,15027,25083
157951,2,1,8766,11949,20715
157951,4,3,1290,3078,4368
158088,1,999,2919,2494,5413
158088,2,1,2919,2494,5413
158158,1,999,53,61,114
158158,2,1,53,61,114
158219,1,999,512,234,746
158219,2,1,512,234,746
158246,1,999,205,377,582
158246,2,1,205,377,582
158325,1,999,18,99,117
158325,2,1,18,99,117
158334,1,999,22,47,69
158334,2,1,22,47,69
158343,1,999,37,35,72
158343,2,1,37,35,72
158352,1,999,3236,2374,5610
158352,2,1,3236,2374,5610
158431,1,999,3050,5337,8387
158431,2,1,3050,5337,8387
158440,1,999,7,199,206
158440,2,1,7,199,206
158477,1,999,439,603,1042
158477,2,1,401,522,923
158477,4,3,38,81,119
158538,1,999,3,78,81
158538,2,1,3,78,81
158617,1,999,1462,1331,2793
158617,2,1,1462,1331,2793
158644,1,999,5,104,109
158644,2,1,5,104,109
158662,1,999,7880,15987,23867
158662,2,1,7880,15987,23867
158723,1,999,84,425,509
158723,2,1,84,425,509
158769,1,999,1433,1814,3247
158769,2,1,1433,1814,3247
158778,1,999,2,69,71
158778,2,1,2,69,71
158787,1,999,4,110,114
158787,2,1,4,110,114
158802,1,999,336,886,1222
158802,2,1,336,886,1222
158884,1,999,1008,1844,2852
158884,2,1,1008,1844,2852
159009,1,999,2204,3581,5785
159009,2,1,2016,3071,5087
159009,4,3,188,510,698
159027,1,999,4,104,108
159027,2,1,4,104,108
159197,1,999,406,56,462
159197,2,1,406,56,462
159258,1,999,1775,812,2587
159258,2,1,1775,812,2587
159267,1,999,814,673,1487
159267,2,1,814,673,1487
159319,1,999,6,50,56
159319,2,1,6,50,56
159328,1,999,7,205,212
159328,2,1,7,205,212
159373,1,999,1019,1959,2978
159373,2,1,170,817,987
159373,4,3,849,1142,1991
159382,1,999,964,2376,3340
159382,2,1,964,2376,3340
159391,1,999,15259,15928,31187
159391,2,1,12162,12595,24757
159391,4,3,3097,3333,6430
159407,1,999,1306,2920,4226
159407,2,1,1306,2920,4226
159416,1,999,2260,3700,5960
159416,2,1,2045,3305,5350
159416,4,3,215,395,610
159443,1,999,3021,3613,6634
159443,2,1,3021,3613,6634
159513,1,999,4,109,113
159513,2,1,4,109,113
159522,1,999,2,98,100
159522,2,1,2,98,100
159531,1,999,0,80,80
159531,2,1,0,80,80
159568,1,999,973,1467,2440
159568,2,1,588,597,1185
159568,4,3,385,870,1255
159601,1,999,3,44,47
159601,2,1,3,44,47
159647,1,999,6266,6923,13189
159647,2,1,5318,4908,10226
159647,4,3,948,2015,2963
159656,1,999,2141,3371,5512
159656,2,1,1365,1773,3138
159656,4,3,776,1598,2374
159717,1,999,3834,6524,10358
159717,2,1,3342,5375,8717
159717,4,3,492,1149,1641
159939,1,999,6704,7840,14544
159939,2,1,5161,5505,10666
159939,4,3,1543,2335,3878
159948,1,999,2408,675,3083
159948,2,1,970,365,1335
159948,4,3,1438,310,1748
159966,1,999,3062,5382,8444
159966,2,1,2797,4577,7374
159966,4,3,265,805,1070
159993,1,999,3920,6960,10880
159993,2,1,3375,5677,9052
159993,4,3,545,1283,1828
160010,1,999,2680,2355,5035
160010,2,1,2680,2355,5035
160029,1,999,117,37,154
160029,4,3,117,37,154
160038,1,999,3562,8243,11805
160038,2,1,3232,6877,10109
160038,4,3,330,1366,1696
160065,1,999,402,1637,2039
160065,2,1,311,1262,1573
160065,4,3,91,375,466
160074,1,999,428,2083,2511
160074,2,1,373,1990,2363
160074,4,3,55,93,148
160117,1,999,2,55,57
160117,2,1,2,55,57
160126,1,999,0,27,27
160126,2,1,0,27,27
160135,1,999,2,66,68
160135,2,1,2,66,68
160199,1,999,5,84,89
160199,2,1,5,84,89
160320,1,999,8,101,109
160320,2,1,8,101,109
160409,1,999,111,11,122
160409,2,1,111,11,122
160445,1,999,13,192,205
160445,2,1,13,192,205
160472,1,999,5,66,71
160472,2,1,5,66,71
160481,1,999,1416,2417,3833
160481,2,1,1416,2417,3833
160524,1,999,181,600,781
160524,2,1,181,600,781
160579,1,999,1649,1229,2878
160579,2,1,1649,1229,2878
160597,1,999,45,82,127
160597,2,1,45,82,127
160612,1,999,6724,11434,18158
160612,2,1,6218,9885,16103
160612,4,3,506,1549,2055
160621,1,999,3353,5511,8864
160621,2,1,2953,4425,7378
160621,4,3,400,1086,1486
160630,1,999,1081,2766,3847
160630,2,1,946,2248,3194
160630,4,3,135,518,653
160649,1,999,1125,3182,4307
160649,2,1,1125,3182,4307
160658,1,999,7889,10637,18526
160658,2,1,7015,9673,16688
160658,4,3,874,964,1838
160667,1,999,2464,2464,4928
160667,2,1,2464,2464,4928
160685,1,999,389,414,803
160685,2,1,389,414,803
160755,1,999,6358,7007,13365
160755,2,1,3548,4444,7992
160755,4,3,2810,2563,5373
160904,1,999,1107,2778,3885
160904,2,1,875,2218,3093
160904,4,3,232,560,792
160913,1,999,5181,2022,7203
160913,2,1,5181,2022,7203
160940,1,999,436,1587,2023
160940,2,1,436,1587,2023
160959,1,999,150,285,435
160959,2,1,131,272,403
160959,4,3,19,13,32
160968,1,999,34,91,125
160968,2,1,1,3,4
160968,4,3,33,88,121
160977,1,999,860,1005,1865
160977,2,1,860,1005,1865
160995,1,999,158,616,774
160995,2,1,158,616,774
161004,1,999,919,964,1883
161004,2,1,919,964,1883
161022,1,999,26,178,204
161022,2,1,26,178,204
161059,1,999,3,23,26
161059,2,1,3,23,26
161077,1,999,1745,1903,3648
161077,2,1,1745,1903,3648
161086,1,999,885,1104,1989
161086,2,1,885,1104,1989
161138,1,999,1624,1487,3111
161138,2,1,1624,1487,3111
161165,1,999,1422,2101,3523
161165,2,1,1218,1691,2909
161165,4,3,204,410,614
161192,1,999,1230,2309,3539
161192,2,1,1230,2309,3539
161208,1,999,84,3,87
161208,2,1,84,3,87
161217,1,999,1890,4889,6779
161217,2,1,1878,4870,6748
161217,4,3,12,19,31
161226,1,999,830,1624,2454
161226,2,1,821,1585,2406
161226,4,3,9,39,48
161235,1,999,611,1317,1928
161235,2,1,611,1317,1928
161244,1,999,437,1215,1652
161244,2,1,437,1215,1652
161253,1,999,6308,7349,13657
161253,2,1,5372,5371,10743
161253,4,3,936,1978,2914
161299,1,999,763,182,945
161299,2,1,755,173,928
161299,4,3,8,9,17
161341,1,999,633,1352,1985
161341,2,1,633,1352,1985
161457,1,999,2116,4740,6856
161457,2,1,1334,2849,4183
161457,4,3,782,1891,2673
161484,1,999,752,766,1518
161484,2,1,752,766,1518
161493,1,999,35,599,634
161493,2,1,35,599,634
161509,1,999,106,254,360
161509,2,1,96,217,313
161509,4,3,10,37,47
161518,1,999,884,2250,3134
161518,2,1,583,1418,2001
161518,4,3,301,832,1133
161527,1,999,13,227,240
161527,2,1,13,227,240
161545,1,999,4203,4188,8391
161545,2,1,4203,4188,8391
161554,1,999,5064,7651,12715
161554,2,1,4100,5510,9610
161554,4,3,964,2141,3105
161563,1,999,541,669,1210
161563,2,1,448,492,940
161563,4,3,93,177,270
161572,1,999,298,285,583
161572,2,1,298,285,583
161581,1,999,253,326,579
161581,2,1,253,326,579
161615,1,999,2,84,86
161615,2,1,2,84,86
161651,1,999,2,55,57
161651,2,1,2,55,57
161688,1,999,1721,3361,5082
161688,2,1,1721,3361,5082
161767,1,999,9490,15260,24750
161767,2,1,9490,15260,24750
161776,1,999,251,652,903
161776,2,1,251,652,903
161800,1,999,9,309,318
161800,2,1,9,309,318
161855,1,999,9,122,131
161855,2,1,9,122,131
161864,1,999,3367,7660,11027
161864,2,1,3367,7660,11027
161873,1,999,3081,4336,7417
161873,2,1,1495,2059,3554
161873,4,3,1586,2277,3863
161882,1,999,324,362,686
161882,2,1,306,345,651
161882,4,3,18,17,35
162007,1,999,2227,4139,6366
162007,2,1,1824,3072,4896
162007,4,3,403,1067,1470
162061,1,999,811,246,1057
162061,2,1,328,98,426
162061,4,3,483,148,631
162104,1,999,1255,2024,3279
162104,2,1,1255,2024,3279
162122,1,999,4333,7349,11682
162122,2,1,4333,7349,11682
162168,1,999,1306,2608,3914
162168,2,1,1306,2608,3914
162210,1,999,411,771,1182
162210,2,1,366,707,1073
162210,4,3,45,64,109
162283,1,999,1185,3650,4835
162283,2,1,972,3027,3999
162283,4,3,213,623,836
162335,1,999,2,120,122
162335,2,1,2,120,122
162371,1,999,747,15,762
162371,2,1,747,15,762
162557,1,999,3785,5478,9263
162557,2,1,3785,5478,9263
162584,1,999,2960,3172,6132
162584,2,1,2665,2576,5241
162584,4,3,295,596,891
162609,1,999,553,542,1095
162609,2,1,553,542,1095
162654,1,999,917,2237,3154
162654,2,1,491,1058,1549
162654,4,3,426,1179,1605
162681,1,999,435,1152,1587
162681,2,1,435,1152,1587
162690,1,999,2534,3989,6523
162690,2,1,2534,3989,6523
162706,1,999,3571,5452,9023
162706,2,1,3571,5452,9023
162760,1,999,890,2013,2903
162760,2,1,499,1069,1568
162760,4,3,391,944,1335
162779,1,999,5421,7430,12851
162779,2,1,5421,7430,12851
162830,1,999,3,78,81
162830,2,1,3,78,81
162928,1,999,11969,13111,25080
162928,2,1,3249,3330,6579
162928,4,3,8720,9781,18501
162982,1,999,73,87,160
162982,2,1,73,87,160
163028,1,999,2401,219,2620
163028,2,1,2401,219,2620
163046,1,999,2587,4099,6686
163046,2,1,1563,2280,3843
163046,4,3,1024,1819,2843
163107,1,999,3,51,54
163107,2,1,3,51,54
163204,1,999,25336,30508,55844
163204,2,1,17146,20254,37400
163204,4,3,8190,10254,18444
163259,1,999,1936,5101,7037
163259,2,1,157,831,988
163259,4,3,1779,4270,6049
163268,1,999,7544,6880,14424
163268,2,1,5976,5017,10993
163268,4,3,1568,1863,3431
163286,1,999,22446,20511,42957
163286,2,1,16198,14721,30919
163286,4,3,6248,5790,12038
163295,1,999,793,1839,2632
163295,2,1,706,1699,2405
163295,4,3,87,140,227
163338,1,999,2098,2969,5067
163338,2,1,1846,2576,4422
163338,4,3,252,393,645
163347,1,999,81,1061,1142
163347,2,1,81,1061,1142
163408,1,999,4,269,273
163408,2,1,4,269,273
163426,1,999,17101,20409,37510
163426,2,1,17101,20409,37510
163453,1,999,3618,4626,8244
163453,2,1,3121,3881,7002
163453,4,3,497,745,1242
163462,1,999,1095,1258,2353
163462,2,1,732,998,1730
163462,4,3,363,260,623
163532,1,999,580,0,580
163532,2,1,371,0,371
163532,4,3,209,0,209
163541,1,999,9,765,774
163541,2,1,9,765,774
163578,1,999,570,3433,4003
163578,2,1,103,1452,1555
163578,4,3,467,1981,2448
163657,1,999,7619,12991,20610
163657,2,1,7619,12991,20610
163736,1,999,689,1123,1812
163736,2,1,689,1123,1812
163754,1,999,7,142,149
163754,2,1,7,142,149
163815,1,999,4,162,166
163815,2,1,4,162,166
163842,1,999,181,134,315
163842,2,1,6,0,6
163842,4,3,175,134,309
163851,1,999,4001,5219,9220
163851,2,1,3738,4602,8340
163851,4,3,263,617,880
163912,1,999,893,1241,2134
163912,2,1,885,1205,2090
163912,4,3,8,36,44
163921,1,999,222,1665,1887
163921,2,1,199,1580,1779
163921,4,3,23,85,108
163976,1,999,311,287,598
163976,2,1,235,239,474
163976,4,3,76,48,124
164058,1,999,662,549,1211
164058,2,1,662,549,1211
164076,1,999,9551,15646,25197
164076,2,1,8010,11664,19674
164076,4,3,1541,3982,5523
164085,1,999,108,499,607
164085,4,3,108,499,607
164100,1,999,16,137,153
164100,2,1,16,137,153
164155,1,999,4611,1187,5798
164155,2,1,4611,1187,5798
164173,1,999,1232,2852,4084
164173,2,1,1107,2620,3727
164173,4,3,125,232,357
164207,1,999,418,345,763
164207,2,1,217,185,402
164207,4,3,201,160,361
164216,1,999,579,856,1435
164216,2,1,551,813,1364
164216,4,3,28,43,71
164243,1,999,160,101,261
164243,4,3,160,101,261
164270,1,999,1560,3323,4883
164270,2,1,888,1137,2025
164270,4,3,672,2186,2858
164313,1,999,2064,3581,5645
164313,2,1,2064,3581,5645
164438,1,999,222,660,882
164438,2,1,185,607,792
164438,4,3,37,53,90
164447,1,999,1257,2837,4094
164447,2,1,763,1092,1855
164447,4,3,494,1745,2239
164465,1,999,919,930,1849
164465,2,1,919,930,1849
164474,1,999,137,208,345
164474,4,3,137,208,345
164492,1,999,866,961,1827
164492,2,1,629,634,1263
164492,4,3,237,327,564
164535,1,999,5,37,42
164535,2,1,5,37,42
164562,1,999,1154,1906,3060
164562,2,1,996,1437,2433
164562,4,3,158,469,627
164571,1,999,236,497,733
164571,2,1,221,451,672
164571,4,3,15,46,61
164580,1,999,2450,1393,3843
164580,2,1,1100,807,1907
164580,4,3,1350,586,1936
164599,1,999,13,82,95
164599,2,1,13,82,95
164614,1,999,82,77,159
164614,2,1,82,77,159
164632,1,999,93,2240,2333
164632,2,1,0,1603,1603
164632,4,3,93,637,730
164641,1,999,409,996,1405
164641,2,1,409,996,1405
164678,1,999,353,2,355
164678,2,1,353,2,355
164720,1,999,652,1364,2016
164720,2,1,652,1364,2016
164739,1,999,3490,2447,5937
164739,2,1,2618,1777,4395
164739,4,3,872,670,1542
164748,1,999,3468,1424,4892
164748,2,1,3468,1424,4892
164775,1,999,1340,2032,3372
164775,2,1,1340,2032,3372
164845,1,999,45,450,495
164845,2,1,45,450,495
164872,1,999,998,851,1849
164872,2,1,684,576,1260
164872,4,3,314,275,589
164915,1,999,60,118,178
164915,4,3,60,118,178
164924,1,999,7357,8500,15857
164924,2,1,5022,5376,10398
164924,4,3,2335,3124,5459
164933,1,999,279,434,713
164933,2,1,210,303,513
164933,4,3,69,131,200
164988,1,999,17361,22573,39934
164988,2,1,9503,13452,22955
164988,4,3,7858,9121,16979
165015,1,999,2907,3296,6203
165015,2,1,1569,2013,3582
165015,4,3,1338,1283,2621
165024,1,999,4989,8329,13318
165024,2,1,4127,6041,10168
165024,4,3,862,2288,3150
165033,1,999,4824,7332,12156
165033,2,1,4824,7332,12156
165060,1,999,25,304,329
165060,2,1,25,304,329
165112,1,999,6993,9552,16545
165112,2,1,6993,9552,16545
165149,1,999,10,14,24
165149,2,1,10,14,24
165167,1,999,1916,4974,6890
165167,2,1,666,1259,1925
165167,4,3,1250,3715,4965
165194,1,999,2630,4038,6668
165194,2,1,2630,4038,6668
165255,1,999,2,243,245
165255,2,1,2,243,245
165264,1,999,71,690,761
165264,2,1,71,690,761
165334,1,999,1593,2257,3850
165334,2,1,983,1525,2508
165334,4,3,610,732,1342
165495,1,999,6,13,19
165495,4,3,6,13,19
165529,1,999,1689,2234,3923
165529,2,1,1475,1954,3429
165529,4,3,214,280,494
165556,1,999,468,968,1436
165556,2,1,468,968,1436
165574,1,999,729,832,1561
165574,2,1,729,832,1561
165608,1,999,9,75,84
165608,2,1,9,75,84
165635,1,999,268,9,277
165635,2,1,268,9,277
165644,1,999,495,799,1294
165644,2,1,417,601,1018
165644,4,3,78,198,276
165662,1,999,1737,2894,4631
165662,2,1,1515,2234,3749
165662,4,3,222,660,882
165671,1,999,768,2165,2933
165671,2,1,664,1843,2507
165671,4,3,104,322,426
165680,1,999,9,123,132
165680,2,1,9,123,132
165699,1,999,1932,5781,7713
165699,2,1,1076,1398,2474
165699,4,3,856,4383,5239
165705,1,999,33,68,101
165705,4,3,33,68,101
165750,1,999,85,81,166
165750,2,1,85,81,166
165802,1,999,512,1480,1992
165802,2,1,512,1480,1992
165820,1,999,3910,7945,11855
165820,2,1,2313,2606,4919
165820,4,3,1597,5339,6936
165866,1,999,2813,7674,10487
165866,2,1,1775,3101,4876
165866,4,3,1038,4573,5611
165884,1,999,602,76,678
165884,2,1,602,76,678
165936,1,999,705,1322,2027
165936,2,1,638,1041,1679
165936,4,3,67,281,348
165945,1,999,1799,730,2529
165945,4,3,1799,730,2529
165981,1,999,1414,1977,3391
165981,2,1,1414,1977,3391
166009,1,999,66,114,180
166009,2,1,66,114,180
166018,1,999,606,917,1523
166018,2,1,606,917,1523
166027,1,999,17053,17359,34412
166027,2,1,6763,7554,14317
166027,4,3,10290,9805,20095
166045,1,999,83,182,265
166045,2,1,7,3,10
166045,4,3,76,179,255
166054,1,999,288,99,387
166054,2,1,83,68,151
166054,4,3,205,31,236
166063,1,999,3,69,72
166063,2,1,3,69,72
166124,1,999,1350,1617,2967
166124,2,1,1350,1617,2967
166133,1,999,3778,6159,9937
166133,2,1,3778,6159,9937
166276,1,999,109,315,424
166276,2,1,109,315,424
166294,1,999,4,106,110
166294,2,1,4,106,110
166319,1,999,1,105,106
166319,2,1,1,105,106
166328,1,999,4,69,73
166328,2,1,4,69,73
166391,1,999,576,1200,1776
166391,2,1,520,1059,1579
166391,4,3,56,141,197
166407,1,999,54,350,404
166407,2,1,54,350,404
166452,1,999,1458,7603,9061
166452,2,1,545,1766,2311
166452,4,3,913,5837,6750
166489,1,999,86,161,247
166489,2,1,26,24,50
166489,4,3,60,137,197
166498,1,999,7,151,158
166498,2,1,7,151,158
166513,1,999,9866,7489,17355
166513,2,1,7761,5444,13205
166513,4,3,2105,2045,4150
166586,1,999,1,71,72
166586,2,1,1,71,72
166595,1,999,2,129,131
166595,2,1,2,129,131
166601,1,999,89,211,300
166601,2,1,89,211,300
166629,1,999,15458,15786,31244
166629,2,1,11859,12156,24015
166629,4,3,3599,3630,7229
166638,1,999,7475,12322,19797
166638,2,1,6016,8633,14649
166638,4,3,1459,3689,5148
166647,1,999,3275,4877,8152
166647,2,1,3275,4877,8152
166656,1,999,1392,3018,4410
166656,2,1,343,1070,1413
166656,4,3,1049,1948,2997
166674,1,999,1117,2205,3322
166674,2,1,1048,2039,3087
166674,4,3,69,166,235
166683,1,999,6991,3988,10979
166683,2,1,2390,1971,4361
166683,4,3,4601,2017,6618
166692,1,999,1251,156,1407
166692,2,1,1175,136,1311
166692,4,3,76,20,96
166708,1,999,440,699,1139
166708,4,3,440,699,1139
166717,1,999,94,364,458
166717,4,3,94,364,458
166805,1,999,113,25,138
166805,2,1,113,25,138
166823,1,999,4886,6526,11412
166823,2,1,4886,6526,11412
166850,1,999,1381,1464,2845
166850,2,1,1358,1338,2696
166850,4,3,23,126,149
166869,1,999,214,1195,1409
166869,2,1,40,278,318
166869,4,3,174,917,1091
166887,1,999,5444,7475,12919
166887,2,1,5444,7475,12919
166911,1,999,98,256,354
166911,2,1,98,256,354
166939,1,999,16,2600,2616
166939,2,1,6,2491,2497
166939,4,3,10,109,119
166948,1,999,542,1006,1548
166948,2,1,540,997,1537
166948,4,3,2,9,11
166957,1,999,2408,4382,6790
166957,2,1,2408,4382,6790
166975,1,999,97,305,402
166975,2,1,97,305,402
166984,1,999,265,572,837
166984,2,1,222,473,695
166984,4,3,43,99,142
167020,1,999,156,1014,1170
167020,2,1,156,1014,1170
167039,1,999,2,32,34
167039,2,1,2,32,34
167057,1,999,414,391,805
167057,2,1,220,192,412
167057,4,3,194,199,393
167093,1,999,123,359,482
167093,4,3,123,359,482
167181,1,999,55,163,218
167181,4,3,55,163,218
167215,1,999,499,633,1132
167215,4,3,499,633,1132
167224,1,999,48,108,156
167224,2,1,48,108,156
167251,1,999,474,644,1118
167251,2,1,474,644,1118
167260,1,999,1097,846,1943
167260,2,1,890,651,1541
167260,4,3,207,195,402
167288,1,999,1029,1553,2582
167288,2,1,812,1150,1962
167288,4,3,217,403,620
167297,1,999,119,39,158
167297,2,1,119,39,158
167312,1,999,4553,6819,11372
167312,2,1,4553,6819,11372
167321,1,999,1418,793,2211
167321,2,1,1418,793,2211
167358,1,999,16476,17990,34466
167358,2,1,10935,11460,22395
167358,4,3,5541,6530,12071
167376,1,999,3783,6143,9926
167376,2,1,3783,6143,9926
167394,1,999,311,1342,1653
167394,2,1,254,915,1169
167394,4,3,57,427,484
167455,1,999,5,499,504
167455,2,1,0,457,457
167455,4,3,5,42,47
167464,1,999,56,0,56
167464,4,3,56,0,56
167525,1,999,2413,4930,7343
167525,2,1,2413,4930,7343
167534,1,999,4972,6484,11456
167534,2,1,4972,6484,11456
167543,1,999,1042,39,1081
167543,2,1,1042,39,1081
167598,1,999,293,1828,2121
167598,2,1,225,1028,1253
167598,4,3,68,800,868
167631,1,999,1399,2605,4004
167631,2,1,1399,2605,4004
167677,1,999,120,107,227
167677,2,1,44,41,85
167677,4,3,76,66,142
167729,1,999,4870,10016,14886
167729,2,1,3747,5918,9665
167729,4,3,1123,4098,5221
167738,1,999,300,1599,1899
167738,2,1,300,1599,1899
167783,1,999,564,5699,6263
167783,2,1,0,2000,2000
167783,4,3,564,3699,4263
167792,1,999,187,266,453
167792,2,1,187,266,453
167835,1,999,86,3189,3275
167835,2,1,5,2718,2723
167835,4,3,81,471,552
167871,1,999,17,124,141
167871,2,1,17,124,141
167899,1,999,2156,3922,6078
167899,2,1,1707,2517,4224
167899,4,3,449,1405,1854
167905,1,999,4004,5406,9410
167905,2,1,4004,5406,9410
167987,1,999,5272,5276,10548
167987,2,1,4536,4286,8822
167987,4,3,736,990,1726
167996,1,999,1013,1509,2522
167996,2,1,1013,1509,2522
168005,1,999,4738,5918,10656
168005,2,1,2831,3670,6501
168005,4,3,1907,2248,4155
168032,1,999,3,77,80
168032,2,1,3,77,80
168148,1,999,5070,6130,11200
168148,2,1,2723,2890,5613
168148,4,3,2347,3240,5587
168218,1,999,91,2455,2546
168218,2,1,91,2455,2546
168227,1,999,3273,772,4045
168227,2,1,3174,726,3900
168227,4,3,99,46,145
168254,1,999,2305,1809,4114
168254,2,1,1759,1197,2956
168254,4,3,546,612,1158
168263,1,999,3068,3611,6679
168263,2,1,2700,2942,5642
168263,4,3,368,669,1037
168281,1,999,649,1026,1675
168281,2,1,649,1026,1675
168290,1,999,105,1100,1205
168290,2,1,83,725,808
168290,4,3,22,375,397
168342,1,999,1082,1177,2259
168342,2,1,1061,1142,2203
168342,4,3,21,35,56
168421,1,999,3870,1450,5320
168421,2,1,2544,993,3537
168421,4,3,1326,457,1783
168430,1,999,3148,6212,9360
168430,2,1,2592,3778,6370
168430,4,3,556,2434,2990
168519,1,999,0,29,29
168519,2,1,0,29,29
168528,1,999,893,777,1670
168528,2,1,893,777,1670
168546,1,999,841,917,1758
168546,2,1,841,917,1758
168555,1,999,0,94,94
168555,2,1,0,94,94
168573,1,999,945,18,963
168573,2,1,945,18,963
168591,1,999,654,818,1472
168591,2,1,654,818,1472
168607,1,999,1275,1516,2791
168607,2,1,1275,1516,2791
168740,1,999,2359,1977,4336
168740,2,1,1004,1247,2251
168740,4,3,1355,730,2085
168786,1,999,863,1609,2472
168786,2,1,772,1316,2088
168786,4,3,91,293,384
168838,1,999,1813,3015,4828
168838,2,1,1812,3011,4823
168838,4,3,1,4,5
168847,1,999,3634,6908,10542
168847,2,1,3628,6899,10527
168847,4,3,6,9,15
168883,1,999,1282,1837,3119
168883,2,1,1282,1837,3119
168892,1,999,14,133,147
168892,2,1,14,133,147
169080,1,999,2029,2455,4484
169080,2,1,1957,2307,4264
169080,4,3,72,148,220
169099,1,999,208,72,280
169099,4,3,208,72,280
169187,1,999,63,390,453
169187,2,1,63,390,453
169220,1,999,32,83,115
169220,4,3,32,83,115
169248,1,999,13689,18914,32603
169248,2,1,10093,12594,22687
169248,4,3,3596,6320,9916
169275,1,999,7302,10518,17820
169275,2,1,7302,10518,17820
169284,1,999,122,887,1009
169284,2,1,122,887,1009
169327,1,999,392,567,959
169327,2,1,328,473,801
169327,4,3,64,94,158
169363,1,999,382,552,934
169363,2,1,236,253,489
169363,4,3,146,299,445
169424,1,999,65,92,157
169424,4,3,65,92,157
169442,1,999,815,658,1473
169442,2,1,801,645,1446
169442,4,3,14,13,27
169479,1,999,5554,10513,16067
169479,2,1,4524,9201,13725
169479,4,3,1030,1312,2342
169503,1,999,21,341,362
169503,2,1,21,341,362
169521,1,999,7882,9233,17115
169521,2,1,7882,9233,17115
169567,1,999,17,259,276
169567,2,1,17,259,276
169576,1,999,9,203,212
169576,2,1,9,203,212
169628,1,999,591,378,969
169628,4,3,591,378,969
169655,1,999,1517,67,1584
169655,2,1,1517,67,1584
169716,1,999,2673,3822,6495
169716,2,1,1317,2382,3699
169716,4,3,1356,1440,2796
169734,1,999,89,474,563
169734,2,1,89,474,563
169761,1,999,75,585,660
169761,2,1,75,585,660
169798,1,999,11518,16549,28067
169798,2,1,8990,12034,21024
169798,4,3,2528,4515,7043
169910,1,999,7995,8243,16238
169910,2,1,7318,7295,14613
169910,4,3,677,948,1625
169947,1,999,77,6,83
169947,2,1,77,6,83
169974,1,999,1043,1628,2671
169974,2,1,1043,1628,2671
169983,1,999,2315,564,2879
169983,2,1,1886,396,2282
169983,4,3,429,168,597
169992,1,999,618,910,1528
169992,2,1,618,910,1528
170000,1,999,109,89,198
170000,2,1,109,89,198
170037,1,999,1499,1908,3407
170037,2,1,1017,1437,2454
170037,4,3,482,471,953
170046,1,999,350,1488,1838
170046,2,1,350,1488,1838
170055,1,999,11871,12743,24614
170055,2,1,11871,12743,24614
170082,1,999,11440,17436,28876
170082,2,1,9554,13530,23084
170082,4,3,1886,3906,5792
170091,1,999,154,119,273
170091,2,1,154,119,273
170240,1,999,11170,14399,25569
170240,2,1,11170,14399,25569
170301,1,999,1400,2091,3491
170301,2,1,1400,2091,3491
170417,1,999,1323,471,1794
170417,2,1,1323,471,1794
170444,1,999,4372,6758,11130
170444,2,1,4372,6758,11130
170514,1,999,11,145,156
170514,2,1,11,145,156
170532,1,999,604,795,1399
170532,2,1,604,795,1399
170541,1,999,8919,9403,18322
170541,2,1,8919,9403,18322
170550,1,999,6516,8132,14648
170550,2,1,6516,8132,14648
170587,1,999,1144,1773,2917
170587,2,1,1144,1773,2917
170611,1,999,8,253,261
170611,2,1,8,253,261
170620,1,999,2615,3746,6361
170620,2,1,2615,3746,6361
170639,1,999,1428,1550,2978
170639,2,1,1421,1522,2943
170639,4,3,7,28,35
170657,1,999,14190,16632,30822
170657,2,1,14190,16632,30822
170675,1,999,3800,1464,5264
170675,2,1,2648,795,3443
170675,4,3,1152,669,1821
170736,1,999,9,103,112
170736,2,1,9,103,112
170790,1,999,17175,18212,35387
170790,2,1,17175,18212,35387
170806,1,999,1519,4911,6430
170806,2,1,1077,3062,4139
170806,4,3,442,1849,2291
170842,1,999,747,2839,3586
170842,2,1,252,785,1037
170842,4,3,495,2054,2549
170967,1,999,481,659,1140
170967,2,1,467,655,1122
170967,4,3,14,4,18
170976,1,999,23067,20781,43848
170976,2,1,13735,13267,27002
170976,4,3,9332,7514,16846
171012,1,999,308,42,350
171012,2,1,308,42,350
171100,1,999,23924,27504,51428
171100,2,1,18143,19846,37989
171100,4,3,5781,7658,13439
171128,1,999,5783,2001,7784
171128,2,1,4675,1550,6225
171128,4,3,1108,451,1559
171137,1,999,5298,5512,10810
171137,2,1,4067,4429,8496
171137,4,3,1231,1083,2314
171146,1,999,3648,5931,9579
171146,2,1,3091,4838,7929
171146,4,3,557,1093,1650
171155,1,999,2911,4336,7247
171155,2,1,2911,4336,7247
171225,1,999,2745,3763,6508
171225,2,1,2745,3763,6508
171234,1,999,1117,2175,3292
171234,2,1,1117,2175,3292
171261,1,999,9,99,108
171261,2,1,9,99,108
171298,1,999,2758,5424,8182
171298,2,1,2754,5409,8163
171298,4,3,4,15,19
171304,1,999,3252,3878,7130
171304,2,1,3252,3878,7130
171313,1,999,328,1803,2131
171313,2,1,328,1803,2131
171322,1,999,740,1975,2715
171322,2,1,740,1975,2715
171395,1,999,1598,2912,4510
171395,2,1,1598,2912,4510
171456,1,999,5544,5970,11514
171456,2,1,5101,5142,10243
171456,4,3,443,828,1271
171465,1,999,1,67,68
171465,2,1,1,67,68
171483,1,999,2862,3528,6390
171483,2,1,2862,3528,6390
171492,1,999,2522,2112,4634
171492,2,1,2234,1942,4176
171492,4,3,288,170,458
171535,1,999,19129,24733,43862
171535,2,1,19129,24733,43862
171571,1,999,8698,14540,23238
171571,2,1,7174,11272,18446
171571,4,3,1524,3268,4792
171599,1,999,679,585,1264
171599,2,1,662,542,1204
171599,4,3,17,43,60
171775,1,999,12,140,152
171775,2,1,12,140,152
171881,1,999,177,190,367
171881,2,1,176,188,364
171881,4,3,1,2,3
171988,1,999,15,397,412
171988,2,1,15,397,412
171997,1,999,23,253,276
171997,2,1,23,253,276
172015,1,999,29,381,410
172015,2,1,29,381,410
172033,1,999,337,170,507
172033,2,1,191,113,304
172033,4,3,146,57,203
172051,1,999,5076,7690,12766
172051,2,1,4411,5983,10394
172051,4,3,665,1707,2372
172200,1,999,9149,11756,20905
172200,2,1,9149,11756,20905
172264,1,999,1239,1876,3115
172264,2,1,1116,1507,2623
172264,4,3,123,369,492
172291,1,999,2699,3842,6541
172291,2,1,2699,3842,6541
172307,1,999,1614,2588,4202
172307,2,1,1614,2588,4202
172325,1,999,670,351,1021
172325,2,1,670,351,1021
172334,1,999,1688,4694,6382
172334,2,1,1087,2404,3491
172334,4,3,601,2290,2891
172422,1,999,396,126,522
172422,2,1,396,126,522
172440,1,999,233,404,637
172440,2,1,233,404,637
172477,1,999,2329,2093,4422
172477,4,3,2329,2093,4422
172495,1,999,7,260,267
172495,2,1,7,260,267
172556,1,999,7,82,89
172556,2,1,7,82,89
172574,1,999,5,214,219
172574,2,1,5,214,219
172583,1,999,15,162,177
172583,2,1,15,162,177
172608,1,999,2230,2259,4489
172608,2,1,712,771,1483
172608,4,3,1518,1488,3006
172617,1,999,11649,11557,23206
172617,2,1,11649,11557,23206
172635,1,999,11197,23145,34342
172635,2,1,11197,23145,34342
172644,1,999,15366,21995,37361
172644,2,1,10085,13966,24051
172644,4,3,5281,8029,13310
172671,1,999,854,1356,2210
172671,2,1,854,1356,2210
172699,1,999,13702,14525,28227
172699,2,1,10973,10442,21415
172699,4,3,2729,4083,6812
172705,1,999,167,85,252
172705,4,3,167,85,252
172802,1,999,4,62,66
172802,2,1,4,62,66
172866,1,999,189,139,328
172866,2,1,189,139,328
172918,1,999,2082,1930,4012
172918,2,1,2082,1930,4012
172927,1,999,33,119,152
172927,2,1,33,119,152
172954,1,999,1416,2227,3643
172954,2,1,1416,2227,3643
172963,1,999,5023,7555,12578
172963,2,1,5023,7555,12578
172972,1,999,33,34,67
172972,2,1,33,34,67
173045,1,999,2014,2891,4905
173045,2,1,1612,2014,3626
173045,4,3,402,877,1279
173063,1,999,2541,2822,5363
173063,2,1,2541,2822,5363
173115,1,999,794,1749,2543
173115,2,1,794,1749,2543
173124,1,999,2997,3703,6700
173124,2,1,2688,3135,5823
173124,4,3,309,568,877
173142,1,999,291,382,673
173142,2,1,291,382,673
173160,1,999,1893,3136,5029
173160,2,1,1502,2392,3894
173160,4,3,391,744,1135
173179,1,999,569,306,875
173179,4,3,569,306,875
173203,1,999,2633,3429,6062
173203,2,1,2633,3429,6062
173258,1,999,990,1053,2043
173258,2,1,990,1053,2043
173300,1,999,1127,1758,2885
173300,2,1,1116,1726,2842
173300,4,3,11,32,43
173328,1,999,1301,2445,3746
173328,2,1,935,1391,2326
173328,4,3,366,1054,1420
173416,1,999,3382,2216,5598
173416,2,1,3382,2216,5598
173452,1,999,559,651,1210
173452,2,1,509,621,1130
173452,4,3,50,30,80
173461,1,999,4003,4682,8685
173461,2,1,4003,4682,8685
173470,1,999,6,69,75
173470,2,1,6,69,75
173489,1,999,105,489,594
173489,2,1,105,489,594
173559,1,999,3693,5526,9219
173559,2,1,3693,5526,9219
173629,1,999,598,1457,2055
173629,2,1,589,1437,2026
173629,4,3,9,20,29
173638,1,999,2336,2732,5068
173638,2,1,2336,2732,5068
173647,1,999,1069,1474,2543
173647,2,1,1069,1474,2543
173665,1,999,2709,5623,8332
173665,2,1,937,1198,2135
173665,4,3,1772,4425,6197
173683,1,999,64,86,150
173683,2,1,3,6,9
173683,4,3,61,80,141
173708,1,999,5280,3879,9159
173708,2,1,5280,3879,9159
173726,1,999,3,43,46
173726,2,1,3,43,46
173735,1,999,1058,1166,2224
173735,2,1,1058,1166,2224
173744,1,999,31,533,564
173744,2,1,31,533,564
173799,1,999,4015,5747,9762
173799,2,1,4015,5747,9762
173805,1,999,827,746,1573
173805,2,1,827,746,1573
173887,1,999,1082,1527,2609
173887,2,1,1082,1527,2609
173896,1,999,468,452,920
173896,4,3,468,452,920
173902,1,999,885,1237,2122
173902,2,1,885,1237,2122
173911,1,999,3064,3183,6247
173911,2,1,3064,3183,6247
173920,1,999,8128,9223,17351
173920,2,1,7146,7528,14674
173920,4,3,982,1695,2677
173939,1,999,7,266,273
173939,2,1,7,266,273
173957,1,999,128,131,259
173957,4,3,128,131,259
173966,1,999,93,291,384
173966,2,1,36,118,154
173966,4,3,57,173,230
173984,1,999,711,2505,3216
173984,2,1,432,1792,2224
173984,4,3,279,713,992
173993,1,999,1324,967,2291
173993,2,1,1324,967,2291
174020,1,999,4205,5808,10013
174020,2,1,3832,5119,8951
174020,4,3,373,689,1062
174066,1,999,30621,34592,65213
174066,2,1,20539,23290,43829
174066,4,3,10082,11302,21384
174075,1,999,1358,1305,2663
174075,2,1,1358,1305,2663
174118,1,999,111,282,393
174118,2,1,111,282,393
174127,1,999,338,446,784
174127,2,1,309,409,718
174127,4,3,29,37,66
174136,1,999,7045,7887,14932
174136,2,1,7045,7887,14932
174154,1,999,48,446,494
174154,2,1,48,446,494
174190,1,999,12,322,334
174190,2,1,12,322,334
174206,1,999,105,98,203
174206,2,1,105,98,203
174233,1,999,6361,6118,12479
174233,2,1,5850,5320,11170
174233,4,3,511,798,1309
174251,1,999,814,1057,1871
174251,2,1,814,1057,1871
174279,1,999,1011,1714,2725
174279,2,1,942,1641,2583
174279,4,3,69,73,142
174321,1,999,5,201,206
174321,2,1,5,201,206
174358,1,999,3686,5214,8900
174358,2,1,3469,4577,8046
174358,4,3,217,637,854
174376,1,999,4592,6098,10690
174376,2,1,4592,6098,10690
174385,1,999,179,595,774
174385,2,1,179,595,774
174394,1,999,1167,612,1779
174394,2,1,1167,612,1779
174428,1,999,6774,8339,15113
174428,2,1,6774,8339,15113
174437,1,999,586,758,1344
174437,2,1,586,758,1344
174473,1,999,2411,3411,5822
174473,2,1,2411,3411,5822
174482,1,999,108,27,135
174482,2,1,108,27,135
174491,1,999,1468,2117,3585
174491,2,1,1402,2068,3470
174491,4,3,66,49,115
174507,1,999,471,561,1032
174507,2,1,58,139,197
174507,4,3,413,422,835
174525,1,999,72,83,155
174525,2,1,72,83,155
174534,1,999,8,248,256
174534,2,1,8,248,256
174570,1,999,460,905,1365
174570,2,1,460,905,1365
174604,1,999,168,270,438
174604,2,1,168,270,438
174738,1,999,3330,4883,8213
174738,2,1,3330,4883,8213
174747,1,999,0,2159,2159
174747,2,1,0,2159,2159
174756,1,999,2891,3052,5943
174756,2,1,2891,3052,5943
174765,1,999,1,160,161
174765,2,1,1,160,161
174783,1,999,10376,11563,21939
174783,2,1,9313,9875,19188
174783,4,3,1063,1688,2751
174792,1,999,2050,83,2133
174792,2,1,1964,0,1964
174792,4,3,86,83,169
174817,1,999,3044,5421,8465
174817,2,1,1164,1302,2466
174817,4,3,1880,4119,5999
174844,1,999,1439,1773,3212
174844,2,1,1439,1773,3212
174862,1,999,600,774,1374
174862,2,1,477,697,1174
174862,4,3,123,77,200
174899,1,999,1341,3167,4508
174899,2,1,986,2233,3219
174899,4,3,355,934,1289
174914,1,999,6086,6215,12301
174914,2,1,3499,2973,6472
174914,4,3,2587,3242,5829
174932,1,999,66,133,199
174932,2,1,66,133,199
174978,1,999,11,323,334
174978,2,1,11,323,334
175005,1,999,295,5719,6014
175005,2,1,134,4183,4317
175005,4,3,161,1536,1697
175014,1,999,2250,7428,9678
175014,2,1,2250,7428,9678
175041,1,999,4278,5347,9625
175041,2,1,4278,5347,9625
175078,1,999,3314,4635,7949
175078,2,1,3072,4175,7247
175078,4,3,242,460,702
175120,1,999,321,104,425
175120,2,1,321,104,425
175139,1,999,67,126,193
175139,4,3,67,126,193
175157,1,999,582,297,879
175157,2,1,582,297,879
175227,1,999,1805,258,2063
175227,2,1,1805,258,2063
175236,1,999,2831,3180,6011
175236,2,1,2831,3180,6011
175263,1,999,1348,2085,3433
175263,2,1,1348,2085,3433
175272,1,999,3807,6041,9848
175272,2,1,3539,5371,8910
175272,4,3,268,670,938
175281,1,999,521,531,1052
175281,4,3,521,531,1052
175315,1,999,6673,8093,14766
175315,2,1,6673,8093,14766
175342,1,999,1255,2715,3970
175342,2,1,1041,2091,3132
175342,4,3,214,624,838
175421,1,999,1410,3051,4461
175421,2,1,1148,2240,3388
175421,4,3,262,811,1073
175430,1,999,197,430,627
175430,2,1,197,405,602
175430,4,3,0,25,25
175494,1,999,15,184,199
175494,2,1,15,184,199
175519,1,999,1187,2128,3315
175519,2,1,1187,2128,3315
175528,1,999,165,923,1088
175528,2,1,165,923,1088
175573,1,999,1837,3415,5252
175573,2,1,1837,3415,5252
175591,1,999,0,105,105
175591,2,1,0,105,105
175607,1,999,4,76,80
175607,2,1,4,76,80
175616,1,999,1818,3221,5039
175616,2,1,1453,2227,3680
175616,4,3,365,994,1359
175643,1,999,1293,2274,3567
175643,2,1,1293,2274,3567
175652,1,999,4005,5901,9906
175652,2,1,4005,5901,9906
175698,1,999,35,16,51
175698,2,1,35,16,51
175722,1,999,0,54,54
175722,2,1,0,54,54
175786,1,999,6105,10897,17002
175786,2,1,6105,10897,17002
175810,1,999,3460,6406,9866
175810,2,1,3460,6406,9866
175829,1,999,3405,6150,9555
175829,2,1,3405,6150,9555
175856,1,999,3670,6606,10276
175856,2,1,2957,4796,7753
175856,4,3,713,1810,2523
175883,1,999,3043,4212,7255
175883,2,1,3043,4212,7255
175935,1,999,1688,3683,5371
175935,2,1,1688,3683,5371
175980,1,999,627,599,1226
175980,2,1,542,529,1071
175980,4,3,85,70,155
176008,1,999,1690,2988,4678
176008,2,1,1690,2988,4678
176017,1,999,8612,9974,18586
176017,2,1,7209,8119,15328
176017,4,3,1403,1855,3258
176026,1,999,1002,1729,2731
176026,2,1,140,727,867
176026,4,3,862,1002,1864
176035,1,999,580,2586,3166
176035,2,1,536,2324,2860
176035,4,3,44,262,306
176044,1,999,1255,2241,3496
176044,2,1,1145,1863,3008
176044,4,3,110,378,488
176053,1,999,2100,3205,5305
176053,2,1,1269,1993,3262
176053,4,3,831,1212,2043
176062,1,999,4,125,129
176062,2,1,4,125,129
176071,1,999,5609,8568,14177
176071,2,1,5609,8568,14177
176080,1,999,10812,10331,21143
176080,2,1,8355,7834,16189
176080,4,3,2457,2497,4954
176169,1,999,1835,2653,4488
176169,2,1,1835,2653,4488
176178,1,999,4168,7356,11524
176178,2,1,4168,7356,11524
176239,1,999,3609,4710,8319
176239,2,1,3609,4710,8319
176318,1,999,430,721,1151
176318,2,1,430,721,1151
176336,1,999,63,33,96
176336,2,1,63,33,96
176354,1,999,1002,1899,2901
176354,2,1,1002,1899,2901
176372,1,999,7142,11569,18711
176372,2,1,5806,9027,14833
176372,4,3,1336,2542,3878
176390,1,999,8,270,278
176390,2,1,8,270,278
176406,1,999,359,684,1043
176406,2,1,359,684,1043
176451,1,999,112,41,153
176451,4,3,112,41,153
176479,1,999,1211,3559,4770
176479,2,1,772,2061,2833
176479,4,3,439,1498,1937
176549,1,999,95,488,583
176549,2,1,95,488,583
176600,1,999,129,161,290
176600,4,3,129,161,290
176619,1,999,380,150,530
176619,4,3,380,150,530
176628,1,999,758,1515,2273
176628,2,1,448,846,1294
176628,4,3,310,669,979
176637,1,999,1484,396,1880
176637,2,1,1484,396,1880
176664,1,999,391,267,658
176664,2,1,304,252,556
176664,4,3,87,15,102
176716,1,999,9,217,226
176716,2,1,9,217,226
176734,1,999,4,24,28
176734,2,1,4,24,28
176770,1,999,89,630,719
176770,2,1,89,618,707
176770,4,3,0,12,12
176789,1,999,208,163,371
176789,2,1,153,143,296
176789,4,3,55,20,75
176798,1,999,51,108,159
176798,2,1,51,108,159
176910,1,999,234,188,422
176910,2,1,234,188,422
176938,1,999,404,310,714
176938,2,1,404,310,714
176947,1,999,561,619,1180
176947,2,1,561,619,1180
176965,1,999,6062,7802,13864
176965,2,1,4939,5948,10887
176965,4,3,1123,1854,2977
176983,1,999,95,9,104
176983,2,1,95,9,104
176992,1,999,2,33,35
176992,2,1,2,33,35
177038,1,999,448,251,699
177038,2,1,90,53,143
177038,4,3,358,198,556
177056,1,999,17,55,72
177056,2,1,17,55,72
177065,1,999,12832,16614,29446
177065,2,1,12345,15828,28173
177065,4,3,487,786,1273
177083,1,999,123,0,123
177083,2,1,115,0,115
177083,4,3,8,0,8
177092,1,999,546,16,562
177092,4,3,546,16,562
177117,1,999,0,314,314
177117,2,1,0,314,314
177126,1,999,684,231,915
177126,4,3,684,231,915
177135,1,999,2415,3988,6403
177135,2,1,2415,3988,6403
177144,1,999,375,461,836
177144,2,1,375,461,836
177153,1,999,568,6483,7051
177153,2,1,568,6483,7051
177162,1,999,1887,1207,3094
177162,2,1,1487,816,2303
177162,4,3,400,391,791
177214,1,999,2806,4892,7698
177214,2,1,2613,4363,6976
177214,4,3,193,529,722
177250,1,999,2457,3604,6061
177250,2,1,2457,3604,6061
177278,1,999,96,132,228
177278,4,3,96,132,228
177287,1,999,9,377,386
177287,2,1,9,377,386
177302,1,999,822,1410,2232
177302,2,1,822,1410,2232
177339,1,999,892,1221,2113
177339,2,1,817,1023,1840
177339,4,3,75,198,273
177418,1,999,997,2554,3551
177418,2,1,701,1558,2259
177418,4,3,296,996,1292
177427,1,999,87,193,280
177427,4,3,87,193,280
177436,1,999,6,32,38
177436,2,1,6,32,38
177472,1,999,7474,9909,17383
177472,2,1,7474,9909,17383
177542,1,999,451,833,1284
177542,2,1,448,796,1244
177542,4,3,3,37,40
177551,1,999,742,1442,2184
177551,2,1,742,1442,2184
177579,1,999,90,460,550
177579,2,1,90,460,550
177588,1,999,20,96,116
177588,2,1,20,96,116
177603,1,999,5,175,180
177603,2,1,5,175,180
177676,1,999,3233,4582,7815
177676,2,1,3233,4582,7815
177685,1,999,5,63,68
177685,2,1,5,63,68
177719,1,999,98,730,828
177719,2,1,83,610,693
177719,4,3,15,120,135
177746,1,999,337,492,829
177746,2,1,337,492,829
177807,1,999,6,39,45
177807,2,1,6,39,45
177816,1,999,115,0,115
177816,2,1,48,0,48
177816,4,3,67,0,67
177834,1,999,1600,2613,4213
177834,4,3,1600,2613,4213
177870,1,999,12,1,13
177870,2,1,12,1,13
177922,1,999,7,33,40
177922,2,1,7,33,40
177931,1,999,13,30,43
177931,2,1,13,30,43
177940,1,999,1637,2502,4139
177940,2,1,1559,2323,3882
177940,4,3,78,179,257
177968,1,999,5681,11670,17351
177968,2,1,3837,4950,8787
177968,4,3,1844,6720,8564
177977,1,999,1151,152,1303
177977,2,1,1151,152,1303
177986,1,999,786,481,1267
177986,2,1,55,42,97
177986,4,3,731,439,1170
177995,1,999,4552,5947,10499
177995,2,1,4552,5947,10499
178004,1,999,22,198,220
178004,2,1,22,198,220
178022,1,999,3490,5033,8523
178022,2,1,3490,5033,8523
178059,1,999,1039,3184,4223
178059,2,1,818,2576,3394
178059,4,3,221,608,829
178077,1,999,8,283,291
178077,2,1,8,283,291
178110,1,999,34,341,375
178110,2,1,34,341,375
178183,1,999,113,407,520
178183,2,1,113,407,520
178208,1,999,854,221,1075
178208,2,1,275,114,389
178208,4,3,579,107,686
178217,1,999,2447,3345,5792
178217,2,1,2447,3345,5792
178226,1,999,858,797,1655
178226,2,1,858,797,1655
178244,1,999,1969,3641,5610
178244,2,1,1432,2338,3770
178244,4,3,537,1303,1840
178262,1,999,13,287,300
178262,2,1,13,287,300
178305,1,999,210,1686,1896
178305,2,1,210,1686,1896
178341,1,999,2915,4074,6989
178341,2,1,2865,3985,6850
178341,4,3,50,89,139
178350,1,999,173,24,197
178350,2,1,173,24,197
178369,1,999,1040,870,1910
178369,2,1,1040,870,1910
178387,1,999,3068,3983,7051
178387,2,1,3035,3866,6901
178387,4,3,33,117,150
178396,1,999,15956,18773,34729
178396,2,1,12374,13332,25706
178396,4,3,3582,5441,9023
178402,1,999,8532,11511,20043
178402,2,1,5586,7757,13343
178402,4,3,2946,3754,6700
178411,1,999,5851,1764,7615
178411,2,1,4209,1305,5514
178411,4,3,1642,459,2101
178420,1,999,8121,12812,20933
178420,2,1,6499,9696,16195
178420,4,3,1622,3116,4738
178448,1,999,2993,4310,7303
178448,2,1,2993,4310,7303
178466,1,999,62,104,166
178466,2,1,62,104,166
178484,1,999,27,508,535
178484,2,1,27,508,535
178518,1,999,261,90,351
178518,4,3,261,90,351
178527,1,999,4,86,90
178527,2,1,4,86,90
178563,1,999,16,64,80
178563,2,1,16,64,80
178615,1,999,2674,3901,6575
178615,2,1,2364,3306,5670
178615,4,3,310,595,905
178624,1,999,3638,4880,8518
178624,2,1,3031,3628,6659
178624,4,3,607,1252,1859
178679,1,999,382,301,683
178679,2,1,382,301,683
178697,1,999,662,856,1518
178697,2,1,662,856,1518
178721,1,999,12756,11267,24023
178721,2,1,12302,10512,22814
178721,4,3,454,755,1209
178767,1,999,18,239,257
178767,2,1,18,239,257
178785,1,999,2469,5628,8097
178785,2,1,2469,5628,8097
178828,1,999,21,59,80
178828,2,1,21,59,80
178891,1,999,2219,115,2334
178891,2,1,2219,115,2334
178989,1,999,47,512,559
178989,2,1,31,339,370
178989,4,3,16,173,189
179043,1,999,1350,2228,3578
179043,2,1,876,1477,2353
179043,4,3,474,751,1225
179052,1,999,88,129,217
179052,2,1,88,129,217
179070,1,999,224,817,1041
179070,2,1,224,817,1041
179113,1,999,7712,10668,18380
179113,2,1,7712,10668,18380
179159,1,999,7835,11418,19253
179159,2,1,5469,7972,13441
179159,4,3,2366,3446,5812
179195,1,999,3,59,62
179195,2,1,3,59,62
179201,1,999,463,1558,2021
179201,2,1,463,1558,2021
179229,1,999,5,71,76
179229,2,1,5,71,76
179238,1,999,6,55,61
179238,2,1,6,55,61
179256,1,999,227,162,389
179256,2,1,227,162,389
179265,1,999,520,729,1249
179265,2,1,292,386,678
179265,4,3,228,343,571
179292,1,999,4126,7425,11551
179292,2,1,4126,7425,11551
179308,1,999,4960,8297,13257
179308,2,1,4960,8297,13257
179317,1,999,163,158,321
179317,4,3,163,158,321
179326,1,999,1450,3063,4513
179326,2,1,1121,2147,3268
179326,4,3,329,916,1245
179344,1,999,1121,1564,2685
179344,2,1,1121,1564,2685
179399,1,999,10,22,32
179399,2,1,10,22,32
179450,1,999,18,122,140
179450,2,1,18,122,140
179511,1,999,43,355,398
179511,2,1,43,355,398
179539,1,999,2499,3735,6234
179539,2,1,2499,3735,6234
179548,1,999,82,1357,1439
179548,2,1,37,1035,1072
179548,4,3,45,322,367
179557,1,999,5112,8167,13279
179557,2,1,4629,6588,11217
179557,4,3,483,1579,2062
179566,1,999,10244,13090,23334
179566,2,1,8449,10457,18906
179566,4,3,1795,2633,4428
179645,1,999,1606,3033,4639
179645,2,1,1606,3033,4639
179715,1,999,667,1793,2460
179715,2,1,667,1793,2460
179724,1,999,10,24,34
179724,2,1,10,24,34
179742,1,999,14,31,45
179742,4,3,14,31,45
179812,1,999,564,544,1108
179812,4,3,564,544,1108
179867,1,999,7002,7334,14336
179867,2,1,3613,3889,7502
179867,4,3,3389,3445,6834
179894,1,999,10903,15288,26191
179894,2,1,1864,2800,4664
179894,4,3,9039,12488,21527
179919,1,999,553,727,1280
179919,2,1,553,727,1280
179946,1,999,626,478,1104
179946,2,1,626,478,1104
179955,1,999,457,705,1162
179955,2,1,457,705,1162
179964,1,999,1253,2543,3796
179964,2,1,350,1036,1386
179964,4,3,903,1507,2410
179991,1,999,0,55,55
179991,2,1,0,55,55
180045,1,999,726,1062,1788
180045,2,1,726,1062,1788
180054,1,999,341,432,773
180054,2,1,341,432,773
180063,1,999,2,61,63
180063,2,1,2,61,63
180081,1,999,392,409,801
180081,2,1,392,409,801
180106,1,999,616,868,1484
180106,2,1,616,868,1484
180151,1,999,833,941,1774
180151,2,1,833,941,1774
180160,1,999,269,397,666
180160,2,1,269,397,666
180179,1,999,1606,3045,4651
180179,2,1,1407,2447,3854
180179,4,3,199,598,797
180197,1,999,1773,2380,4153
180197,2,1,1773,2380,4153
180203,1,999,205,291,496
180203,2,1,205,291,496
180212,1,999,330,460,790
180212,2,1,330,460,790
180249,1,999,1183,2247,3430
180249,2,1,1183,2247,3430
180258,1,999,369,713,1082
180258,2,1,346,641,987
180258,4,3,23,72,95
180276,1,999,801,984,1785
180276,2,1,801,984,1785
180328,1,999,342,618,960
180328,2,1,342,618,960
180373,1,999,257,458,715
180373,2,1,257,458,715
180391,1,999,1,59,60
180391,2,1,1,59,60
180416,1,999,1879,1237,3116
180416,2,1,1765,1151,2916
180416,4,3,114,86,200
180461,1,999,7835,6867,14702
180461,2,1,6610,5442,12052
180461,4,3,1225,1425,2650
180489,1,999,8192,9550,17742
180489,2,1,7078,7897,14975
180489,4,3,1114,1653,2767
180522,1,999,784,829,1613
180522,2,1,756,743,1499
180522,4,3,28,86,114
180595,1,999,506,495,1001
180595,2,1,464,439,903
180595,4,3,42,56,98
180647,1,999,678,985,1663
180647,2,1,678,985,1663
180692,1,999,714,1125,1839
180692,2,1,714,1125,1839
180771,1,999,4,80,84
180771,2,1,4,80,84
180814,1,999,8381,7804,16185
180814,2,1,6288,5560,11848
180814,4,3,2093,2244,4337
180832,1,999,139,1017,1156
180832,2,1,106,751,857
180832,4,3,33,266,299
180878,1,999,59,547,606
180878,2,1,43,522,565
180878,4,3,16,25,41
180902,1,999,6002,7656,13658
180902,2,1,6002,7656,13658
180948,1,999,1398,2125,3523
180948,2,1,1108,1624,2732
180948,4,3,290,501,791
180957,1,999,31,250,281
180957,2,1,31,250,281
180984,1,999,767,1284,2051
180984,2,1,630,700,1330
180984,4,3,137,584,721
181002,1,999,3731,4642,8373
181002,2,1,1838,2644,4482
181002,4,3,1893,1998,3891
181020,1,999,512,492,1004
181020,2,1,512,492,1004
181093,1,999,271,350,621
181093,2,1,215,281,496
181093,4,3,56,69,125
181127,1,999,635,767,1402
181127,2,1,593,548,1141
181127,4,3,42,219,261
181136,1,999,2,54,56
181136,2,1,2,54,56
181145,1,999,5,17,22
181145,2,1,5,17,22
181190,1,999,72,438,510
181190,2,1,72,438,510
181215,1,999,3506,4746,8252
181215,2,1,2656,2892,5548
181215,4,3,850,1854,2704
181242,1,999,280,687,967
181242,2,1,280,687,967
181251,1,999,4,25,29
181251,2,1,4,25,29
181297,1,999,86,787,873
181297,2,1,72,703,775
181297,4,3,14,84,98
181303,1,999,15012,19911,34923
181303,2,1,15012,19911,34923
181312,1,999,3157,2698,5855
181312,2,1,3157,2698,5855
181330,1,999,299,491,790
181330,2,1,291,471,762
181330,4,3,8,20,28
181376,1,999,78,63,141
181376,2,1,78,63,141
181394,1,999,8226,9396,17622
181394,2,1,6608,6973,13581
181394,4,3,1618,2423,4041
181400,1,999,317,1276,1593
181400,2,1,317,1276,1593
181419,1,999,84,117,201
181419,2,1,84,117,201
181428,1,999,1138,2339,3477
181428,2,1,103,896,999
181428,4,3,1035,1443,2478
181446,1,999,1404,2322,3726
181446,2,1,1330,2058,3388
181446,4,3,74,264,338
181464,1,999,14195,12756,26951
181464,2,1,10988,9296,20284
181464,4,3,3207,3460,6667
181491,1,999,3627,3763,7390
181491,2,1,3627,3763,7390
181534,1,999,1305,1970,3275
181534,2,1,1140,1554,2694
181534,4,3,165,416,581
181543,1,999,26,26,52
181543,2,1,26,26,52
181604,1,999,29,1223,1252
181604,2,1,7,936,943
181604,4,3,22,287,309
181640,1,999,10516,9053,19569
181640,2,1,10516,9053,19569
181738,1,999,420,631,1051
181738,2,1,397,581,978
181738,4,3,23,50,73
181756,1,999,322,660,982
181756,2,1,322,660,982
181765,1,999,216,219,435
181765,2,1,216,219,435
181783,1,999,1849,2603,4452
181783,2,1,1442,1646,3088
181783,4,3,407,957,1364
181792,1,999,5,11,16
181792,2,1,5,11,16
181817,1,999,3094,4376,7470
181817,2,1,3094,4376,7470
181853,1,999,257,195,452
181853,2,1,257,195,452
181880,1,999,15,261,276
181880,2,1,15,261,276
181941,1,999,212,405,617
181941,2,1,212,405,617
182005,1,999,31268,31480,62748
182005,2,1,31268,31480,62748
182111,1,999,990,779,1769
182111,2,1,990,779,1769
182148,1,999,1215,779,1994
182148,2,1,1215,779,1994
182209,1,999,28,529,557
182209,2,1,28,529,557
182281,1,999,15542,20177,35719
182281,2,1,12075,14764,26839
182281,4,3,3467,5413,8880
182290,1,999,9161,10934,20095
182290,2,1,7261,8310,15571
182290,4,3,1900,2624,4524
182306,1,999,2016,2816,4832
182306,2,1,2016,2816,4832
182397,1,999,2,249,251
182397,2,1,2,249,251
182430,1,999,190,184,374
182430,2,1,161,154,315
182430,4,3,29,30,59
182458,1,999,501,767,1268
182458,2,1,273,230,503
182458,4,3,228,537,765
182500,1,999,8557,10725,19282
182500,2,1,8557,10725,19282
182564,1,999,3170,4656,7826
182564,2,1,3170,4656,7826
182634,1,999,387,796,1183
182634,2,1,387,796,1183
182652,1,999,9,118,127
182652,2,1,9,118,127
182661,1,999,814,283,1097
182661,2,1,749,247,996
182661,4,3,65,36,101
182670,1,999,3477,3138,6615
182670,2,1,2321,2292,4613
182670,4,3,1156,846,2002
182704,1,999,6,187,193
182704,2,1,6,187,193
182722,1,999,29,177,206
182722,2,1,29,177,206
182795,1,999,1201,1705,2906
182795,2,1,948,1293,2241
182795,4,3,253,412,665
182829,1,999,330,214,544
182829,4,3,330,214,544
182865,1,999,1811,4152,5963
182865,2,1,1811,4152,5963
182883,1,999,0,44,44
182883,2,1,0,44,44
182892,1,999,0,60,60
182892,2,1,0,60,60
182908,1,999,146,268,414
182908,2,1,146,268,414
182917,1,999,31,37,68
182917,2,1,31,37,68
182953,1,999,18,194,212
182953,2,1,18,194,212
182980,1,999,1086,1516,2602
182980,2,1,564,565,1129
182980,4,3,522,951,1473
182999,1,999,2,73,75
182999,2,1,2,73,75
183026,1,999,5247,7096,12343
183026,2,1,3290,4380,7670
183026,4,3,1957,2716,4673
183035,1,999,8,66,74
183035,2,1,8,66,74
183044,1,999,7240,9209,16449
183044,2,1,6033,7333,13366
183044,4,3,1207,1876,3083
183062,1,999,3277,3635,6912
183062,2,1,3208,3443,6651
183062,4,3,69,192,261
183071,1,999,981,1176,2157
183071,2,1,736,753,1489
183071,4,3,245,423,668
183080,1,999,3337,4120,7457
183080,2,1,2548,2128,4676
183080,4,3,789,1992,2781
183099,1,999,2697,3067,5764
183099,2,1,2697,3067,5764
183105,1,999,582,996,1578
183105,2,1,582,996,1578
183114,1,999,579,1120,1699
183114,2,1,579,1120,1699
183123,1,999,1248,997,2245
183123,2,1,1248,997,2245
183132,1,999,1798,2384,4182
183132,2,1,1798,2384,4182
183141,1,999,1461,1654,3115
183141,2,1,1461,1654,3115
183150,1,999,1063,1749,2812
183150,2,1,1063,1749,2812
183202,1,999,1,40,41
183202,2,1,1,40,41
183211,1,999,656,2276,2932
183211,2,1,377,1388,1765
183211,4,3,279,888,1167
183239,1,999,880,1166,2046
183239,2,1,880,1166,2046
183248,1,999,14,221,235
183248,2,1,14,221,235
183257,1,999,713,1919,2632
183257,2,1,649,1588,2237
183257,4,3,64,331,395
183275,1,999,34,34,68
183275,2,1,34,34,68
183345,1,999,72,149,221
183345,2,1,72,149,221
183488,1,999,155,1340,1495
183488,2,1,155,1340,1495
183600,1,999,0,43,43
183600,2,1,0,43,43
183655,1,999,4314,6739,11053
183655,2,1,4314,6739,11053
183725,1,999,156,663,819
183725,2,1,156,663,819
183743,1,999,11369,12256,23625
183743,2,1,11369,12256,23625
183789,1,999,1459,3518,4977
183789,2,1,1459,3518,4977
183804,1,999,6455,0,6455
183804,2,1,2896,0,2896
183804,4,3,3559,0,3559
183822,1,999,854,1657,2511
183822,2,1,854,1657,2511
183859,1,999,10317,12513,22830
183859,2,1,10317,12513,22830
183877,1,999,7197,9508,16705
183877,2,1,7197,9508,16705
183910,1,999,753,1755,2508
183910,2,1,582,1091,1673
183910,4,3,171,664,835
183938,1,999,9443,13936,23379
183938,2,1,9443,13936,23379
183974,1,999,1378,2409,3787
183974,2,1,982,1658,2640
183974,4,3,396,751,1147
183983,1,999,97,16,113
183983,2,1,97,16,113
184047,1,999,359,373,732
184047,2,1,359,373,732
184056,1,999,413,1371,1784
184056,2,1,413,1371,1784
184092,1,999,173,670,843
184092,2,1,173,670,843
184135,1,999,385,1537,1922
184135,2,1,385,1537,1922
184144,1,999,29,188,217
184144,2,1,29,188,217
184153,1,999,10,37,47
184153,2,1,6,35,41
184153,4,3,4,2,6
184180,1,999,6858,7043,13901
184180,2,1,6858,7043,13901
184205,1,999,2054,3774,5828
184205,2,1,2054,3774,5828
184269,1,999,2243,910,3153
184269,2,1,2202,872,3074
184269,4,3,41,38,79
184278,1,999,226,6,232
184278,2,1,226,6,232
184320,1,999,1091,1570,2661
184320,2,1,1091,1570,2661
184348,1,999,1262,1784,3046
184348,2,1,800,1214,2014
184348,4,3,462,570,1032
184357,1,999,33,21,54
184357,2,1,33,21,54
184427,1,999,458,2,460
184427,2,1,458,2,460
184481,1,999,7468,10619,18087
184481,2,1,7468,10619,18087
184506,1,999,24,195,219
184506,2,1,24,195,219
184603,1,999,4704,6067,10771
184603,2,1,3126,3982,7108
184603,4,3,1578,2085,3663
184612,1,999,560,1874,2434
184612,2,1,464,1526,1990
184612,4,3,96,348,444
184694,1,999,1879,2040,3919
184694,2,1,1269,1373,2642
184694,4,3,610,667,1277
184746,1,999,271,5,276
184746,2,1,271,5,276
184773,1,999,485,3033,3518
184773,2,1,264,1963,2227
184773,4,3,221,1070,1291
184782,1,999,5664,7206,12870
184782,2,1,5114,5847,10961
184782,4,3,550,1359,1909
184791,1,999,4035,5828,9863
184791,2,1,4035,5828,9863
184816,1,999,88,276,364
184816,2,1,88,276,364
184870,1,999,108,670,778
184870,2,1,108,670,778
184959,1,999,133,843,976
184959,2,1,133,843,976
184968,1,999,29,119,148
184968,2,1,29,119,148
184995,1,999,4807,7385,12192
184995,2,1,4807,7385,12192
185129,1,999,3962,7099,11061
185129,2,1,3060,4744,7804
185129,4,3,902,2355,3257
185174,1,999,60,13,73
185174,2,1,60,13,73
185262,1,999,6251,11594,17845
185262,2,1,5256,8517,13773
185262,4,3,995,3077,4072
185332,1,999,54,411,465
185332,2,1,54,411,465
185396,1,999,2784,99,2883
185396,2,1,2784,99,2883
185466,1,999,11,235,246
185466,2,1,11,235,246
185509,1,999,6261,7470,13731
185509,2,1,6261,7470,13731
185536,1,999,8754,9903,18657
185536,2,1,8754,9903,18657
185572,1,999,2830,4648,7478
185572,2,1,2203,2982,5185
185572,4,3,627,1666,2293
185590,1,999,7753,13874,21627
185590,2,1,6330,10058,16388
185590,4,3,1423,3816,5239
185624,1,999,10,110,120
185624,2,1,10,110,120
185651,1,999,64,113,177
185651,2,1,64,113,177
185679,1,999,65,520,585
185679,2,1,65,520,585
185721,1,999,265,482,747
185721,2,1,265,482,747
185730,1,999,31,125,156
185730,2,1,31,125,156
185758,1,999,118,120,238
185758,4,3,118,120,238
185767,1,999,21,343,364
185767,2,1,21,343,364
185828,1,999,7657,2538,10195
185828,2,1,5160,1483,6643
185828,4,3,2497,1055,3552
185873,1,999,6566,9087,15653
185873,2,1,6566,9087,15653
185916,1,999,57,260,317
185916,2,1,57,260,317
185970,1,999,26,260,286
185970,2,1,26,260,286
186016,1,999,24,456,480
186016,2,1,24,456,480
186034,1,999,4830,7758,12588
186034,2,1,4830,7758,12588
186052,1,999,1150,234,1384
186052,2,1,1150,234,1384
186122,1,999,356,256,612
186122,4,3,356,256,612
186131,1,999,4292,3510,7802
186131,2,1,2737,2560,5297
186131,4,3,1555,950,2505
186186,1,999,250,0,250
186186,2,1,250,0,250
186201,1,999,2929,4081,7010
186201,2,1,2840,3826,6666
186201,4,3,89,255,344
186274,1,999,44,320,364
186274,2,1,44,320,364
186283,1,999,2686,4467,7153
186283,2,1,2218,3370,5588
186283,4,3,468,1097,1565
186335,1,999,28,128,156
186335,2,1,28,128,156
186371,1,999,3381,3711,7092
186371,2,1,2307,2838,5145
186371,4,3,1074,873,1947
186380,1,999,20127,21789,41916
186380,2,1,16783,15860,32643
186380,4,3,3344,5929,9273
186399,1,999,6785,6944,13729
186399,2,1,4066,4676,8742
186399,4,3,2719,2268,4987
186405,1,999,3,13,16
186405,2,1,3,13,16
186423,1,999,8,69,77
186423,2,1,8,69,77
186432,1,999,1626,2273,3899
186432,2,1,1230,1699,2929
186432,4,3,396,574,970
186469,1,999,765,1272,2037
186469,2,1,765,1272,2037
186584,1,999,4698,6244,10942
186584,2,1,2385,3325,5710
186584,4,3,2313,2919,5232
186593,1,999,41,184,225
186593,2,1,41,184,225
186618,1,999,324,2176,2500
186618,2,1,157,1285,1442
186618,4,3,167,891,1058
186645,1,999,5260,6406,11666
186645,2,1,5260,6406,11666
186867,1,999,5424,1777,7201
186867,2,1,1695,592,2287
186867,4,3,3729,1185,4914
186876,1,999,3497,5102,8599
186876,2,1,3247,4427,7674
186876,4,3,250,675,925
186900,1,999,0,64,64
186900,2,1,0,64,64
187000,1,999,148,4,152
187000,2,1,148,4,152
187046,1,999,11115,7621,18736
187046,2,1,10749,6973,17722
187046,4,3,366,648,1014
187134,1,999,3153,5068,8221
187134,2,1,2785,3895,6680
187134,4,3,368,1173,1541
187161,1,999,262,1818,2080
187161,2,1,262,1818,2080
187198,1,999,7552,10720,18272
187198,2,1,7552,10720,18272
187222,1,999,2193,4218,6411
187222,2,1,155,760,915
187222,4,3,2038,3458,5496
187444,1,999,5397,7630,13027
187444,2,1,4870,5940,10810
187444,4,3,527,1690,2217
187505,1,999,88,1541,1629
187505,2,1,88,1541,1629
187532,1,999,18624,22882,41506
187532,2,1,18624,22882,41506
187596,1,999,413,449,862
187596,2,1,413,449,862
187602,1,999,23,133,156
187602,2,1,23,133,156
187620,1,999,5630,7043,12673
187620,2,1,5630,7043,12673
187639,1,999,2007,4302,6309
187639,2,1,2007,4302,6309
187648,1,999,2658,3752,6410
187648,2,1,2285,2791,5076
187648,4,3,373,961,1334
187666,1,999,3137,3331,6468
187666,2,1,3137,3331,6468
187745,1,999,227,248,475
187745,2,1,227,248,475
187897,1,999,1706,3040,4746
187897,2,1,1087,1611,2698
187897,4,3,619,1429,2048
187903,1,999,2127,3039,5166
187903,2,1,2127,3039,5166
187912,1,999,369,87,456
187912,2,1,369,87,456
187958,1,999,1386,2463,3849
187958,2,1,1386,2463,3849
187967,1,999,1503,908,2411
187967,2,1,1051,585,1636
187967,4,3,452,323,775
187976,1,999,589,798,1387
187976,2,1,589,798,1387
187985,1,999,13812,17970,31782
187985,2,1,10072,12558,22630
187985,4,3,3740,5412,9152
187994,1,999,2162,3695,5857
187994,2,1,2162,3695,5857
188003,1,999,1306,2107,3413
188003,2,1,1306,2107,3413
188021,1,999,905,1856,2761
188021,2,1,905,1856,2761
188030,1,999,9589,12100,21689
188030,2,1,7600,9382,16982
188030,4,3,1989,2718,4707
188049,1,999,1283,2115,3398
188049,2,1,1283,2115,3398
188058,1,999,1160,1919,3079
188058,2,1,1160,1919,3079
188100,1,999,5732,5872,11604
188100,2,1,5732,5872,11604
188137,1,999,2897,4629,7526
188137,2,1,2897,4629,7526
188146,1,999,125,143,268
188146,2,1,120,119,239
188146,4,3,5,24,29
188182,1,999,360,415,775
188182,2,1,293,246,539
188182,4,3,67,169,236
188207,1,999,18,134,152
188207,4,3,18,134,152
188216,1,999,457,533,990
188216,2,1,457,533,990
188225,1,999,815,1270,2085
188225,2,1,815,1270,2085
188261,1,999,1198,818,2016
188261,2,1,1198,818,2016
188304,1,999,1565,2384,3949
188304,2,1,1345,1969,3314
188304,4,3,220,415,635
188340,1,999,1411,188,1599
188340,2,1,1398,178,1576
188340,4,3,13,10,23
188429,1,999,2706,8297,11003
188429,2,1,1650,4133,5783
188429,4,3,1056,4164,5220
188438,1,999,2168,3062,5230
188438,2,1,2168,3062,5230
188465,1,999,505,284,789
188465,2,1,505,284,789
188517,1,999,313,819,1132
188517,2,1,313,819,1132
188526,1,999,655,916,1571
188526,2,1,448,671,1119
188526,4,3,207,245,452
188535,1,999,444,354,798
188535,4,3,444,354,798
188580,1,999,364,445,809
188580,4,3,364,445,809
188641,1,999,1120,1412,2532
188641,2,1,955,999,1954
188641,4,3,165,413,578
188650,1,999,52,648,700
188650,2,1,52,648,700
188669,1,999,15,70,85
188669,2,1,15,70,85
188678,1,999,78,132,210
188678,2,1,78,132,210
188687,1,999,198,202,400
188687,2,1,198,202,400
188696,1,999,17,59,76
188696,2,1,17,59,76
188854,1,999,499,828,1327
188854,2,1,499,828,1327
188890,1,999,3042,64,3106
188890,2,1,3042,64,3106
188915,1,999,8,64,72
188915,2,1,8,64,72
188942,1,999,0,109,109
188942,2,1,0,109,109
188988,1,999,175,460,635
188988,2,1,175,460,635
189015,1,999,176,1272,1448
189015,4,3,176,1272,1448
189088,1,999,1279,1584,2863
189088,2,1,1152,1389,2541
189088,4,3,127,195,322
189097,1,999,0,2472,2472
189097,2,1,0,2472,2472
189219,1,999,251,13,264
189219,2,1,251,13,264
189228,1,999,2101,4331,6432
189228,2,1,2101,4331,6432
189264,1,999,70,0,70
189264,2,1,70,0,70
189273,1,999,42,0,42
189273,2,1,36,0,36
189273,4,3,6,0,6
189282,1,999,58,214,272
189282,2,1,58,214,272
189404,1,999,16,159,175
189404,2,1,16,159,175
189413,1,999,287,1045,1332
189413,2,1,274,970,1244
189413,4,3,13,75,88
189422,1,999,492,772,1264
189422,2,1,492,772,1264
189459,1,999,1369,1313,2682
189459,2,1,1369,1313,2682
189468,1,999,16,321,337
189468,2,1,16,321,337
189477,1,999,14,358,372
189477,2,1,14,358,372
189501,1,999,772,725,1497
189501,4,3,772,725,1497
189547,1,999,4016,5002,9018
189547,2,1,4016,5002,9018
189556,1,999,216,579,795
189556,2,1,216,579,795
189565,1,999,259,644,903
189565,2,1,259,644,903
189574,1,999,323,857,1180
189574,2,1,323,857,1180
189583,1,999,440,1037,1477
189583,2,1,440,1037,1477
189592,1,999,122,430,552
189592,2,1,122,430,552
189653,1,999,15,156,171
189653,2,1,15,156,171
189705,1,999,2519,3091,5610
189705,2,1,1608,1739,3347
189705,4,3,911,1352,2263
189714,1,999,6,276,282
189714,2,1,6,276,282
189811,1,999,53,183,236
189811,2,1,53,183,236
189839,1,999,2896,4613,7509
189839,2,1,2896,4613,7509
189848,1,999,399,1162,1561
189848,2,1,399,1162,1561
189857,1,999,681,0,681
189857,2,1,606,0,606
189857,4,3,75,0,75
189954,1,999,5,63,68
189954,2,1,5,63,68
189981,1,999,54,49,103
189981,4,3,54,49,103
190008,1,999,43,51,94
190008,2,1,43,51,94
190044,1,999,2352,944,3296
190044,2,1,2012,781,2793
190044,4,3,340,163,503
190053,1,999,1257,1517,2774
190053,2,1,1257,1517,2774
190071,1,999,52,280,332
190071,2,1,52,280,332
190080,1,999,47,68,115
190080,4,3,47,68,115
190099,1,999,1365,1564,2929
190099,2,1,1361,1554,2915
190099,4,3,4,10,14
190114,1,999,486,1080,1566
190114,2,1,297,682,979
190114,4,3,189,398,587
190150,1,999,13105,13236,26341
190150,2,1,4101,4072,8173
190150,4,3,9004,9164,18168
190169,1,999,1034,1648,2682
190169,2,1,1034,1648,2682
190239,1,999,16,369,385
190239,2,1,16,369,385
190248,1,999,308,592,900
190248,2,1,308,592,900
190293,1,999,14,204,218
190293,2,1,14,204,218
190309,1,999,3,86,89
190309,2,1,3,86,89
190318,1,999,35,619,654
190318,2,1,35,619,654
190372,1,999,654,358,1012
190372,2,1,568,347,915
190372,4,3,86,11,97
190415,1,999,11190,9967,21157
190415,2,1,7196,7002,14198
190415,4,3,3994,2965,6959
190424,1,999,550,671,1221
190424,4,3,550,671,1221
190442,1,999,3484,4188,7672
190442,2,1,3484,4188,7672
190451,1,999,44,303,347
190451,2,1,44,303,347
190503,1,999,2594,1956,4550
190503,2,1,2594,1956,4550
190512,1,999,10206,11111,21317
190512,2,1,7844,8527,16371
190512,4,3,2362,2584,4946
190521,1,999,12025,17674,29699
190521,2,1,12025,17674,29699
190530,1,999,5710,8513,14223
190530,2,1,5710,8513,14223
190549,1,999,8081,13422,21503
190549,2,1,6487,9701,16188
190549,4,3,1594,3721,5315
190558,1,999,7050,9992,17042
190558,2,1,6721,9100,15821
190558,4,3,329,892,1221
190567,1,999,8945,10301,19246
190567,2,1,7228,7758,14986
190567,4,3,1717,2543,4260
190576,1,999,2845,4579,7424
190576,2,1,568,1111,1679
190576,4,3,2277,3468,5745
190585,1,999,2604,5873,8477
190585,2,1,2604,5873,8477
190594,1,999,8453,19565,28018
190594,2,1,6661,13334,19995
190594,4,3,1792,6231,8023
190600,1,999,7570,10580,18150
190600,2,1,6684,8981,15665
190600,4,3,886,1599,2485
190619,1,999,11285,14140,25425
190619,2,1,11285,14140,25425
190628,1,999,9275,13253,22528
190628,2,1,9275,13253,22528
190637,1,999,4672,11373,16045
190637,2,1,3890,8985,12875
190637,4,3,782,2388,3170
190646,1,999,2352,7013,9365
190646,2,1,2352,7013,9365
190655,1,999,9860,9329,19189
190655,2,1,9860,9329,19189
190664,1,999,9851,15848,25699
190664,2,1,8063,11685,19748
190664,4,3,1788,4163,5951
190673,1,999,9294,11559,20853
190673,2,1,9294,11559,20853
190682,1,999,159,263,422
190682,4,3,159,263,422
190691,1,999,3335,6448,9783
190691,2,1,3327,6397,9724
190691,4,3,8,51,59
190707,1,999,4,22,26
190707,2,1,4,22,26
190716,1,999,943,2540,3483
190716,2,1,552,1607,2159
190716,4,3,391,933,1324
190725,1,999,703,2675,3378
190725,2,1,555,1711,2266
190725,4,3,148,964,1112
190734,1,999,17,0,17
190734,2,1,9,0,9
190734,4,3,8,0,8
190761,1,999,670,1594,2264
190761,2,1,581,1297,1878
190761,4,3,89,297,386
190770,1,999,2903,4035,6938
190770,2,1,1777,2062,3839
190770,4,3,1126,1973,3099
190840,1,999,5839,7197,13036
190840,2,1,5839,7197,13036
190956,1,999,21,112,133
190956,2,1,21,112,133
190974,1,999,129,727,856
190974,2,1,129,727,856
190983,1,999,523,1413,1936
190983,2,1,431,1090,1521
190983,4,3,92,323,415
191083,1,999,10528,10999,21527
191083,2,1,10528,10999,21527
191126,1,999,2223,11525,13748
191126,2,1,2193,11296,13489
191126,4,3,30,229,259
191199,1,999,4009,5161,9170
191199,2,1,4009,5161,9170
191205,1,999,872,393,1265
191205,2,1,815,368,1183
191205,4,3,57,25,82
191241,1,999,7318,9693,17011
191241,2,1,4148,4765,8913
191241,4,3,3170,4928,8098
191287,1,999,374,473,847
191287,2,1,374,473,847
191302,1,999,1462,1951,3413
191302,2,1,1462,1951,3413
191311,1,999,82,139,221
191311,2,1,82,139,221
191320,1,999,85,70,155
191320,4,3,85,70,155
191339,1,999,3432,5741,9173
191339,2,1,3432,5741,9173
191384,1,999,81,312,393
191384,2,1,81,312,393
191393,1,999,113,943,1056
191393,2,1,113,943,1056
191515,1,999,970,1067,2037
191515,2,1,970,1067,2037
191533,1,999,619,908,1527
191533,2,1,619,908,1527
191597,1,999,98,559,657
191597,2,1,98,559,657
191612,1,999,2339,3525,5864
191612,2,1,2339,3525,5864
191621,1,999,392,618,1010
191621,2,1,392,618,1010
191630,1,999,979,1149,2128
191630,2,1,978,1142,2120
191630,4,3,1,7,8
191649,1,999,6016,7449,13465
191649,2,1,4190,4442,8632
191649,4,3,1826,3007,4833
191676,1,999,520,959,1479
191676,2,1,506,945,1451
191676,4,3,14,14,28
191719,1,999,9749,9329,19078
191719,2,1,9749,9329,19078
191728,1,999,334,1335,1669
191728,2,1,334,1335,1669
191764,1,999,174,41,215
191764,2,1,174,41,215
191834,1,999,1190,125,1315
191834,2,1,1190,125,1315
191931,1,999,2396,3290,5686
191931,2,1,1807,2269,4076
191931,4,3,589,1021,1610
191940,1,999,16,81,97
191940,2,1,16,81,97
191959,1,999,162,28,190
191959,2,1,162,28,190
191968,1,999,3142,4245,7387
191968,2,1,2938,3808,6746
191968,4,3,204,437,641
191986,1,999,3338,3892,7230
191986,2,1,3338,3892,7230
192004,1,999,112,350,462
192004,2,1,112,350,462
192022,1,999,2026,3046,5072
192022,2,1,2026,3046,5072
192040,1,999,253,273,526
192040,2,1,82,98,180
192040,4,3,171,175,346
192110,1,999,534,479,1013
192110,2,1,341,321,662
192110,4,3,193,158,351
192156,1,999,444,621,1065
192156,2,1,444,621,1065
192165,1,999,112,0,112
192165,2,1,112,0,112
192192,1,999,494,1446,1940
192192,2,1,423,1293,1716
192192,4,3,71,153,224
192244,1,999,27,0,27
192244,2,1,23,0,23
192244,4,3,4,0,4
192271,1,999,102,1457,1559
192271,2,1,93,1399,1492
192271,4,3,9,58,67
192323,1,999,1495,2763,4258
192323,2,1,1157,2037,3194
192323,4,3,338,726,1064
192439,1,999,2928,7149,10077
192439,2,1,1630,4099,5729
192439,4,3,1298,3050,4348
192448,1,999,3815,9531,13346
192448,2,1,2732,6618,9350
192448,4,3,1083,2913,3996
192475,1,999,31,170,201
192475,2,1,31,170,201
192484,1,999,4,266,270
192484,2,1,4,266,270
192509,1,999,594,1357,1951
192509,2,1,594,1357,1951
192536,1,999,15,8,23
192536,2,1,15,8,23
192554,1,999,173,533,706
192554,4,3,173,533,706
192563,1,999,77,568,645
192563,2,1,16,28,44
192563,4,3,61,540,601
192624,1,999,114,0,114
192624,2,1,114,0,114
192688,1,999,97,606,703
192688,2,1,97,606,703
192703,1,999,1850,1718,3568
192703,2,1,1647,1474,3121
192703,4,3,203,244,447
192712,1,999,445,496,941
192712,2,1,208,191,399
192712,4,3,237,305,542
192749,1,999,1342,2688,4030
192749,2,1,749,1391,2140
192749,4,3,593,1297,1890
192785,1,999,128,944,1072
192785,2,1,128,944,1072
192800,1,999,3,26,29
192800,2,1,3,26,29
192819,1,999,3282,3936,7218
192819,2,1,2779,3282,6061
192819,4,3,503,654,1157
192828,1,999,5,109,114
192828,2,1,5,109,114
192864,1,999,647,1715,2362
192864,2,1,647,1715,2362
192925,1,999,1024,2364,3388
192925,2,1,703,1284,1987
192925,4,3,321,1080,1401
192961,1,999,21,114,135
192961,2,1,21,114,135
192970,1,999,6,9,15
192970,2,1,6,9,15
192998,1,999,12,37,49
192998,2,1,12,37,49
193016,1,999,3402,8863,12265
193016,2,1,2416,4746,7162
193016,4,3,986,4117,5103
193052,1,999,275,0,275
193052,2,1,154,0,154
193052,4,3,121,0,121
193061,1,999,42,0,42
193061,2,1,35,0,35
193061,4,3,7,0,7
193070,1,999,81,0,81
193070,2,1,56,0,56
193070,4,3,25,0,25
193122,1,999,32,131,163
193122,2,1,32,131,163
193186,1,999,2,158,160
193186,2,1,2,158,160
193201,1,999,235,1006,1241
193201,2,1,235,1006,1241
193247,1,999,335,0,335
193247,2,1,270,0,270
193247,4,3,65,0,65
193265,1,999,125,4,129
193265,2,1,125,4,129
193283,1,999,4218,5030,9248
193283,2,1,4218,5030,9248
193292,1,999,1864,4825,6689
193292,2,1,1608,3740,5348
193292,4,3,256,1085,1341
193308,1,999,1987,5191,7178
193308,2,1,1895,4934,6829
193308,4,3,92,257,349
193317,1,999,1070,1789,2859
193317,2,1,927,1610,2537
193317,4,3,143,179,322
193326,1,999,17424,17138,34562
193326,2,1,17424,17138,34562
193353,1,999,788,2364,3152
193353,2,1,629,1833,2462
193353,4,3,159,531,690
193380,1,999,17,146,163
193380,2,1,17,146,163
193399,1,999,643,2039,2682
193399,2,1,435,1307,1742
193399,4,3,208,732,940
193405,1,999,454,558,1012
193405,4,3,454,558,1012
193478,1,999,15909,17440,33349
193478,2,1,15909,17440,33349
193584,1,999,800,2990,3790
193584,2,1,548,1762,2310
193584,4,3,252,1228,1480
193609,1,999,62,88,150
193609,2,1,62,88,150
193645,1,999,591,5920,6511
193645,2,1,450,4737,5187
193645,4,3,141,1183,1324
193654,1,999,3833,8744,12577
193654,2,1,2344,6234,8578
193654,4,3,1489,2510,3999
193672,1,999,72,35,107
193672,2,1,72,35,107
193751,1,999,489,391,880
193751,4,3,489,391,880
193760,1,999,586,852,1438
193760,2,1,586,852,1438
193788,1,999,280,370,650
193788,2,1,280,370,650
193821,1,999,968,980,1948
193821,4,3,968,980,1948
193830,1,999,597,931,1528
193830,4,3,597,931,1528
193858,1,999,43,528,571
193858,2,1,43,528,571
193894,1,999,247,188,435
193894,4,3,247,188,435
193900,1,999,20490,29343,49833
193900,2,1,9900,15295,25195
193900,4,3,10590,14048,24638
193946,1,999,3799,5070,8869
193946,2,1,3799,5070,8869
193973,1,999,1739,3040,4779
193973,2,1,1301,2186,3487
193973,4,3,438,854,1292
193991,1,999,3,54,57
193991,2,1,3,54,57
194028,1,999,1040,1650,2690
194028,2,1,1040,1650,2690
194073,1,999,209,164,373
194073,4,3,209,164,373
194091,1,999,8290,5951,14241
194091,2,1,5477,3380,8857
194091,4,3,2813,2571,5384
194116,1,999,101,825,926
194116,2,1,88,777,865
194116,4,3,13,48,61
194161,1,999,1620,2269,3889
194161,2,1,1058,1477,2535
194161,4,3,562,792,1354
194189,1,999,133,0,133
194189,2,1,133,0,133
194204,1,999,19,91,110
194204,2,1,19,91,110
194222,1,999,9317,10043,19360
194222,2,1,9317,10043,19360
194240,1,999,4054,5550,9604
194240,2,1,4054,5550,9604
194259,1,999,6,43,49
194259,2,1,6,43,49
194310,1,999,6074,8982,15056
194310,2,1,3832,5532,9364
194310,4,3,2242,3450,5692
194392,1,999,678,312,990
194392,2,1,678,312,990
194435,1,999,5,224,229
194435,2,1,5,224,229
194453,1,999,16,194,210
194453,2,1,16,194,210
194499,1,999,215,1217,1432
194499,2,1,215,1217,1432
194541,1,999,3759,1187,4946
194541,2,1,1438,358,1796
194541,4,3,2321,829,3150
194569,1,999,220,187,407
194569,2,1,220,187,407
194578,1,999,1723,3359,5082
194578,2,1,1198,1964,3162
194578,4,3,525,1395,1920
194611,1,999,531,1047,1578
194611,2,1,531,1047,1578
194657,1,999,284,0,284
194657,2,1,172,0,172
194657,4,3,112,0,112
194666,1,999,285,0,285
194666,2,1,232,0,232
194666,4,3,53,0,53
194675,1,999,59,0,59
194675,2,1,46,0,46
194675,4,3,13,0,13
194693,1,999,35,0,35
194693,2,1,35,0,35
194718,1,999,60,0,60
194718,2,1,58,0,58
194718,4,3,2,0,2
194736,1,999,122,0,122
194736,2,1,122,0,122
194763,1,999,471,0,471
194763,2,1,224,0,224
194763,4,3,247,0,247
194824,1,999,5003,1952,6955
194824,2,1,4059,1576,5635
194824,4,3,944,376,1320
194879,1,999,98,259,357
194879,2,1,98,259,357
194958,1,999,632,1651,2283
194958,2,1,481,1123,1604
194958,4,3,151,528,679
194967,1,999,731,1893,2624
194967,2,1,731,1893,2624
195003,1,999,12673,6279,18952
195003,2,1,10705,5191,15896
195003,4,3,1968,1088,3056
195030,1,999,5036,5570,10606
195030,2,1,2761,3164,5925
195030,4,3,2275,2406,4681
195049,1,999,117,98,215
195049,4,3,117,98,215
195058,1,999,4658,5682,10340
195058,2,1,4658,5682,10340
195067,1,999,80,1223,1303
195067,2,1,80,1223,1303
195128,1,999,622,2737,3359
195128,2,1,353,1467,1820
195128,4,3,269,1270,1539
195155,1,999,80,68,148
195155,4,3,80,68,148
195164,1,999,1274,1509,2783
195164,2,1,992,1082,2074
195164,4,3,282,427,709
195173,1,999,1269,1607,2876
195173,2,1,1250,1596,2846
195173,4,3,19,11,30
195191,1,999,34,265,299
195191,2,1,34,265,299
195216,1,999,1142,1433,2575
195216,2,1,1090,1303,2393
195216,4,3,52,130,182
195234,1,999,1786,4382,6168
195234,2,1,996,2251,3247
195234,4,3,790,2131,2921
195243,1,999,1077,1348,2425
195243,2,1,990,1151,2141
195243,4,3,87,197,284
195289,1,999,29,169,198
195289,2,1,29,169,198
195304,1,999,438,1390,1828
195304,2,1,388,1065,1453
195304,4,3,50,325,375
195322,1,999,3277,4211,7488
195322,2,1,3277,4211,7488
195429,1,999,104,51,155
195429,4,3,104,51,155
195438,1,999,257,0,257
195438,2,1,244,0,244
195438,4,3,13,0,13
195474,1,999,1646,1858,3504
195474,2,1,1630,1835,3465
195474,4,3,16,23,39
195492,1,999,28,32,60
195492,2,1,28,32,60
195526,1,999,1157,1761,2918
195526,2,1,1143,1709,2852
195526,4,3,14,52,66
195544,1,999,1736,4779,6515
195544,2,1,1571,4088,5659
195544,4,3,165,691,856
195571,1,999,98,60,158
195571,4,3,98,60,158
195580,1,999,68,12,80
195580,4,3,68,12,80
195623,1,999,16,20,36
195623,2,1,16,20,36
195669,1,999,13,31,44
195669,2,1,13,31,44
195687,1,999,37,213,250
195687,2,1,37,213,250
195702,1,999,6,14,20
195702,2,1,6,14,20
195720,1,999,1667,2653,4320
195720,2,1,1265,1791,3056
195720,4,3,402,862,1264
195784,1,999,50,218,268
195784,2,1,50,218,268
195793,1,999,7,22,29
195793,2,1,7,22,29
195809,1,999,9563,13258,22821
195809,2,1,7253,9029,16282
195809,4,3,2310,4229,6539
195845,1,999,127,925,1052
195845,2,1,127,925,1052
195924,1,999,184,691,875
195924,2,1,184,691,875
195933,1,999,617,1285,1902
195933,2,1,617,1285,1902
195988,1,999,1005,1355,2360
195988,2,1,1005,1355,2360
196006,1,999,2377,1580,3957
196006,2,1,2377,1580,3957
196015,1,999,2231,2356,4587
196015,2,1,2231,2356,4587
196024,1,999,1779,1737,3516
196024,2,1,1779,1737,3516
196033,1,999,1562,1455,3017
196033,2,1,1562,1455,3017
196042,1,999,5346,4312,9658
196042,2,1,5346,4312,9658
196051,1,999,2048,2048,4096
196051,2,1,2048,2048,4096
196060,1,999,9759,10811,20570
196060,2,1,7625,7250,14875
196060,4,3,2134,3561,5695
196079,1,999,8454,7683,16137
196079,2,1,6679,5997,12676
196079,4,3,1775,1686,3461
196088,1,999,16582,15312,31894
196088,2,1,11525,9825,21350
196088,4,3,5057,5487,10544
196097,1,999,14196,15334,29530
196097,2,1,9857,9309,19166
196097,4,3,4339,6025,10364
196103,1,999,1519,1259,2778
196103,2,1,1226,974,2200
196103,4,3,293,285,578
196112,1,999,1769,1823,3592
196112,2,1,1348,1388,2736
196112,4,3,421,435,856
196121,1,999,4049,5772,9821
196121,2,1,3434,4551,7985
196121,4,3,615,1221,1836
196130,1,999,5428,8271,13699
196130,2,1,4618,6443,11061
196130,4,3,810,1828,2638
196149,1,999,3572,4879,8451
196149,2,1,2904,3841,6745
196149,4,3,668,1038,1706
196158,1,999,2651,3543,6194
196158,2,1,2486,3155,5641
196158,4,3,165,388,553
196167,1,999,2538,3601,6139
196167,2,1,2459,3432,5891
196167,4,3,79,169,248
196176,1,999,3247,6270,9517
196176,2,1,2639,4921,7560
196176,4,3,608,1349,1957
196185,1,999,2818,3910,6728
196185,2,1,2765,3725,6490
196185,4,3,53,185,238
196194,1,999,4496,5202,9698
196194,2,1,3902,4150,8052
196194,4,3,594,1052,1646
196200,1,999,1997,2997,4994
196200,2,1,1786,2406,4192
196200,4,3,211,591,802
196219,1,999,2226,2783,5009
196219,2,1,2170,2705,4875
196219,4,3,56,78,134
196228,1,999,77,225,302
196228,4,3,77,225,302
196237,1,999,2108,2900,5008
196237,2,1,2054,2836,4890
196237,4,3,54,64,118
196246,1,999,3159,4215,7374
196246,2,1,2936,3666,6602
196246,4,3,223,549,772
196255,1,999,621,1228,1849
196255,2,1,80,334,414
196255,4,3,541,894,1435
196264,1,999,7930,11926,19856
196264,2,1,7451,11241,18692
196264,4,3,479,685,1164
196291,1,999,1763,214,1977
196291,2,1,1544,175,1719
196291,4,3,219,39,258
196307,1,999,516,976,1492
196307,2,1,79,264,343
196307,4,3,437,712,1149
196389,1,999,215,499,714
196389,2,1,204,467,671
196389,4,3,11,32,43
196413,1,999,13497,17519,31016
196413,2,1,10101,13648,23749
196413,4,3,3396,3871,7267
196431,1,999,298,0,298
196431,2,1,298,0,298
196440,1,999,34,0,34
196440,2,1,28,0,28
196440,4,3,6,0,6
196468,1,999,1538,4938,6476
196468,4,3,1538,4938,6476
196477,1,999,4246,2516,6762
196477,2,1,4246,2516,6762
196565,1,999,3787,4744,8531
196565,2,1,3787,4744,8531
196583,1,999,189,0,189
196583,2,1,189,0,189
196592,1,999,5308,14179,19487
196592,2,1,3029,6538,9567
196592,4,3,2279,7641,9920
196653,1,999,216,1322,1538
196653,2,1,216,1322,1538
196680,1,999,17873,21922,39795
196680,2,1,17370,20853,38223
196680,4,3,503,1069,1572
196699,1,999,1925,2622,4547
196699,2,1,1925,2622,4547
196857,1,999,390,3179,3569
196857,2,1,390,3179,3569
196866,1,999,1164,1095,2259
196866,2,1,1164,1095,2259
196884,1,999,97,154,251
196884,4,3,97,154,251
197018,1,999,1667,9,1676
197018,2,1,1508,8,1516
197018,4,3,159,1,160
197027,1,999,936,113,1049
197027,2,1,914,110,1024
197027,4,3,22,3,25
197036,1,999,3955,731,4686
197036,2,1,3955,731,4686
197045,1,999,1626,2324,3950
197045,2,1,1262,1687,2949
197045,4,3,364,637,1001
197081,1,999,175,604,779
197081,2,1,175,604,779
197133,1,999,1081,1608,2689
197133,2,1,1081,1607,2688
197133,4,3,0,1,1
197142,1,999,207,373,580
197142,2,1,207,373,580
197151,1,999,1885,2560,4445
197151,2,1,1665,2215,3880
197151,4,3,220,345,565
197197,1,999,874,1555,2429
197197,2,1,710,1234,1944
197197,4,3,164,321,485
197221,1,999,77,12,89
197221,2,1,77,12,89
197230,1,999,169,418,587
197230,2,1,169,418,587
197285,1,999,980,993,1973
197285,2,1,980,993,1973
197294,1,999,9544,12170,21714
197294,2,1,9544,12170,21714
197337,1,999,10,122,132
197337,2,1,10,122,132
197522,1,999,108,566,674
197522,2,1,108,566,674
197531,1,999,315,311,626
197531,2,1,315,311,626
197601,1,999,83,0,83
197601,2,1,83,0,83
197610,1,999,155,0,155
197610,2,1,135,0,135
197610,4,3,20,0,20
197647,1,999,179,0,179
197647,2,1,113,0,113
197647,4,3,66,0,66
197674,1,999,231,0,231
197674,2,1,212,0,212
197674,4,3,19,0,19
197692,1,999,116,0,116
197692,2,1,98,0,98
197692,4,3,18,0,18
197708,1,999,3281,3535,6816
197708,2,1,1602,1340,2942
197708,4,3,1679,2195,3874
197735,1,999,492,0,492
197735,2,1,364,0,364
197735,4,3,128,0,128
197744,1,999,240,0,240
197744,2,1,197,0,197
197744,4,3,43,0,43
197814,1,999,1444,2723,4167
197814,2,1,1444,2723,4167
197832,1,999,514,955,1469
197832,2,1,514,955,1469
197850,1,999,1134,2685,3819
197850,2,1,1134,2685,3819
197869,1,999,8613,10129,18742
197869,2,1,7797,8286,16083
197869,4,3,816,1843,2659
197887,1,999,4857,5904,10761
197887,2,1,4857,5904,10761
197911,1,999,360,904,1264
197911,2,1,360,904,1264
197966,1,999,886,1664,2550
197966,2,1,886,1664,2550
197984,1,999,699,1171,1870
197984,2,1,699,1171,1870
197993,1,999,0,823,823
197993,2,1,0,823,823
198011,1,999,646,1701,2347
198011,2,1,646,1701,2347
198039,1,999,1497,2044,3541
198039,2,1,1497,2044,3541
198066,1,999,408,308,716
198066,2,1,408,308,716
198075,1,999,57,407,464
198075,2,1,57,407,464
198084,1,999,947,1730,2677
198084,2,1,947,1730,2677
198109,1,999,52,464,516
198109,2,1,52,464,516
198118,1,999,3006,3534,6540
198118,2,1,3006,3534,6540
198136,1,999,3637,3707,7344
198136,2,1,2876,2684,5560
198136,4,3,761,1023,1784
198154,1,999,6081,6958,13039
198154,2,1,6081,6958,13039
198190,1,999,69,29,98
198190,2,1,69,29,98
198206,1,999,867,1779,2646
198206,2,1,867,1779,2646
198215,1,999,672,799,1471
198215,2,1,672,760,1432
198215,4,3,0,39,39
198233,1,999,2972,4171,7143
198233,2,1,2972,4171,7143
198242,1,999,118,398,516
198242,2,1,118,398,516
198251,1,999,2945,4894,7839
198251,2,1,2945,4894,7839
198260,1,999,12808,16716,29524
198260,2,1,12808,16716,29524
198303,1,999,588,599,1187
198303,2,1,588,599,1187
198321,1,999,2404,3871,6275
198321,2,1,2404,3871,6275
198330,1,999,2671,4658,7329
198330,2,1,2671,4658,7329
198367,1,999,2461,3788,6249
198367,2,1,2461,3788,6249
198376,1,999,2031,3767,5798
198376,2,1,2031,3767,5798
198385,1,999,914,959,1873
198385,2,1,914,959,1873
198419,1,999,8247,7629,15876
198419,2,1,3645,3554,7199
198419,4,3,4602,4075,8677
198455,1,999,3316,5305,8621
198455,2,1,3316,5305,8621
198464,1,999,12297,19234,31531
198464,2,1,9776,13920,23696
198464,4,3,2521,5314,7835
198491,1,999,1297,3555,4852
198491,2,1,1297,3555,4852
198507,1,999,1488,2471,3959
198507,2,1,1471,2403,3874
198507,4,3,17,68,85
198516,1,999,2476,3449,5925
198516,2,1,2132,3041,5173
198516,4,3,344,408,752
198525,1,999,3,63,66
198525,2,1,3,63,66
198534,1,999,4966,10825,15791
198534,2,1,4966,10825,15791
198543,1,999,2449,5098,7547
198543,2,1,2179,4349,6528
198543,4,3,270,749,1019
198552,1,999,4934,7895,12829
198552,2,1,4934,7895,12829
198561,1,999,1891,3313,5204
198561,2,1,1231,2279,3510
198561,4,3,660,1034,1694
198570,1,999,3482,5879,9361
198570,2,1,3482,5879,9361
198598,1,999,631,809,1440
198598,2,1,599,732,1331
198598,4,3,32,77,109
198613,1,999,1362,2002,3364
198613,2,1,1362,2002,3364
198622,1,999,7945,9911,17856
198622,2,1,7945,9911,17856
198631,1,999,52,25,77
198631,2,1,52,25,77
198640,1,999,972,1568,2540
198640,2,1,972,1568,2540
198668,1,999,1807,2556,4363
198668,2,1,1807,2556,4363
198677,1,999,45,49,94
198677,2,1,45,49,94
198695,1,999,1497,2558,4055
198695,2,1,1361,2281,3642
198695,4,3,136,277,413
198710,1,999,1672,2503,4175
198710,2,1,1672,2503,4175
198729,1,999,776,1422,2198
198729,2,1,776,1422,2198
198747,1,999,79,77,156
198747,2,1,79,77,156
198756,1,999,666,947,1613
198756,2,1,666,947,1613
198774,1,999,2468,3803,6271
198774,2,1,2468,3803,6271
198808,1,999,357,598,955
198808,2,1,357,598,955
198817,1,999,2098,3629,5727
198817,2,1,2098,3629,5727
198835,1,999,646,1235,1881
198835,2,1,567,1020,1587
198835,4,3,79,215,294
198844,1,999,17,170,187
198844,2,1,17,170,187
198862,1,999,649,523,1172
198862,2,1,649,523,1172
198871,1,999,522,229,751
198871,2,1,522,229,751
198899,1,999,648,726,1374
198899,2,1,648,726,1374
198905,1,999,388,754,1142
198905,2,1,388,754,1142
198914,1,999,1150,1096,2246
198914,2,1,1150,1096,2246
198923,1,999,961,1336,2297
198923,2,1,961,1336,2297
198941,1,999,33,167,200
198941,2,1,33,167,200
198950,1,999,46,2467,2513
198950,2,1,11,2161,2172
198950,4,3,35,306,341
198969,1,999,1430,1247,2677
198969,2,1,1324,1116,2440
198969,4,3,106,131,237
198978,1,999,384,1552,1936
198978,2,1,384,1552,1936
198987,1,999,1722,3012,4734
198987,2,1,1722,3012,4734
198996,1,999,0,9,9
198996,2,1,0,9,9
199005,1,999,0,37,37
199005,2,1,0,37,37
199014,1,999,2,24,26
199014,2,1,2,24,26
199023,1,999,615,1234,1849
199023,2,1,615,1234,1849
199032,1,999,526,931,1457
199032,2,1,436,670,1106
199032,4,3,90,261,351
199069,1,999,1658,3363,5021
199069,2,1,1658,3363,5021
199078,1,999,3,58,61
199078,2,1,3,58,61
199087,1,999,2077,2783,4860
199087,2,1,2077,2783,4860
199102,1,999,5739,6715,12454
199102,2,1,4916,5427,10343
199102,4,3,823,1288,2111
199111,1,999,2040,2567,4607
199111,2,1,2015,2531,4546
199111,4,3,25,36,61
199120,1,999,13275,19051,32326
199120,2,1,8005,11375,19380
199120,4,3,5270,7676,12946
199139,1,999,13649,15495,29144
199139,2,1,10994,11321,22315
199139,4,3,2655,4174,6829
199148,1,999,8320,16933,25253
199148,2,1,6845,13561,20406
199148,4,3,1475,3372,4847
199157,1,999,3312,6608,9920
199157,2,1,2553,4842,7395
199157,4,3,759,1766,2525
199184,1,999,505,379,884
199184,2,1,452,305,757
199184,4,3,53,74,127
199193,1,999,21402,17767,39169
199193,2,1,15887,12870,28757
199193,4,3,5515,4897,10412
199209,1,999,708,1084,1792
199209,2,1,708,1084,1792
199218,1,999,5921,8750,14671
199218,2,1,5323,7694,13017
199218,4,3,598,1056,1654
199263,1,999,311,471,782
199263,2,1,311,471,782
199272,1,999,11,848,859
199272,2,1,11,848,859
199281,1,999,3018,5185,8203
199281,2,1,2729,4498,7227
199281,4,3,289,687,976
199306,1,999,853,1498,2351
199306,2,1,519,633,1152
199306,4,3,334,865,1199
199315,1,999,313,141,454
199315,2,1,188,131,319
199315,4,3,125,10,135
199324,1,999,1952,2257,4209
199324,2,1,1952,2257,4209
199333,1,999,4741,6388,11129
199333,2,1,4741,6388,11129
199412,1,999,756,2327,3083
199412,2,1,495,1760,2255
199412,4,3,261,567,828
199421,1,999,1385,2433,3818
199421,2,1,1385,2433,3818
199449,1,999,814,1732,2546
199449,2,1,814,1732,2546
199458,1,999,109,79,188
199458,2,1,109,79,188
199467,1,999,412,756,1168
199467,2,1,412,756,1168
199476,1,999,1190,2625,3815
199476,2,1,1190,2625,3815
199485,1,999,1273,2087,3360
199485,2,1,1273,2087,3360
199494,1,999,4071,6321,10392
199494,2,1,4071,6321,10392
199582,1,999,783,747,1530
199582,2,1,783,747,1530
199607,1,999,67,1156,1223
199607,2,1,37,877,914
199607,4,3,30,279,309
199625,1,999,700,1449,2149
199625,2,1,700,1449,2149
199634,1,999,2095,3776,5871
199634,2,1,2095,3776,5871
199643,1,999,1111,1778,2889
199643,2,1,995,1667,2662
199643,4,3,116,111,227
199689,1,999,17,181,198
199689,2,1,17,181,198
199698,1,999,264,360,624
199698,2,1,264,360,624
199713,1,999,24,252,276
199713,2,1,24,252,276
199722,1,999,1215,2440,3655
199722,2,1,1215,2440,3655
199731,1,999,1447,2198,3645
199731,2,1,1447,2198,3645
199740,1,999,1686,3486,5172
199740,2,1,1686,3486,5172
199768,1,999,1999,3178,5177
199768,2,1,1999,3178,5177
199786,1,999,2908,4870,7778
199786,2,1,2908,4870,7778
199795,1,999,729,1251,1980
199795,2,1,729,1251,1980
199838,1,999,2545,3721,6266
199838,2,1,2545,3721,6266
199847,1,999,3924,3837,7761
199847,2,1,2524,2580,5104
199847,4,3,1400,1257,2657
199856,1,999,10392,12425,22817
199856,2,1,10392,12425,22817
199865,1,999,432,694,1126
199865,2,1,401,625,1026
199865,4,3,31,69,100
199883,1,999,34,168,202
199883,2,1,34,168,202
199892,1,999,1812,3163,4975
199892,2,1,1812,3163,4975
199908,1,999,1846,2703,4549
199908,2,1,1846,2703,4549
199926,1,999,1682,2382,4064
199926,2,1,1682,2382,4064
199953,1,999,1401,2640,4041
199953,2,1,1401,2640,4041
199962,1,999,1036,1335,2371
199962,2,1,705,836,1541
199962,4,3,331,499,830
199971,1,999,27,37,64
199971,2,1,27,37,64
199980,1,999,77,4,81
199980,2,1,77,4,81
199999,1,999,2198,5591,7789
199999,2,1,2050,5161,7211
199999,4,3,148,430,578
200004,1,999,4879,6447,11326
200004,2,1,3952,4793,8745
200004,4,3,927,1654,2581
200013,1,999,771,2064,2835
200013,2,1,771,2064,2835
200022,1,999,2985,2272,5257
200022,2,1,2985,2272,5257
200059,1,999,1207,1975,3182
200059,2,1,1207,1975,3182
200086,1,999,181,328,509
200086,2,1,181,328,509
200110,1,999,2,114,116
200110,2,1,2,114,116
200129,1,999,10,102,112
200129,2,1,10,102,112
200156,1,999,481,584,1065
200156,2,1,481,584,1065
200165,1,999,6,139,145
200165,2,1,6,139,145
200192,1,999,1271,1498,2769
200192,2,1,1271,1498,2769
200208,1,999,140,267,407
200208,2,1,140,267,407
200217,1,999,1313,2287,3600
200217,2,1,876,1390,2266
200217,4,3,437,897,1334
200226,1,999,483,721,1204
200226,2,1,483,721,1204
200244,1,999,8,128,136
200244,2,1,8,128,136
200253,1,999,1745,2885,4630
200253,2,1,1625,2501,4126
200253,4,3,120,384,504
200262,1,999,11,4,15
200262,2,1,11,4,15
200280,1,999,8252,7463,15715
200280,2,1,6908,5337,12245
200280,4,3,1344,2126,3470
200305,1,999,1705,1393,3098
200305,2,1,1705,1393,3098
200314,1,999,429,559,988
200314,2,1,429,559,988
200332,1,999,8787,7851,16638
200332,2,1,7137,5612,12749
200332,4,3,1650,2239,3889
200341,1,999,414,860,1274
200341,2,1,414,860,1274
200387,1,999,2,109,111
200387,2,1,2,109,111
200466,1,999,119,271,390
200466,2,1,119,271,390
200484,1,999,165,124,289
200484,2,1,165,124,289
200527,1,999,405,681,1086
200527,2,1,405,681,1086
200554,1,999,273,571,844
200554,2,1,273,571,844
200572,1,999,594,776,1370
200572,2,1,523,663,1186
200572,4,3,71,113,184
200590,1,999,158,267,425
200590,2,1,158,267,425
200624,1,999,46,39,85
200624,2,1,46,39,85
200633,1,999,103,555,658
200633,2,1,103,555,658
200697,1,999,782,84,866
200697,4,3,782,84,866
200785,1,999,421,1130,1551
200785,2,1,421,1130,1551
200800,1,999,15121,15953,31074
200800,2,1,12688,12181,24869
200800,4,3,2433,3772,6205
200828,1,999,10,73,83
200828,2,1,10,73,83
200846,1,999,1116,1674,2790
200846,2,1,1116,1674,2790
200873,1,999,33,32,65
200873,2,1,33,32,65
201016,1,999,182,505,687
201016,2,1,182,505,687
201034,1,999,1230,1418,2648
201034,2,1,1230,1418,2648
201061,1,999,70,135,205
201061,2,1,63,127,190
201061,4,3,7,8,15
201098,1,999,75,81,156
201098,2,1,75,81,156
201104,1,999,3992,5495,9487
201104,2,1,1745,1812,3557
201104,4,3,2247,3683,5930
201131,1,999,76,115,191
201131,2,1,76,115,191
201140,1,999,216,81,297
201140,2,1,126,35,161
201140,4,3,90,46,136
201159,1,999,352,239,591
201159,2,1,352,239,591
201177,1,999,48,283,331
201177,2,1,48,283,331
201195,1,999,2029,2917,4946
201195,2,1,1668,2272,3940
201195,4,3,361,645,1006
201283,1,999,1246,1943,3189
201283,2,1,1246,1943,3189
201371,1,999,597,695,1292
201371,2,1,521,561,1082
201371,4,3,76,134,210
201399,1,999,327,563,890
201399,2,1,327,563,890
201432,1,999,1111,1994,3105
201432,2,1,1111,1991,3102
201432,4,3,0,3,3
201441,1,999,9073,11074,20147
201441,2,1,7485,8464,15949
201441,4,3,1588,2610,4198
201469,1,999,202,923,1125
201469,2,1,202,923,1125
201478,1,999,66,107,173
201478,2,1,66,107,173
201496,1,999,393,390,783
201496,2,1,393,390,783
201539,1,999,42,128,170
201539,2,1,42,128,170
201548,1,999,1814,2378,4192
201548,2,1,1263,1847,3110
201548,4,3,551,531,1082
201584,1,999,6,60,66
201584,2,1,6,60,66
201609,1,999,1,63,64
201609,2,1,1,63,64
201618,1,999,2,47,49
201618,2,1,2,47,49
201627,1,999,1,88,89
201627,2,1,1,88,89
201645,1,999,5364,5147,10511
201645,2,1,2478,1922,4400
201645,4,3,2886,3225,6111
201654,1,999,1503,1852,3355
201654,2,1,1469,1740,3209
201654,4,3,34,112,146
201672,1,999,2009,4784,6793
201672,2,1,2009,4784,6793
201681,1,999,20,102,122
201681,2,1,20,102,122
201690,1,999,1385,1363,2748
201690,2,1,1363,1335,2698
201690,4,3,22,28,50
201751,1,999,77,246,323
201751,2,1,77,246,323
201803,1,999,31,173,204
201803,2,1,31,173,204
201821,1,999,43,323,366
201821,2,1,43,323,366
201858,1,999,748,469,1217
201858,2,1,509,383,892
201858,4,3,239,86,325
201867,1,999,79,86,165
201867,2,1,79,86,165
201885,1,999,16919,19989,36908
201885,2,1,12156,12962,25118
201885,4,3,4763,7027,11790
201928,1,999,9333,10365,19698
201928,2,1,9333,10365,19698
201946,1,999,2138,2946,5084
201946,2,1,2132,2925,5057
201946,4,3,6,21,27
201955,1,999,2474,4072,6546
201955,2,1,2459,4030,6489
201955,4,3,15,42,57
201964,1,999,649,774,1423
201964,2,1,635,772,1407
201964,4,3,14,2,16
201973,1,999,2438,4303,6741
201973,2,1,2438,4303,6741
201982,1,999,6,99,105
201982,2,1,6,99,105
202046,1,999,249,273,522
202046,2,1,249,273,522
202055,1,999,39,397,436
202055,2,1,39,397,436
202064,1,999,2769,188,2957
202064,2,1,2769,188,2957
202073,1,999,205,267,472
202073,2,1,123,133,256
202073,4,3,82,134,216
202134,1,999,9131,11904,21035
202134,2,1,6048,7421,13469
202134,4,3,3083,4483,7566
202152,1,999,159,523,682
202152,2,1,159,523,682
202161,1,999,357,633,990
202161,2,1,357,633,990
202170,1,999,692,1171,1863
202170,2,1,692,1171,1863
202189,1,999,245,728,973
202189,2,1,245,728,973
202222,1,999,20432,26741,47173
202222,2,1,20432,26741,47173
202268,1,999,26,226,252
202268,2,1,26,226,252
202356,1,999,16937,27101,44038
202356,2,1,16937,27101,44038
202435,1,999,136,666,802
202435,2,1,136,666,802
202453,1,999,94,11,105
202453,2,1,94,11,105
202480,1,999,6083,7478,13561
202480,2,1,3908,3805,7713
202480,4,3,2175,3673,5848
202514,1,999,542,675,1217
202514,2,1,489,569,1058
202514,4,3,53,106,159
202523,1,999,997,1287,2284
202523,2,1,997,1287,2284
202541,1,999,4314,3526,7840
202541,2,1,3631,2732,6363
202541,4,3,683,794,1477
202611,1,999,344,588,932
202611,2,1,218,473,691
202611,4,3,126,115,241
202639,1,999,5,131,136
202639,2,1,5,131,136
202648,1,999,1786,2976,4762
202648,2,1,1786,2974,4760
202648,4,3,0,2,2
202657,1,999,257,408,665
202657,2,1,257,408,665
202684,1,999,331,1039,1370
202684,2,1,331,1039,1370
202736,1,999,7,186,193
202736,2,1,7,186,193
202763,1,999,2730,4279,7009
202763,2,1,1866,2962,4828
202763,4,3,864,1317,2181
202806,1,999,4817,6475,11292
202806,2,1,4294,5735,10029
202806,4,3,523,740,1263
202888,1,999,19,184,203
202888,2,1,19,184,203
202903,1,999,166,181,347
202903,2,1,166,181,347
202912,1,999,35,346,381
202912,2,1,35,346,381
202949,1,999,499,256,755
202949,2,1,499,256,755
202985,1,999,19,78,97
202985,2,1,19,78,97
203030,1,999,25,161,186
203030,2,1,25,161,186
203049,1,999,30,65,95
203049,4,3,30,65,95
203067,1,999,55,104,159
203067,4,3,55,104,159
203076,1,999,71,56,127
203076,4,3,71,56,127
203085,1,999,812,976,1788
203085,2,1,713,715,1428
203085,4,3,99,261,360
203128,1,999,650,858,1508
203128,2,1,644,827,1471
203128,4,3,6,31,37
203146,1,999,475,13,488
203146,2,1,475,13,488
203155,1,999,5001,4490,9491
203155,2,1,5001,4490,9491
203164,1,999,71,364,435
203164,2,1,71,364,435
203225,1,999,379,220,599
203225,2,1,379,220,599
203234,1,999,20,277,297
203234,2,1,20,277,297
203289,1,999,161,32,193
203289,2,1,161,32,193
203313,1,999,772,240,1012
203313,2,1,772,240,1012
203331,1,999,1254,1762,3016
203331,2,1,1254,1762,3016
203368,1,999,1878,2378,4256
203368,2,1,1513,1577,3090
203368,4,3,365,801,1166
203386,1,999,219,1057,1276
203386,2,1,219,1057,1276
203438,1,999,6,141,147
203438,2,1,6,141,147
203447,1,999,1262,2061,3323
203447,2,1,1250,2056,3306
203447,4,3,12,5,17
203456,1,999,544,1336,1880
203456,2,1,544,1336,1880
203465,1,999,2439,3913,6352
203465,2,1,2390,3808,6198
203465,4,3,49,105,154
203474,1,999,1553,2494,4047
203474,2,1,1548,2491,4039
203474,4,3,5,3,8
203483,1,999,1253,1869,3122
203483,2,1,1253,1869,3122
203492,1,999,717,1605,2322
203492,2,1,717,1605,2322
203517,1,999,11918,18533,30451
203517,2,1,9681,13402,23083
203517,4,3,2237,5131,7368
203526,1,999,1201,2274,3475
203526,2,1,1179,2259,3438
203526,4,3,22,15,37
203535,1,999,819,926,1745
203535,2,1,819,926,1745
203544,1,999,231,820,1051
203544,2,1,190,736,926
203544,4,3,41,84,125
203580,1,999,575,694,1269
203580,2,1,443,508,951
203580,4,3,132,186,318
203599,1,999,5515,7999,13514
203599,2,1,5515,7999,13514
203614,1,999,244,344,588
203614,2,1,244,344,588
203678,1,999,1758,3797,5555
203678,2,1,1758,3797,5555
203720,1,999,124,670,794
203720,2,1,124,670,794
203739,1,999,149,519,668
203739,2,1,149,519,668
203748,1,999,6564,11167,17731
203748,2,1,6564,11167,17731
203757,1,999,563,2167,2730
203757,2,1,505,1879,2384
203757,4,3,58,288,346
203775,1,999,1314,2399,3713
203775,2,1,1037,1498,2535
203775,4,3,277,901,1178
203818,1,999,73,329,402
203818,2,1,73,329,402
203845,1,999,846,931,1777
203845,2,1,800,791,1591
203845,4,3,46,140,186
203881,1,999,1656,2125,3781
203881,2,1,1656,2125,3781
203942,1,999,90,148,238
203942,2,1,90,148,238
203960,1,999,181,1032,1213
203960,2,1,181,1032,1213
203997,1,999,118,160,278
203997,4,3,118,160,278
204006,1,999,1964,2525,4489
204006,2,1,1964,2525,4489
204015,1,999,1160,1724,2884
204015,2,1,1160,1724,2884
204024,1,999,8474,11490,19964
204024,2,1,7290,8271,15561
204024,4,3,1184,3219,4403
204060,1,999,224,1259,1483
204060,2,1,224,1259,1483
204121,1,999,2,86,88
204121,2,1,2,86,88
204158,1,999,247,416,663
204158,2,1,247,416,663
204176,1,999,94,839,933
204176,2,1,89,761,850
204176,4,3,5,78,83
204185,1,999,1125,1165,2290
204185,2,1,1114,1130,2244
204185,4,3,11,35,46
204194,1,999,1314,2207,3521
204194,2,1,996,1495,2491
204194,4,3,318,712,1030
204200,1,999,964,1879,2843
204200,2,1,835,1414,2249
204200,4,3,129,465,594
204255,1,999,1594,2212,3806
204255,2,1,1594,2212,3806
204264,1,999,1113,1901,3014
204264,2,1,844,967,1811
204264,4,3,269,934,1203
204307,1,999,292,825,1117
204307,2,1,292,825,1117
204316,1,999,539,1859,2398
204316,2,1,539,1859,2398
204334,1,999,13,176,189
204334,2,1,13,176,189
204422,1,999,1839,3192,5031
204422,2,1,1839,3192,5031
204431,1,999,5,34,39
204431,2,1,5,34,39
204440,1,999,3527,3244,6771
204440,2,1,3527,3244,6771
204459,1,999,102,243,345
204459,2,1,102,243,345
204468,1,999,916,1463,2379
204468,2,1,814,1179,1993
204468,4,3,102,284,386
204477,1,999,384,380,764
204477,4,3,384,380,764
204486,1,999,3951,1099,5050
204486,2,1,3932,1062,4994
204486,4,3,19,37,56
204501,1,999,1362,1689,3051
204501,2,1,1348,1669,3017
204501,4,3,14,20,34
204547,1,999,280,175,455
204547,4,3,280,175,455
204592,1,999,40,220,260
204592,2,1,40,220,260
204608,1,999,1188,47,1235
204608,2,1,1188,47,1235
204617,1,999,1389,2287,3676
204617,2,1,1022,1580,2602
204617,4,3,367,707,1074
204626,1,999,455,849,1304
204626,2,1,455,849,1304
204635,1,999,1954,1818,3772
204635,2,1,1499,1287,2786
204635,4,3,455,531,986
204662,1,999,471,330,801
204662,2,1,471,330,801
204671,1,999,807,1080,1887
204671,2,1,761,915,1676
204671,4,3,46,165,211
204680,1,999,795,1249,2044
204680,2,1,785,1153,1938
204680,4,3,10,96,106
204699,1,999,954,1203,2157
204699,2,1,931,1120,2051
204699,4,3,23,83,106
204705,1,999,1439,1549,2988
204705,2,1,1424,1426,2850
204705,4,3,15,123,138
204714,1,999,12,258,270
204714,2,1,12,258,270
204723,1,999,173,24,197
204723,2,1,173,24,197
204741,1,999,44,47,91
204741,2,1,44,47,91
204769,1,999,23,97,120
204769,2,1,23,97,120
204778,1,999,4,43,47
204778,2,1,4,43,47
204796,1,999,32229,30955,63184
204796,2,1,24722,21534,46256
204796,4,3,7507,9421,16928
204802,1,999,438,759,1197
204802,2,1,438,759,1197
204820,1,999,1133,2165,3298
204820,2,1,1133,2165,3298
204839,1,999,934,1933,2867
204839,2,1,934,1933,2867
204848,1,999,1288,1948,3236
204848,2,1,1288,1948,3236
204857,1,999,12410,14830,27240
204857,2,1,10121,11642,21763
204857,4,3,2289,3188,5477
204866,1,999,784,1848,2632
204866,2,1,784,1848,2632
204884,1,999,56,286,342
204884,2,1,56,286,342
204893,1,999,18,148,166
204893,2,1,18,148,166
204909,1,999,881,1026,1907
204909,2,1,881,1026,1907
204936,1,999,1173,2278,3451
204936,2,1,1049,1812,2861
204936,4,3,124,466,590
204945,1,999,16257,13554,29811
204945,2,1,16257,13554,29811
204963,1,999,9,129,138
204963,2,1,9,129,138
204981,1,999,18,130,148
204981,2,1,18,130,148
204990,1,999,91,87,178
204990,4,3,91,87,178
205027,1,999,138,2,140
205027,2,1,80,0,80
205027,4,3,58,2,60
205054,1,999,91,481,572
205054,2,1,91,481,572
205090,1,999,10,81,91
205090,2,1,10,81,91
205124,1,999,63,0,63
205124,2,1,42,0,42
205124,4,3,21,0,21
205142,1,999,25,197,222
205142,2,1,25,197,222
205179,1,999,1065,2712,3777
205179,2,1,1065,2712,3777
205203,1,999,1165,1800,2965
205203,2,1,1103,1676,2779
205203,4,3,62,124,186
205391,1,999,51,76,127
205391,2,1,51,76,127
205443,1,999,2159,3028,5187
205443,2,1,2150,2957,5107
205443,4,3,9,71,80
205470,1,999,16543,19856,36399
205470,2,1,16543,19856,36399
205513,1,999,61,211,272
205513,2,1,61,211,272
205522,1,999,96,248,344
205522,2,1,96,248,344
205531,1,999,57,196,253
205531,2,1,57,196,253
205559,1,999,37,172,209
205559,2,1,37,172,209
205568,1,999,97,393,490
205568,2,1,97,393,490
205610,1,999,1047,2723,3770
205610,2,1,1047,2723,3770
205647,1,999,482,2099,2581
205647,2,1,482,2099,2581
205692,1,999,142,608,750
205692,2,1,142,608,750
205708,1,999,435,2168,2603
205708,2,1,435,2168,2603
205717,1,999,414,1564,1978
205717,2,1,414,1564,1978
205726,1,999,541,1731,2272
205726,2,1,541,1731,2272
205841,1,999,7558,9023,16581
205841,2,1,7558,9023,16581
205887,1,999,230,1269,1499
205887,2,1,230,1269,1499
205957,1,999,1412,2037,3449
205957,2,1,938,1449,2387
205957,4,3,474,588,1062
205966,1,999,1523,3414,4937
205966,2,1,1523,3414,4937
206002,1,999,50,14,64
206002,2,1,50,14,64
206011,1,999,1981,2268,4249
206011,2,1,1981,2268,4249
206039,1,999,2,114,116
206039,2,1,2,114,116
206048,1,999,1990,2539,4529
206048,2,1,1405,1749,3154
206048,4,3,585,790,1375
206084,1,999,13105,13877,26982
206084,2,1,10497,10349,20846
206084,4,3,2608,3528,6136
206093,1,999,684,575,1259
206093,2,1,684,575,1259
206154,1,999,59,21,80
206154,2,1,59,21,80
206172,1,999,40,256,296
206172,2,1,40,256,296
206181,1,999,68,182,250
206181,2,1,68,182,250
206215,1,999,103,81,184
206215,4,3,103,81,184
206224,1,999,115,515,630
206224,2,1,115,515,630
206279,1,999,968,1461,2429
206279,2,1,694,871,1565
206279,4,3,274,590,864
206288,1,999,208,151,359
206288,4,3,208,151,359
206321,1,999,366,331,697
206321,2,1,366,331,697
206330,1,999,997,1153,2150
206330,2,1,860,986,1846
206330,4,3,137,167,304
206349,1,999,235,1631,1866
206349,2,1,136,1105,1241
206349,4,3,99,526,625
206358,1,999,3,49,52
206358,2,1,3,49,52
206394,1,999,82,240,322
206394,2,1,82,240,322
206419,1,999,3,132,135
206419,2,1,3,132,135
206428,1,999,3,36,39
206428,2,1,3,36,39
206437,1,999,1208,2109,3317
206437,2,1,943,1593,2536
206437,4,3,265,516,781
206446,1,999,1121,1885,3006
206446,2,1,1121,1885,3006
206482,1,999,21,356,377
206482,2,1,21,356,377
206491,1,999,335,501,836
206491,2,1,334,493,827
206491,4,3,1,8,9
206507,1,999,861,1072,1933
206507,2,1,845,976,1821
206507,4,3,16,96,112
206516,1,999,80,31,111
206516,4,3,80,31,111
206525,1,999,892,1233,2125
206525,2,1,885,1163,2048
206525,4,3,7,70,77
206589,1,999,868,1009,1877
206589,2,1,868,1009,1877
206604,1,999,8865,10799,19664
206604,2,1,6783,8029,14812
206604,4,3,2082,2770,4852
206613,1,999,568,893,1461
206613,2,1,508,758,1266
206613,4,3,60,135,195
206622,1,999,3853,4976,8829
206622,2,1,2259,2757,5016
206622,4,3,1594,2219,3813
206631,1,999,964,515,1479
206631,2,1,964,515,1479
206695,1,999,8161,9664,17825
206695,2,1,7470,8371,15841
206695,4,3,691,1293,1984
206783,1,999,40,13,53
206783,2,1,40,13,53
206817,1,999,624,621,1245
206817,2,1,624,621,1245
206835,1,999,700,1026,1726
206835,2,1,633,972,1605
206835,4,3,67,54,121
206862,1,999,1166,1414,2580
206862,2,1,935,1020,1955
206862,4,3,231,394,625
206880,1,999,3,137,140
206880,2,1,3,137,140
206905,1,999,131,138,269
206905,2,1,131,138,269
206914,1,999,3351,4721,8072
206914,2,1,3131,4314,7445
206914,4,3,220,407,627
206923,1,999,1156,2289,3445
206923,2,1,1156,2289,3445
206932,1,999,7,176,183
206932,2,1,7,176,183
206941,1,999,8045,11432,19477
206941,2,1,7405,9840,17245
206941,4,3,640,1592,2232
206969,1,999,0,22,22
206969,2,1,0,22,22
206996,1,999,1043,2209,3252
206996,2,1,1043,2209,3252
207041,1,999,2306,3583,5889
207041,2,1,1870,2606,4476
207041,4,3,436,977,1413
207050,1,999,987,1911,2898
207050,2,1,987,1911,2898
207069,1,999,1311,2163,3474
207069,2,1,1311,2163,3474
207087,1,999,4,99,103
207087,2,1,4,99,103
207102,1,999,13,99,112
207102,2,1,13,99,112
207157,1,999,162,105,267
207157,2,1,153,103,256
207157,4,3,9,2,11
207166,1,999,0,19,19
207166,2,1,0,19,19
207209,1,999,1428,2105,3533
207209,2,1,1192,1631,2823
207209,4,3,236,474,710
207236,1,999,1149,2434,3583
207236,2,1,1149,2434,3583
207254,1,999,1208,90,1298
207254,2,1,1208,90,1298
207263,1,999,4333,6927,11260
207263,2,1,3880,5869,9749
207263,4,3,453,1058,1511
207272,1,999,4,27,31
207272,2,1,4,27,31
207281,1,999,3109,4292,7401
207281,2,1,3109,4292,7401
207290,1,999,1431,1702,3133
207290,2,1,1431,1702,3133
207306,1,999,1155,1601,2756
207306,2,1,1056,1356,2412
207306,4,3,99,245,344
207315,1,999,207,229,436
207315,4,3,207,229,436
207324,1,999,1316,1173,2489
207324,2,1,1067,1021,2088
207324,4,3,249,152,401
207342,1,999,1444,3200,4644
207342,2,1,244,1293,1537
207342,4,3,1200,1907,3107
207351,1,999,783,792,1575
207351,2,1,783,792,1575
207388,1,999,13520,12798,26318
207388,2,1,10226,9877,20103
207388,4,3,3294,2921,6215
207397,1,999,4701,6254,10955
207397,2,1,4701,6254,10955
207403,1,999,858,1128,1986
207403,2,1,844,1061,1905
207403,4,3,14,67,81
207449,1,999,9458,12234,21692
207449,2,1,9458,12234,21692
207458,1,999,1983,2424,4407
207458,2,1,993,1597,2590
207458,4,3,990,827,1817
207500,1,999,15148,15042,30190
207500,2,1,10917,10894,21811
207500,4,3,4231,4148,8379
207537,1,999,6,36,42
207537,2,1,6,36,42
207564,1,999,3467,2129,5596
207564,2,1,3467,2129,5596
207582,1,999,1434,1976,3410
207582,2,1,1122,1643,2765
207582,4,3,312,333,645
207607,1,999,307,392,699
207607,2,1,307,392,699
207625,1,999,49,485,534
207625,2,1,49,485,534
207661,1,999,2078,3419,5497
207661,2,1,2078,3419,5497
207670,1,999,5570,7626,13196
207670,2,1,5570,7626,13196
207689,1,999,366,555,921
207689,2,1,328,516,844
207689,4,3,38,39,77
207704,1,999,18,218,236
207704,2,1,18,218,236
207722,1,999,468,839,1307
207722,2,1,468,839,1307
207740,1,999,1056,2206,3262
207740,2,1,1056,2206,3262
207786,1,999,0,32,32
207786,2,1,0,32,32
207847,1,999,2394,2894,5288
207847,2,1,2104,2617,4721
207847,4,3,290,277,567
207856,1,999,192,143,335
207856,2,1,127,116,243
207856,4,3,65,27,92
207865,1,999,2577,3469,6046
207865,2,1,2120,2883,5003
207865,4,3,457,586,1043
207935,1,999,12342,18229,30571
207935,2,1,12342,18229,30571
207962,1,999,1800,62,1862
207962,2,1,1800,62,1862
207971,1,999,2500,2127,4627
207971,2,1,1777,1525,3302
207971,4,3,723,602,1325
208017,1,999,8,51,59
208017,2,1,8,51,59
208026,1,999,167,113,280
208026,2,1,167,113,280
208035,1,999,3057,2209,5266
208035,2,1,3057,2209,5266
208044,1,999,0,18,18
208044,2,1,0,18,18
208053,1,999,159,163,322
208053,2,1,159,163,322
208080,1,999,23,83,106
208080,2,1,23,83,106
208123,1,999,44,144,188
208123,2,1,44,144,188
208239,1,999,1203,1283,2486
208239,2,1,1203,1283,2486
208248,1,999,76,219,295
208248,2,1,76,219,295
208275,1,999,1692,2633,4325
208275,2,1,1692,2633,4325
208318,1,999,4733,5530,10263
208318,2,1,4733,5530,10263
208390,1,999,9808,12493,22301
208390,2,1,9808,12493,22301
208406,1,999,8631,8626,17257
208406,2,1,8631,8626,17257
208415,1,999,2490,524,3014
208415,2,1,2490,524,3014
208433,1,999,1,104,105
208433,2,1,1,104,105
208479,1,999,180,852,1032
208479,2,1,180,852,1032
208488,1,999,870,1602,2472
208488,2,1,489,822,1311
208488,4,3,381,780,1161
208512,1,999,94,233,327
208512,2,1,94,233,327
208637,1,999,115,362,477
208637,2,1,115,362,477
208646,1,999,2106,3564,5670
208646,2,1,1833,2872,4705
208646,4,3,273,692,965
208655,1,999,28,251,279
208655,2,1,28,251,279
208725,1,999,53,55,108
208725,2,1,53,55,108
208822,1,999,1692,2411,4103
208822,2,1,867,1264,2131
208822,4,3,825,1147,1972
208859,1,999,4,96,100
208859,2,1,4,96,100
208965,1,999,1320,328,1648
208965,2,1,1320,328,1648
209038,1,999,8908,9294,18202
209038,2,1,8908,9294,18202
209056,1,999,1650,2612,4262
209056,2,1,845,1246,2091
209056,4,3,805,1366,2171
209065,1,999,748,986,1734
209065,2,1,748,986,1734
209074,1,999,6143,7072,13215
209074,2,1,6143,7072,13215
209083,1,999,10,101,111
209083,2,1,10,101,111
209108,1,999,958,1679,2637
209108,2,1,390,941,1331
209108,4,3,568,738,1306
209153,1,999,7,118,125
209153,2,1,7,118,125
209205,1,999,27,197,224
209205,2,1,27,197,224
209241,1,999,177,8,185
209241,2,1,94,0,94
209241,4,3,83,8,91
209250,1,999,7802,8607,16409
209250,2,1,7802,8607,16409
209287,1,999,645,416,1061
209287,2,1,414,269,683
209287,4,3,231,147,378
209296,1,999,122,439,561
209296,4,3,122,439,561
209348,1,999,1,54,55
209348,2,1,1,54,55
209409,1,999,260,413,673
209409,2,1,199,304,503
209409,4,3,61,109,170
209490,1,999,1127,1851,2978
209490,2,1,142,697,839
209490,4,3,985,1154,2139
209506,1,999,2676,2566,5242
209506,2,1,2642,2560,5202
209506,4,3,34,6,40
209533,1,999,47,112,159
209533,2,1,43,99,142
209533,4,3,4,13,17
209542,1,999,13435,12816,26251
209542,2,1,10928,9991,20919
209542,4,3,2507,2825,5332
209551,1,999,12723,13548,26271
209551,2,1,10477,10512,20989
209551,4,3,2246,3036,5282
209603,1,999,238,414,652
209603,2,1,216,390,606
209603,4,3,22,24,46
209612,1,999,1224,2571,3795
209612,2,1,548,1013,1561
209612,4,3,676,1558,2234
209667,1,999,8,90,98
209667,2,1,8,90,98
209676,1,999,21,265,286
209676,2,1,21,265,286
209694,1,999,23,97,120
209694,2,1,23,97,120
209700,1,999,8,112,120
209700,2,1,8,112,120
209719,1,999,8,72,80
209719,2,1,8,72,80
209746,1,999,23828,27073,50901
209746,2,1,23828,27073,50901
209807,1,999,17556,24019,41575
209807,2,1,13490,15578,29068
209807,4,3,4066,8441,12507
209825,1,999,1611,2653,4264
209825,2,1,1306,2092,3398
209825,4,3,305,561,866
209922,1,999,688,853,1541
209922,2,1,672,832,1504
209922,4,3,16,21,37
209940,1,999,5043,6142,11185
209940,2,1,5043,6142,11185
209986,1,999,3,51,54
209986,2,1,3,51,54
210076,1,999,896,2229,3125
210076,2,1,896,2229,3125
210100,1,999,8,150,158
210100,2,1,8,150,158
210146,1,999,3236,4682,7918
210146,2,1,2617,3580,6197
210146,4,3,619,1102,1721
210155,1,999,1080,1472,2552
210155,2,1,1080,1472,2552
210234,1,999,2028,2599,4627
210234,2,1,2028,2599,4627
210270,1,999,1996,2732,4728
210270,2,1,1996,2732,4728
210304,1,999,681,1236,1917
210304,2,1,593,1063,1656
210304,4,3,88,173,261
210331,1,999,499,802,1301
210331,2,1,407,616,1023
210331,4,3,92,186,278
210340,1,999,6,129,135
210340,2,1,6,129,135
210359,1,999,494,938,1432
210359,2,1,494,938,1432
210368,1,999,560,304,864
210368,4,3,560,304,864
210401,1,999,1444,1694,3138
210401,2,1,919,1220,2139
210401,4,3,525,474,999
210429,1,999,2946,4732,7678
210429,2,1,2381,3121,5502
210429,4,3,565,1611,2176
210438,1,999,373,205,578
210438,2,1,16,44,60
210438,4,3,357,161,518
210456,1,999,55,257,312
210456,2,1,55,257,312
210474,1,999,0,44,44
210474,2,1,0,44,44
210483,1,999,128,377,505
210483,2,1,128,377,505
210492,1,999,111,105,216
210492,2,1,95,97,192
210492,4,3,16,8,24
210508,1,999,17,10,27
210508,4,3,17,10,27
210571,1,999,1092,1611,2703
210571,2,1,1067,1514,2581
210571,4,3,25,97,122
210599,1,999,862,405,1267
210599,2,1,862,405,1267
210605,1,999,13769,18255,32024
210605,2,1,13769,18255,32024
210669,1,999,986,1215,2201
210669,2,1,986,1215,2201
210711,1,999,30,210,240
210711,2,1,30,210,240
210739,1,999,1547,2419,3966
210739,2,1,1091,1612,2703
210739,4,3,456,807,1263
210748,1,999,7,88,95
210748,2,1,7,88,95
210775,1,999,1315,2761,4076
210775,2,1,984,2009,2993
210775,4,3,331,752,1083
210784,1,999,20,346,366
210784,2,1,20,346,366
210809,1,999,488,141,629
210809,4,3,488,141,629
210890,1,999,68,166,234
210890,2,1,68,166,234
210906,1,999,408,586,994
210906,2,1,408,586,994
210942,1,999,2079,2646,4725
210942,2,1,2079,2646,4725
210951,1,999,9,153,162
210951,2,1,9,153,162
210960,1,999,1834,1706,3540
210960,2,1,1834,1706,3540
211006,1,999,453,15,468
211006,2,1,453,15,468
211024,1,999,592,491,1083
211024,2,1,277,400,677
211024,4,3,315,91,406
211079,1,999,2351,3302,5653
211079,2,1,2351,3302,5653
211088,1,999,1275,3759,5034
211088,2,1,650,1713,2363
211088,4,3,625,2046,2671
211130,1,999,233,76,309
211130,4,3,233,76,309
211149,1,999,114,201,315
211149,2,1,114,201,315
211158,1,999,4617,6602,11219
211158,2,1,4138,5619,9757
211158,4,3,479,983,1462
211200,1,999,165,461,626
211200,2,1,165,461,626
211273,1,999,90,1768,1858
211273,2,1,0,1392,1392
211273,4,3,90,376,466
211291,1,999,1848,2001,3849
211291,2,1,1780,1892,3672
211291,4,3,68,109,177
211307,1,999,7193,9616,16809
211307,2,1,7193,9616,16809
211316,1,999,1,103,104
211316,2,1,1,103,104
211334,1,999,3,100,103
211334,2,1,3,100,103
211343,1,999,2436,3877,6313
211343,2,1,2436,3877,6313
211352,1,999,1296,3279,4575
211352,2,1,617,1082,1699
211352,4,3,679,2197,2876
211361,1,999,5957,6783,12740
211361,2,1,4737,5134,9871
211361,4,3,1220,1649,2869
211370,1,999,131,11,142
211370,4,3,131,11,142
211398,1,999,83,220,303
211398,2,1,83,220,303
211431,1,999,363,2840,3203
211431,2,1,239,1828,2067
211431,4,3,124,1012,1136
211440,1,999,7501,4219,11720
211440,2,1,3678,2547,6225
211440,4,3,3823,1672,5495
211468,1,999,152,2098,2250
211468,2,1,130,1872,2002
211468,4,3,22,226,248
211477,1,999,598,1096,1694
211477,2,1,598,1096,1694
211556,1,999,410,2317,2727
211556,2,1,118,1223,1341
211556,4,3,292,1094,1386
211583,1,999,755,2091,2846
211583,2,1,532,1244,1776
211583,4,3,223,847,1070
211608,1,999,822,986,1808
211608,2,1,775,885,1660
211608,4,3,47,101,148
211617,1,999,780,1003,1783
211617,2,1,780,1003,1783
211635,1,999,20,182,202
211635,2,1,20,182,202
211644,1,999,3138,5551,8689
211644,2,1,2797,4335,7132
211644,4,3,341,1216,1557
211750,1,999,98,367,465
211750,2,1,98,367,465
211802,1,999,35,159,194
211802,2,1,35,159,194
211820,1,999,23,220,243
211820,2,1,23,220,243
211893,1,999,80,79,159
211893,2,1,64,63,127
211893,4,3,16,16,32
211909,1,999,152,3,155
211909,2,1,152,3,155
211927,1,999,7883,10610,18493
211927,2,1,7883,10610,18493
211954,1,999,12,166,178
211954,2,1,12,166,178
211981,1,999,1196,1512,2708
211981,2,1,1036,1305,2341
211981,4,3,160,207,367
212009,1,999,1079,1368,2447
212009,2,1,1079,1368,2447
212018,1,999,168,182,350
212018,4,3,168,182,350
212045,1,999,187,300,487
212045,2,1,187,300,487
212054,1,999,12574,13745,26319
212054,2,1,8097,6986,15083
212054,4,3,4477,6759,11236
212072,1,999,254,80,334
212072,2,1,254,80,334
212090,1,999,357,1260,1617
212090,2,1,357,1260,1617
212106,1,999,4977,6902,11879
212106,2,1,2744,3511,6255
212106,4,3,2233,3391,5624
212115,1,999,3819,5258,9077
212115,2,1,3238,3880,7118
212115,4,3,581,1378,1959
212133,1,999,1711,3384,5095
212133,2,1,949,2146,3095
212133,4,3,762,1238,2000
212160,1,999,3820,5827,9647
212160,2,1,3175,4063,7238
212160,4,3,645,1764,2409
212197,1,999,934,1638,2572
212197,2,1,925,1568,2493
212197,4,3,9,70,79
212212,1,999,3,45,48
212212,2,1,3,45,48
212230,1,999,9,87,96
212230,2,1,9,87,96
212267,1,999,26,313,339
212267,2,1,26,313,339
212276,1,999,30,236,266
212276,2,1,30,236,266
212285,1,999,6,116,122
212285,2,1,6,116,122
212294,1,999,10,116,126
212294,2,1,10,116,126
212300,1,999,4,95,99
212300,2,1,4,95,99
212328,1,999,27,314,341
212328,2,1,27,314,341
212337,1,999,19,268,287
212337,2,1,19,268,287
212355,1,999,23,351,374
212355,2,1,23,351,374
212373,1,999,17,163,180
212373,2,1,17,163,180
212382,1,999,25,328,353
212382,2,1,25,328,353
212391,1,999,14,241,255
212391,2,1,14,241,255
212425,1,999,205,419,624
212425,2,1,205,419,624
212434,1,999,455,66,521
212434,2,1,455,66,521
212443,1,999,107,67,174
212443,4,3,107,67,174
212568,1,999,61,203,264
212568,2,1,61,203,264
212577,1,999,1140,1269,2409
212577,2,1,1140,1269,2409
212601,1,999,2050,2936,4986
212601,2,1,1334,1849,3183
212601,4,3,716,1087,1803
212656,1,999,1116,1383,2499
212656,2,1,968,1143,2111
212656,4,3,148,240,388
212674,1,999,1291,1425,2716
212674,2,1,1291,1425,2716
212683,1,999,14,224,238
212683,2,1,14,224,238
212708,1,999,40,169,209
212708,2,1,40,169,209
212753,1,999,33,390,423
212753,2,1,33,390,423
212771,1,999,239,784,1023
212771,2,1,9,59,68
212771,4,3,230,725,955
212805,1,999,1293,1267,2560
212805,2,1,1293,1267,2560
212832,1,999,848,2341,3189
212832,2,1,672,1847,2519
212832,4,3,176,494,670
212869,1,999,223,1185,1408
212869,2,1,223,1185,1408
212878,1,999,12064,20103,32167
212878,2,1,12064,20103,32167
212911,1,999,557,697,1254
212911,2,1,557,697,1254
212975,1,999,320,155,475
212975,2,1,320,155,475
212984,1,999,955,2740,3695
212984,2,1,694,1864,2558
212984,4,3,261,876,1137
212993,1,999,100,39,139
212993,2,1,100,39,139
213002,1,999,726,952,1678
213002,2,1,726,952,1678
213011,1,999,1369,4587,5956
213011,2,1,838,2896,3734
213011,4,3,531,1691,2222
213020,1,999,7344,9345,16689
213020,2,1,6064,7492,13556
213020,4,3,1280,1853,3133
213057,1,999,293,595,888
213057,2,1,293,595,888
213163,1,999,5,68,73
213163,2,1,5,68,73
213181,1,999,94,833,927
213181,2,1,94,833,927
213215,1,999,12,126,138
213215,2,1,12,126,138
213233,1,999,337,90,427
213233,2,1,337,90,427
213251,1,999,692,903,1595
213251,2,1,692,903,1595
213303,1,999,875,1358,2233
213303,2,1,859,1304,2163
213303,4,3,16,54,70
213312,1,999,222,507,729
213312,2,1,222,507,729
213321,1,999,1418,1809,3227
213321,2,1,1256,1298,2554
213321,4,3,162,511,673
213330,1,999,3,38,41
213330,2,1,3,38,41
213349,1,999,4801,7106,11907
213349,2,1,4393,6042,10435
213349,4,3,408,1064,1472
213358,1,999,554,1028,1582
213358,2,1,522,908,1430
213358,4,3,32,120,152
213367,1,999,2682,5072,7754
213367,2,1,1732,3219,4951
213367,4,3,950,1853,2803
213376,1,999,1036,1130,2166
213376,2,1,1036,1130,2166
213385,1,999,1310,1158,2468
213385,2,1,1310,1158,2468
213400,1,999,628,580,1208
213400,2,1,489,445,934
213400,4,3,139,135,274
213446,1,999,57,99,156
213446,4,3,57,99,156
213455,1,999,20,218,238
213455,2,1,20,218,238
213473,1,999,165,595,760
213473,2,1,165,595,760
213491,1,999,5,112,117
213491,2,1,5,112,117
213507,1,999,1012,1324,2336
213507,2,1,809,1048,1857
213507,4,3,203,276,479
213525,1,999,4656,7497,12153
213525,2,1,4656,7497,12153
213534,1,999,563,921,1484
213534,2,1,563,921,1484
213543,1,999,4264,3253,7517
213543,2,1,2838,1967,4805
213543,4,3,1426,1286,2712
213552,1,999,14,89,103
213552,2,1,14,89,103
213570,1,999,416,1074,1490
213570,2,1,416,1074,1490
213589,1,999,1048,55,1103
213589,2,1,1048,55,1103
213598,1,999,1119,1667,2786
213598,2,1,873,1231,2104
213598,4,3,246,436,682
213613,1,999,2606,3594,6200
213613,2,1,2466,3240,5706
213613,4,3,140,354,494
213622,1,999,42,255,297
213622,2,1,42,255,297
213631,1,999,93,103,196
213631,4,3,93,103,196
213640,1,999,182,155,337
213640,4,3,182,155,337
213659,1,999,4295,6120,10415
213659,2,1,4295,6120,10415
213668,1,999,680,738,1418
213668,2,1,680,738,1418
213686,1,999,31,110,141
213686,2,1,31,110,141
213774,1,999,208,844,1052
213774,2,1,208,844,1052
213783,1,999,1518,2651,4169
213783,2,1,1398,2051,3449
213783,4,3,120,600,720
213826,1,999,1086,2870,3956
213826,2,1,743,1649,2392
213826,4,3,343,1221,1564
213914,1,999,34,399,433
213914,2,1,34,399,433
213932,1,999,16,119,135
213932,2,1,16,119,135
213987,1,999,2054,2914,4968
213987,2,1,1783,2573,4356
213987,4,3,271,341,612
213996,1,999,1087,1830,2917
213996,2,1,1054,1786,2840
213996,4,3,33,44,77
214023,1,999,139,120,259
214023,2,1,139,120,259
214041,1,999,4443,6628,11071
214041,2,1,3786,4770,8556
214041,4,3,657,1858,2515
214069,1,999,935,2294,3229
214069,2,1,785,1889,2674
214069,4,3,150,405,555
214111,1,999,7522,9308,16830
214111,2,1,7522,9308,16830
214148,1,999,2,602,604
214148,2,1,0,547,547
214148,4,3,2,55,57
214157,1,999,879,1439,2318
214157,2,1,785,1189,1974
214157,4,3,94,250,344
214166,1,999,703,1717,2420
214166,2,1,690,1699,2389
214166,4,3,13,18,31
214175,1,999,1154,1584,2738
214175,2,1,1154,1584,2738
214254,1,999,610,1340,1950
214254,2,1,610,1340,1950
214272,1,999,1221,2381,3602
214272,2,1,967,1827,2794
214272,4,3,254,554,808
214290,1,999,1292,33,1325
214290,2,1,1292,33,1325
214315,1,999,28,100,128
214315,2,1,28,100,128
214379,1,999,6508,9806,16314
214379,2,1,6508,9806,16314
214476,1,999,2,85,87
214476,2,1,2,85,87
214528,1,999,977,245,1222
214528,2,1,977,245,1222
214546,1,999,10,106,116
214546,2,1,10,106,116
214564,1,999,395,975,1370
214564,4,3,395,975,1370
214582,1,999,390,1531,1921
214582,2,1,390,1531,1921
214591,1,999,2992,1729,4721
214591,2,1,2886,1687,4573
214591,4,3,106,42,148
214607,1,999,791,641,1432
214607,4,3,791,641,1432
214616,1,999,419,436,855
214616,4,3,419,436,855
214625,1,999,546,480,1026
214625,2,1,545,472,1017
214625,4,3,1,8,9
214634,1,999,338,680,1018
214634,2,1,338,680,1018
214643,1,999,573,315,888
214643,2,1,527,227,754
214643,4,3,46,88,134
214652,1,999,815,880,1695
214652,2,1,815,875,1690
214652,4,3,0,5,5
214670,1,999,536,452,988
214670,2,1,532,425,957
214670,4,3,4,27,31
214689,1,999,2325,2137,4462
214689,2,1,2310,2105,4415
214689,4,3,15,32,47
214698,1,999,565,523,1088
214698,2,1,562,515,1077
214698,4,3,3,8,11
214704,1,999,1714,1421,3135
214704,2,1,1691,1270,2961
214704,4,3,23,151,174
214713,1,999,2427,2576,5003
214713,2,1,1752,1451,3203
214713,4,3,675,1125,1800
214731,1,999,1043,790,1833
214731,2,1,1043,789,1832
214731,4,3,0,1,1
214740,1,999,576,575,1151
214740,2,1,574,573,1147
214740,4,3,2,2,4
214759,1,999,566,719,1285
214759,2,1,566,719,1285
214768,1,999,733,588,1321
214768,2,1,733,588,1321
214777,1,999,26862,22298,49160
214777,2,1,22758,18664,41422
214777,4,3,4104,3634,7738
214786,1,999,469,386,855
214786,2,1,469,386,855
214795,1,999,586,793,1379
214795,2,1,585,784,1369
214795,4,3,1,9,10
214801,1,999,2093,2074,4167
214801,2,1,2078,1996,4074
214801,4,3,15,78,93
214810,1,999,505,612,1117
214810,2,1,505,608,1113
214810,4,3,0,4,4
214829,1,999,944,989,1933
214829,2,1,908,780,1688
214829,4,3,36,209,245
214838,1,999,120,256,376
214838,2,1,120,256,376
214883,1,999,760,1875,2635
214883,2,1,760,1875,2635
214892,1,999,253,375,628
214892,2,1,253,375,628
214944,1,999,976,146,1122
214944,2,1,976,146,1122
214962,1,999,4,80,84
214962,2,1,4,80,84
214971,1,999,139,206,345
214971,2,1,103,153,256
214971,4,3,36,53,89
215008,1,999,87,0,87
215008,2,1,87,0,87
215026,1,999,13,1,14
215026,2,1,13,1,14
215044,1,999,73,232,305
215044,2,1,73,232,305
215053,1,999,107,212,319
215053,2,1,107,212,319
215062,1,999,12949,14800,27749
215062,2,1,6321,6818,13139
215062,4,3,6628,7982,14610
215099,1,999,1294,2559,3853
215099,2,1,1015,2049,3064
215099,4,3,279,510,789
215105,1,999,1057,1462,2519
215105,2,1,974,1290,2264
215105,4,3,83,172,255
215114,1,999,705,842,1547
215114,2,1,518,583,1101
215114,4,3,187,259,446
215123,1,999,908,1456,2364
215123,4,3,908,1456,2364
215132,1,999,1225,1890,3115
215132,2,1,572,996,1568
215132,4,3,653,894,1547
215239,1,999,9900,18883,28783
215239,2,1,9900,18883,28783
215266,1,999,875,1094,1969
215266,2,1,875,1094,1969
215275,1,999,992,960,1952
215275,2,1,992,960,1952
215284,1,999,1730,1465,3195
215284,2,1,1730,1465,3195
215293,1,999,16349,18012,34361
215293,2,1,11117,11410,22527
215293,4,3,5232,6602,11834
215309,1,999,214,392,606
215309,2,1,214,392,606
215336,1,999,6,83,89
215336,2,1,6,83,89
215381,1,999,706,48,754
215381,2,1,706,48,754
215390,1,999,127,124,251
215390,2,1,127,124,251
215415,1,999,2166,1092,3258
215415,2,1,2166,1092,3258
215424,1,999,222,128,350
215424,4,3,222,128,350
215433,1,999,188,660,848
215433,2,1,188,660,848
215442,1,999,1865,2782,4647
215442,2,1,1542,2367,3909
215442,4,3,323,415,738
215479,1,999,2,62,64
215479,2,1,2,62,64
215530,1,999,2,47,49
215530,2,1,2,47,49
215585,1,999,2914,4792,7706
215585,2,1,2914,4792,7706
215594,1,999,94,420,514
215594,2,1,94,420,514
215619,1,999,18,43,61
215619,4,3,18,43,61
215628,1,999,109,25,134
215628,4,3,109,25,134
215637,1,999,263,249,512
215637,2,1,263,249,512
215646,1,999,672,600,1272
215646,2,1,672,600,1272
215655,1,999,2866,2631,5497
215655,2,1,2200,1864,4064
215655,4,3,666,767,1433
215682,1,999,488,18,506
215682,2,1,488,18,506
215691,1,999,237,964,1201
215691,2,1,129,524,653
215691,4,3,108,440,548
215743,1,999,1096,1713,2809
215743,2,1,767,1038,1805
215743,4,3,329,675,1004
215770,1,999,4529,5872,10401
215770,2,1,2758,2992,5750
215770,4,3,1771,2880,4651
215798,1,999,1094,1070,2164
215798,2,1,976,887,1863
215798,4,3,118,183,301
215813,1,999,77,5,82
215813,4,3,77,5,82
215886,1,999,106,219,325
215886,2,1,106,219,325
215929,1,999,2833,4121,6954
215929,2,1,1915,2480,4395
215929,4,3,918,1641,2559
215947,1,999,1021,1859,2880
215947,2,1,877,1444,2321
215947,4,3,144,415,559
215965,1,999,16,84,100
215965,2,1,16,84,100
215974,1,999,133,417,550
215974,2,1,133,417,550
215983,1,999,8,55,63
215983,2,1,8,55,63
215992,1,999,95,358,453
215992,2,1,95,358,453
216010,1,999,4223,5332,9555
216010,2,1,3584,3953,7537
216010,4,3,639,1379,2018
216038,1,999,4302,5802,10104
216038,2,1,3971,5013,8984
216038,4,3,331,789,1120
216047,1,999,209,72,281
216047,2,1,116,33,149
216047,4,3,93,39,132
216074,1,999,4,97,101
216074,2,1,4,97,101
216083,1,999,349,537,886
216083,2,1,349,537,886
216162,1,999,27,170,197
216162,2,1,27,170,197
216223,1,999,1,47,48
216223,2,1,1,47,48
216278,1,999,1091,1276,2367
216278,2,1,1091,1276,2367
216287,1,999,741,805,1546
216287,2,1,741,805,1546
216296,1,999,879,96,975
216296,2,1,879,96,975
216311,1,999,120,0,120
216311,2,1,120,0,120
216339,1,999,19159,22324,41483
216339,2,1,14204,16080,30284
216339,4,3,4955,6244,11199
216348,1,999,15,4,19
216348,4,3,15,4,19
216357,1,999,557,496,1053
216357,2,1,557,496,1053
216366,1,999,1076,2711,3787
216366,2,1,212,997,1209
216366,4,3,864,1714,2578
216418,1,999,1246,1643,2889
216418,2,1,1246,1643,2889
216427,1,999,298,14,312
216427,2,1,298,14,312
216436,1,999,490,10,500
216436,2,1,490,10,500
216445,1,999,426,9,435
216445,2,1,426,9,435
216454,1,999,500,20,520
216454,2,1,500,20,520
216463,1,999,153,85,238
216463,4,3,153,85,238
216524,1,999,815,944,1759
216524,2,1,815,944,1759
216542,1,999,684,754,1438
216542,2,1,660,736,1396
216542,4,3,24,18,42
216551,1,999,277,39,316
216551,2,1,277,39,316
216579,1,999,5,124,129
216579,2,1,5,124,129
216597,1,999,5996,5857,11853
216597,2,1,3933,4078,8011
216597,4,3,2063,1779,3842
216630,1,999,48,261,309
216630,2,1,48,261,309
216649,1,999,8,17,25
216649,2,1,8,17,25
216667,1,999,807,749,1556
216667,2,1,807,749,1556
216694,1,999,1047,1989,3036
216694,2,1,692,1235,1927
216694,4,3,355,754,1109
216746,1,999,148,4,152
216746,2,1,148,4,152
216764,1,999,6628,10889,17517
216764,2,1,5598,8170,13768
216764,4,3,1030,2719,3749
216773,1,999,24,106,130
216773,2,1,24,106,130
216782,1,999,225,1313,1538
216782,2,1,225,1313,1538
216807,1,999,660,923,1583
216807,2,1,609,867,1476
216807,4,3,51,56,107
216816,1,999,557,171,728
216816,4,3,557,171,728
216825,1,999,4141,7255,11396
216825,2,1,4141,7255,11396
216852,1,999,2203,3324,5527
216852,2,1,1621,1989,3610
216852,4,3,582,1335,1917
216931,1,999,3530,6391,9921
216931,2,1,1250,1199,2449
216931,4,3,2280,5192,7472
216986,1,999,11,178,189
216986,2,1,11,178,189
217013,1,999,190,858,1048
217013,2,1,184,817,1001
217013,4,3,6,41,47
217040,1,999,78,0,78
217040,2,1,78,0,78
217059,1,999,2684,3399,6083
217059,2,1,2546,3195,5741
217059,4,3,138,204,342
217077,1,999,1642,1339,2981
217077,2,1,1642,1339,2981
217086,1,999,91,316,407
217086,2,1,91,316,407
217095,1,999,30,318,348
217095,2,1,30,318,348
217156,1,999,4354,4784,9138
217156,2,1,3159,3582,6741
217156,4,3,1195,1202,2397
217165,1,999,2272,1669,3941
217165,2,1,2021,1508,3529
217165,4,3,251,161,412
217235,1,999,5651,6633,12284
217235,2,1,4891,5656,10547
217235,4,3,760,977,1737
217244,1,999,31,277,308
217244,2,1,31,277,308
217305,1,999,3618,1050,4668
217305,2,1,3615,1028,4643
217305,4,3,3,22,25
217323,1,999,845,21,866
217323,2,1,845,21,866
217350,1,999,4,92,96
217350,2,1,4,92,96
217402,1,999,2484,3316,5800
217402,2,1,2069,2657,4726
217402,4,3,415,659,1074
217420,1,999,3494,7661,11155
217420,2,1,3026,6009,9035
217420,4,3,468,1652,2120
217475,1,999,10035,14592,24627
217475,2,1,10035,14592,24627
217484,1,999,8343,11143,19486
217484,2,1,6794,8681,15475
217484,4,3,1549,2462,4011
217493,1,999,887,1756,2643
217493,2,1,698,1511,2209
217493,4,3,189,245,434
217518,1,999,2550,2428,4978
217518,2,1,2407,2203,4610
217518,4,3,143,225,368
217536,1,999,1027,1895,2922
217536,2,1,626,1409,2035
217536,4,3,401,486,887
217545,1,999,196,1395,1591
217545,2,1,196,1395,1591
217572,1,999,19,88,107
217572,2,1,19,88,107
217581,1,999,10,259,269
217581,2,1,10,259,269
217606,1,999,168,147,315
217606,2,1,168,147,315
217615,1,999,1591,2959,4550
217615,2,1,1591,2959,4550
217624,1,999,405,506,911
217624,2,1,405,506,911
217633,1,999,833,1610,2443
217633,2,1,746,1504,2250
217633,4,3,87,106,193
217688,1,999,1662,2892,4554
217688,2,1,1324,2237,3561
217688,4,3,338,655,993
217712,1,999,1129,2676,3805
217712,2,1,1129,2676,3805
217721,1,999,1686,1658,3344
217721,2,1,1686,1658,3344
217749,1,999,2134,2349,4483
217749,2,1,1628,2002,3630
217749,4,3,506,347,853
217776,1,999,998,2115,3113
217776,2,1,709,1222,1931
217776,4,3,289,893,1182
217794,1,999,13,203,216
217794,2,1,13,203,216
217819,1,999,4674,10182,14856
217819,2,1,4119,7016,11135
217819,4,3,555,3166,3721
217828,1,999,2,104,106
217828,2,1,2,104,106
217837,1,999,490,1096,1586
217837,2,1,490,1096,1586
217864,1,999,3019,1094,4113
217864,2,1,2495,265,2760
217864,4,3,524,829,1353
217873,1,999,753,1356,2109
217873,2,1,714,1297,2011
217873,4,3,39,59,98
217882,1,999,11596,10102,21698
217882,2,1,9136,7498,16634
217882,4,3,2460,2604,5064
217891,1,999,84,73,157
217891,2,1,84,73,157
217907,1,999,341,926,1267
217907,2,1,341,926,1267
217925,1,999,758,730,1488
217925,2,1,323,371,694
217925,4,3,435,359,794
217934,1,999,108,1599,1707
217934,2,1,38,1284,1322
217934,4,3,70,315,385
217961,1,999,418,3016,3434
217961,2,1,0,776,776
217961,4,3,418,2240,2658
217989,1,999,750,1087,1837
217989,2,1,750,1087,1837
217998,1,999,589,424,1013
217998,2,1,294,334,628
217998,4,3,295,90,385
218025,1,999,2507,4940,7447
218025,2,1,2507,4940,7447
218043,1,999,21,137,158
218043,2,1,21,137,158
218061,1,999,1459,3311,4770
218061,2,1,1359,2750,4109
218061,4,3,100,561,661
218070,1,999,1372,1996,3368
218070,2,1,1262,1627,2889
218070,4,3,110,369,479
218089,1,999,86,106,192
218089,2,1,74,89,163
218089,4,3,12,17,29
218113,1,999,8640,12560,21200
218113,2,1,8640,12560,21200
218140,1,999,3501,6650,10151
218140,2,1,3501,6650,10151
218159,1,999,1,131,132
218159,2,1,1,131,132
218195,1,999,13,252,265
218195,2,1,13,252,265
218229,1,999,1135,2400,3535
218229,2,1,1111,2190,3301
218229,4,3,24,210,234
218238,1,999,1508,2414,3922
218238,2,1,1508,2414,3922
218265,1,999,91,70,161
218265,4,3,91,70,161
218335,1,999,1041,1916,2957
218335,2,1,55,275,330
218335,4,3,986,1641,2627
218353,1,999,6802,10638,17440
218353,2,1,6802,10638,17440
218399,1,999,468,647,1115
218399,2,1,468,647,1115
218414,1,999,629,498,1127
218414,2,1,629,498,1127
218441,1,999,1256,1258,2514
218441,2,1,1139,1191,2330
218441,4,3,117,67,184
218487,1,999,1423,2927,4350
218487,2,1,1423,2927,4350
218520,1,999,2870,5273,8143
218520,2,1,2870,5273,8143
218539,1,999,641,616,1257
218539,2,1,641,616,1257
218645,1,999,1242,2472,3714
218645,2,1,1212,2331,3543
218645,4,3,30,141,171
218654,1,999,832,1227,2059
218654,2,1,832,1227,2059
218663,1,999,13847,17428,31275
218663,2,1,10150,11688,21838
218663,4,3,3697,5740,9437
218672,1,999,789,1234,2023
218672,2,1,789,1234,2023
218681,1,999,356,899,1255
218681,2,1,356,899,1255
218690,1,999,615,844,1459
218690,2,1,615,844,1459
218706,1,999,249,395,644
218706,2,1,249,395,644
218724,1,999,4323,5626,9949
218724,2,1,4063,4612,8675
218724,4,3,260,1014,1274
218733,1,999,2242,3070,5312
218733,2,1,2072,2452,4524
218733,4,3,170,618,788
218742,1,999,2151,4121,6272
218742,2,1,2127,3844,5971
218742,4,3,24,277,301
218751,1,999,139,100,239
218751,4,3,139,100,239
218821,1,999,489,373,862
218821,2,1,489,373,862
218830,1,999,3056,5237,8293
218830,2,1,3056,5237,8293
218858,1,999,1942,4113,6055
218858,2,1,1942,4113,6055
218867,1,999,1,63,64
218867,2,1,1,63,64
218885,1,999,4031,5182,9213
218885,2,1,4031,5182,9213
218894,1,999,8336,13281,21617
218894,2,1,8336,13281,21617
218919,1,999,357,427,784
218919,2,1,357,427,784
218955,1,999,420,740,1160
218955,2,1,420,740,1160
218964,1,999,2248,5097,7345
218964,2,1,1801,3840,5641
218964,4,3,447,1257,1704
218973,1,999,744,730,1474
218973,2,1,744,730,1474
218991,1,999,3434,5424,8858
218991,2,1,3434,5424,8858
219000,1,999,719,1214,1933
219000,2,1,702,1192,1894
219000,4,3,17,22,39
219037,1,999,9,192,201
219037,2,1,9,192,201
219046,1,999,2055,3862,5917
219046,2,1,1909,3077,4986
219046,4,3,146,785,931
219055,1,999,170,386,556
219055,2,1,170,386,556
219082,1,999,1957,2652,4609
219082,2,1,1689,2379,4068
219082,4,3,268,273,541
219091,1,999,353,539,892
219091,2,1,331,512,843
219091,4,3,22,27,49
219125,1,999,6,152,158
219125,2,1,6,152,158
219143,1,999,745,758,1503
219143,2,1,745,758,1503
219170,1,999,0,19,19
219170,2,1,0,19,19
219189,1,999,776,340,1116
219189,2,1,776,340,1116
219198,1,999,577,942,1519
219198,2,1,517,869,1386
219198,4,3,60,73,133
219204,1,999,1078,2233,3311
219204,2,1,887,1884,2771
219204,4,3,191,349,540
219213,1,999,223,801,1024
219213,2,1,223,801,1024
219240,1,999,89,58,147
219240,4,3,89,58,147
219259,1,999,1194,1943,3137
219259,2,1,1040,1451,2491
219259,4,3,154,492,646
219277,1,999,886,1866,2752
219277,2,1,819,1614,2433
219277,4,3,67,252,319
219295,1,999,135,644,779
219295,2,1,135,644,779
219338,1,999,2,15,17
219338,2,1,2,15,17
219347,1,999,1783,782,2565
219347,2,1,1521,696,2217
219347,4,3,262,86,348
219356,1,999,6658,7971,14629
219356,2,1,5808,6862,12670
219356,4,3,850,1109,1959
219374,1,999,495,1134,1629
219374,2,1,434,996,1430
219374,4,3,61,138,199
219383,1,999,847,1170,2017
219383,2,1,661,798,1459
219383,4,3,186,372,558
219392,1,999,5,21,26
219392,2,1,5,21,26
219408,1,999,94,258,352
219408,2,1,94,258,352
219426,1,999,1676,1458,3134
219426,2,1,1676,1458,3134
219453,1,999,2,227,229
219453,2,1,2,227,229
219471,1,999,4528,7895,12423
219471,2,1,3297,5620,8917
219471,4,3,1231,2275,3506
219480,1,999,951,770,1721
219480,2,1,951,770,1721
219505,1,999,76,43,119
219505,2,1,76,43,119
219578,1,999,173,916,1089
219578,2,1,173,886,1059
219578,4,3,0,30,30
219587,1,999,4,99,103
219587,2,1,4,99,103
219596,1,999,353,258,611
219596,2,1,353,258,611
219602,1,999,4718,7443,12161
219602,2,1,4372,6577,10949
219602,4,3,346,866,1212
219639,1,999,141,1033,1174
219639,2,1,141,1033,1174
219709,1,999,2487,3648,6135
219709,2,1,2061,2808,4869
219709,4,3,426,840,1266
219718,1,999,1612,2528,4140
219718,2,1,1286,1944,3230
219718,4,3,326,584,910
219790,1,999,754,851,1605
219790,2,1,708,789,1497
219790,4,3,46,62,108
219806,1,999,1006,1414,2420
219806,2,1,896,1172,2068
219806,4,3,110,242,352
219824,1,999,5114,7511,12625
219824,2,1,5114,7511,12625
219833,1,999,1076,1335,2411
219833,2,1,722,897,1619
219833,4,3,354,438,792
219842,1,999,207,80,287
219842,4,3,207,80,287
219879,1,999,1909,2915,4824
219879,2,1,1909,2915,4824
219888,1,999,2752,4687,7439
219888,2,1,2752,4687,7439
219903,1,999,147,1129,1276
219903,2,1,147,1129,1276
219921,1,999,251,132,383
219921,2,1,251,132,383
219949,1,999,648,966,1614
219949,2,1,513,722,1235
219949,4,3,135,244,379
219976,1,999,1643,2289,3932
219976,2,1,1171,1549,2720
219976,4,3,472,740,1212
219994,1,999,701,604,1305
219994,2,1,701,604,1305
220002,1,999,243,731,974
220002,2,1,243,731,974
220057,1,999,1344,3067,4411
220057,2,1,1344,3067,4411
220075,1,999,6992,9659,16651
220075,2,1,5818,7481,13299
220075,4,3,1174,2178,3352
220118,1,999,93,344,437
220118,2,1,93,344,437
220127,1,999,393,612,1005
220127,2,1,393,612,1005
220136,1,999,119,47,166
220136,4,3,119,47,166
220163,1,999,5,133,138
220163,2,1,5,133,138
220181,1,999,238,439,677
220181,2,1,207,396,603
220181,4,3,31,43,74
220206,1,999,187,146,333
220206,2,1,187,146,333
220215,1,999,961,1236,2197
220215,2,1,688,850,1538
220215,4,3,273,386,659
220251,1,999,274,380,654
220251,2,1,274,380,654
220279,1,999,443,363,806
220279,2,1,443,363,806
220312,1,999,66,79,145
220312,2,1,66,79,145
220321,1,999,566,595,1161
220321,2,1,566,595,1161
220394,1,999,187,173,360
220394,2,1,187,173,360
220400,1,999,2448,4783,7231
220400,2,1,2448,4783,7231
220464,1,999,78,92,170
220464,2,1,78,92,170
220473,1,999,469,400,869
220473,2,1,384,333,717
220473,4,3,85,67,152
220491,1,999,47,505,552
220491,2,1,47,505,552
220516,1,999,771,1364,2135
220516,2,1,637,1137,1774
220516,4,3,134,227,361
220552,1,999,370,1220,1590
220552,2,1,304,1063,1367
220552,4,3,66,157,223
220570,1,999,38,33,71
220570,2,1,38,33,71
220589,1,999,408,333,741
220589,2,1,408,333,741
220598,1,999,1033,1184,2217
220598,2,1,1033,1184,2217
220604,1,999,387,740,1127
220604,2,1,387,740,1127
220613,1,999,2068,2729,4797
220613,2,1,1896,2396,4292
220613,4,3,172,333,505
220631,1,999,1435,3062,4497
220631,2,1,531,1252,1783
220631,4,3,904,1810,2714
220640,1,999,458,583,1041
220640,2,1,458,583,1041
220701,1,999,427,706,1133
220701,2,1,427,706,1133
220710,1,999,510,623,1133
220710,2,1,510,623,1133
220756,1,999,326,136,462
220756,2,1,326,136,462
220765,1,999,42,305,347
220765,2,1,42,305,347
220792,1,999,321,471,792
220792,4,3,321,471,792
220808,1,999,186,299,485
220808,2,1,154,233,387
220808,4,3,32,66,98
220853,1,999,818,450,1268
220853,2,1,818,450,1268
220862,1,999,9733,15683,25416
220862,2,1,7537,11862,19399
220862,4,3,2196,3821,6017
220871,1,999,209,142,351
220871,4,3,209,142,351
220941,1,999,231,662,893
220941,2,1,212,608,820
220941,4,3,19,54,73
220978,1,999,13914,16105,30019
220978,2,1,12558,13423,25981
220978,4,3,1356,2682,4038
220996,1,999,123,163,286
220996,4,3,123,163,286
221014,1,999,490,754,1244
221014,2,1,392,570,962
221014,4,3,98,184,282
221050,1,999,819,521,1340
221050,2,1,819,521,1340
221096,1,999,2607,4198,6805
221096,2,1,2607,4198,6805
221102,1,999,243,303,546
221102,2,1,243,303,546
221148,1,999,3983,95,4078
221148,2,1,3983,95,4078
221157,1,999,10,376,386
221157,2,1,10,376,386
221184,1,999,5526,7945,13471
221184,2,1,5526,7945,13471
221236,1,999,330,265,595
221236,2,1,330,265,595
221254,1,999,28,159,187
221254,2,1,28,159,187
221281,1,999,226,414,640
221281,2,1,226,414,640
221290,1,999,26,266,292
221290,2,1,26,266,292
221333,1,999,554,303,857
221333,2,1,554,303,857
221351,1,999,761,1028,1789
221351,2,1,757,1022,1779
221351,4,3,4,6,10
221388,1,999,175,212,387
221388,2,1,175,212,387
221397,1,999,2933,5410,8343
221397,2,1,2933,5410,8343
221430,1,999,282,194,476
221430,2,1,282,194,476
221485,1,999,6899,12881,19780
221485,2,1,6899,12881,19780
221494,1,999,572,313,885
221494,2,1,572,313,885
221519,1,999,876,898,1774
221519,2,1,757,812,1569
221519,4,3,119,86,205
221582,1,999,336,355,691
221582,2,1,336,355,691
221591,1,999,647,484,1131
221591,2,1,647,484,1131
221607,1,999,230,200,430
221607,2,1,230,200,430
221616,1,999,346,306,652
221616,2,1,346,306,652
221625,1,999,458,1217,1675
221625,2,1,458,1217,1675
221634,1,999,226,162,388
221634,2,1,226,162,388
221643,1,999,7052,7937,14989
221643,2,1,7052,7937,14989
221661,1,999,1345,1734,3079
221661,2,1,1223,1512,2735
221661,4,3,122,222,344
221670,1,999,240,247,487
221670,4,3,240,247,487
221731,1,999,439,787,1226
221731,2,1,439,787,1226
221740,1,999,5301,6634,11935
221740,2,1,4469,5562,10031
221740,4,3,832,1072,1904
221759,1,999,16255,16831,33086
221759,2,1,11881,11453,23334
221759,4,3,4374,5378,9752
221768,1,999,4017,5584,9601
221768,2,1,3777,5068,8845
221768,4,3,240,516,756
221795,1,999,176,33,209
221795,2,1,176,33,209
221829,1,999,29,408,437
221829,2,1,29,408,437
221838,1,999,3739,6670,10409
221838,2,1,2943,4897,7840
221838,4,3,796,1773,2569
221847,1,999,6054,6293,12347
221847,2,1,5151,4625,9776
221847,4,3,903,1668,2571
221856,1,999,654,479,1133
221856,2,1,409,426,835
221856,4,3,245,53,298
221892,1,999,1229,2069,3298
221892,2,1,747,920,1667
221892,4,3,482,1149,1631
221908,1,999,3610,4589,8199
221908,2,1,3610,4589,8199
221953,1,999,999,1594,2593
221953,2,1,942,1396,2338
221953,4,3,57,198,255
221971,1,999,1946,3052,4998
221971,2,1,1401,1900,3301
221971,4,3,545,1152,1697
221980,1,999,10,94,104
221980,2,1,10,94,104
221999,1,999,5978,7257,13235
221999,2,1,3304,3560,6864
221999,4,3,2674,3697,6371
222026,1,999,4,73,77
222026,2,1,4,73,77
222053,1,999,4478,7516,11994
222053,2,1,4478,7516,11994
222062,1,999,3583,5494,9077
222062,2,1,3583,5494,9077
222099,1,999,36,714,750
222099,2,1,36,714,750
222105,1,999,188,0,188
222105,2,1,188,0,188
222178,1,999,2475,3058,5533
222178,2,1,1970,2314,4284
222178,4,3,505,744,1249
222567,1,999,3606,4581,8187
222567,2,1,3606,4581,8187
222576,1,999,6219,9211,15430
222576,2,1,6219,9211,15430
222628,1,999,884,1615,2499
222628,2,1,267,374,641
222628,4,3,617,1241,1858
222673,1,999,49,275,324
222673,2,1,49,275,324
222682,1,999,76,283,359
222682,2,1,76,283,359
222691,1,999,17,233,250
222691,2,1,17,233,250
222707,1,999,29,314,343
222707,2,1,29,314,343
222761,1,999,2568,100,2668
222761,2,1,2568,100,2668
222822,1,999,2857,4863,7720
222822,2,1,2857,4863,7720
222831,1,999,3234,4218,7452
222831,2,1,2899,3563,6462
222831,4,3,335,655,990
222877,1,999,98,92,190
222877,2,1,94,92,186
222877,4,3,4,0,4
222886,1,999,29,331,360
222886,2,1,29,331,360
222938,1,999,1419,1819,3238
222938,2,1,1419,1819,3238
222983,1,999,633,755,1388
222983,2,1,625,730,1355
222983,4,3,8,25,33
222992,1,999,31128,39198,70326
222992,2,1,31128,39198,70326
223001,1,999,100,119,219
223001,4,3,100,119,219
223056,1,999,10,121,131
223056,2,1,10,121,131
223083,1,999,133,493,626
223083,2,1,133,493,626
223117,1,999,121,34,155
223117,2,1,56,25,81
223117,4,3,65,9,74
223214,1,999,913,1063,1976
223214,2,1,13,146,159
223214,4,3,900,917,1817
223223,1,999,644,787,1431
223223,4,3,644,787,1431
223232,1,999,6924,8921,15845
223232,2,1,5433,7544,12977
223232,4,3,1491,1377,2868
223320,1,999,2681,3806,6487
223320,2,1,2681,3806,6487
223427,1,999,12154,12916,25070
223427,2,1,12154,12916,25070
223463,1,999,518,1891,2409
223463,2,1,518,1891,2409
223472,1,999,32,300,332
223472,2,1,32,300,332
223506,1,999,2831,3056,5887
223506,2,1,2831,3056,5887
223524,1,999,9516,14006,23522
223524,2,1,9516,14006,23522
223658,1,999,440,22,462
223658,2,1,440,22,462
223667,1,999,4,49,53
223667,2,1,4,49,53
223773,1,999,4267,6802,11069
223773,2,1,4267,6802,11069
223816,1,999,27482,20267,47749
223816,2,1,27482,20267,47749
223852,1,999,1,60,61
223852,2,1,1,60,61
223898,1,999,2648,3743,6391
223898,2,1,2648,3743,6391
223922,1,999,867,887,1754
223922,2,1,867,887,1754
224004,1,999,834,1922,2756
224004,2,1,561,802,1363
224004,4,3,273,1120,1393
224013,1,999,5,94,99
224013,2,1,5,94,99
224110,1,999,5767,7932,13699
224110,2,1,5767,7932,13699
224147,1,999,4436,6858,11294
224147,2,1,3678,5234,8912
224147,4,3,758,1624,2382
224156,1,999,39,460,499
224156,2,1,39,460,499
224183,1,999,67,1406,1473
224183,2,1,67,1406,1473
224226,1,999,2781,4140,6921
224226,2,1,1884,2639,4523
224226,4,3,897,1501,2398
224244,1,999,209,175,384
224244,2,1,207,163,370
224244,4,3,2,12,14
224271,1,999,102,93,195
224271,2,1,102,93,195
224305,1,999,1629,683,2312
224305,4,3,1629,683,2312
224323,1,999,1945,1555,3500
224323,2,1,671,713,1384
224323,4,3,1274,842,2116
224350,1,999,6749,9433,16182
224350,2,1,6749,9433,16182
224402,1,999,5275,3902,9177
224402,2,1,4533,3156,7689
224402,4,3,742,746,1488
224439,1,999,561,2563,3124
224439,2,1,561,2563,3124
224527,1,999,609,635,1244
224527,2,1,609,635,1244
224545,1,999,641,1698,2339
224545,2,1,379,1017,1396
224545,4,3,262,681,943
224554,1,999,4839,7754,12593
224554,2,1,2523,4058,6581
224554,4,3,2316,3696,6012
224572,1,999,8932,13002,21934
224572,2,1,8932,13002,21934
224615,1,999,5756,11854,17610
224615,2,1,5756,11854,17610
224642,1,999,16623,22183,38806
224642,2,1,16623,22183,38806
224660,1,999,444,482,926
224660,2,1,444,482,926
224679,1,999,1147,299,1446
224679,2,1,1147,299,1446
224712,1,999,37,90,127
224712,4,3,37,90,127
224758,1,999,13,110,123
224758,2,1,13,110,123
224776,1,999,1432,1641,3073
224776,2,1,1432,1641,3073
224828,1,999,35,236,271
224828,2,1,35,236,271
224891,1,999,725,887,1612
224891,2,1,725,887,1612
224907,1,999,3,166,169
224907,2,1,3,166,169
224961,1,999,1220,2038,3258
224961,2,1,1220,2038,3258
225070,1,999,2667,4157,6824
225070,2,1,2667,4157,6824
225201,1,999,576,373,949
225201,2,1,576,373,949
225247,1,999,1206,1476,2682
225247,2,1,949,1189,2138
225247,4,3,257,287,544
225308,1,999,4990,6376,11366
225308,2,1,4990,6376,11366
225371,1,999,2509,3918,6427
225371,2,1,2509,3918,6427
225399,1,999,1027,2047,3074
225399,2,1,896,1662,2558
225399,4,3,131,385,516
225414,1,999,3529,6277,9806
225414,2,1,1827,3828,5655
225414,4,3,1702,2449,4151
225423,1,999,37225,51982,89207
225423,2,1,37225,51982,89207
225432,1,999,6129,9712,15841
225432,2,1,6046,9608,15654
225432,4,3,83,104,187
225502,1,999,1653,3334,4987
225502,2,1,730,1764,2494
225502,4,3,923,1570,2493
225511,1,999,21460,21694,43154
225511,2,1,17058,17165,34223
225511,4,3,4402,4529,8931
225520,1,999,2232,3527,5759
225520,2,1,2232,3527,5759
225548,1,999,728,651,1379
225548,2,1,713,642,1355
225548,4,3,15,9,24
225575,1,999,474,522,996
225575,2,1,450,488,938
225575,4,3,24,34,58
225627,1,999,3088,5407,8495
225627,2,1,2366,4085,6451
225627,4,3,722,1322,2044
225779,1,999,104,207,311
225779,2,1,104,207,311
225788,1,999,186,343,529
225788,2,1,186,343,529
225849,1,999,1376,245,1621
225849,2,1,1376,245,1621
225858,1,999,998,215,1213
225858,2,1,998,215,1213
225876,1,999,172,313,485
225876,2,1,172,313,485
225885,1,999,424,346,770
225885,2,1,424,346,770
225991,1,999,91,80,171
225991,2,1,91,80,171
226019,1,999,3404,5401,8805
226019,2,1,3404,5401,8805
226091,1,999,7085,11290,18375
226091,2,1,4419,6438,10857
226091,4,3,2666,4852,7518
226107,1,999,793,2352,3145
226107,2,1,793,2352,3145
226116,1,999,1217,1948,3165
226116,2,1,1217,1948,3165
226125,1,999,4,197,201
226125,2,1,4,197,201
226134,1,999,5740,7697,13437
226134,2,1,5740,7697,13437
226152,1,999,3158,4695,7853
226152,2,1,2589,3853,6442
226152,4,3,569,842,1411
226204,1,999,5179,4695,9874
226204,2,1,5179,4695,9874
226231,1,999,1990,2661,4651
226231,2,1,1837,2338,4175
226231,4,3,153,323,476
226277,1,999,3238,95,3333
226277,2,1,3238,95,3333
226329,1,999,850,322,1172
226329,2,1,850,322,1172
226374,1,999,58,25,83
226374,2,1,58,25,83
226383,1,999,1006,1437,2443
226383,2,1,795,1110,1905
226383,4,3,211,327,538
226408,1,999,2374,3615,5989
226408,2,1,2374,3615,5989
226471,1,999,1221,1917,3138
226471,2,1,1097,1711,2808
226471,4,3,124,206,330
226578,1,999,4674,8789,13463
226578,2,1,4674,8789,13463
226587,1,999,905,941,1846
226587,2,1,905,941,1846
226675,1,999,61,295,356
226675,2,1,61,295,356
226772,1,999,9,123,132
226772,2,1,9,123,132
226806,1,999,4577,6178,10755
226806,2,1,4577,6178,10755
226833,1,999,3136,4382,7518
226833,2,1,2810,3763,6573
226833,4,3,326,619,945
226860,1,999,11,70,81
226860,2,1,11,70,81
226879,1,999,60,292,352
226879,2,1,60,292,352
226903,1,999,89,379,468
226903,2,1,89,379,468
226930,1,999,5830,8976,14806
226930,2,1,5830,8976,14806
227003,1,999,1192,1154,2346
227003,2,1,1192,1154,2346
227058,1,999,5,98,103
227058,2,1,5,98,103
227146,1,999,5503,8263,13766
227146,2,1,5503,8263,13766
227155,1,999,4,79,83
227155,2,1,4,79,83
227182,1,999,32502,47513,80015
227182,2,1,32502,47513,80015
227191,1,999,8904,11321,20225
227191,2,1,8904,11321,20225
227216,1,999,18510,23580,42090
227216,2,1,14937,17203,32140
227216,4,3,3573,6377,9950
227225,1,999,1572,2581,4153
227225,2,1,1572,2581,4153
227243,1,999,479,607,1086
227243,2,1,458,584,1042
227243,4,3,21,23,44
227289,1,999,170,63,233
227289,4,3,170,63,233
227298,1,999,743,25,768
227298,2,1,743,25,768
227304,1,999,2960,4413,7373
227304,2,1,2960,4413,7373
227313,1,999,29,580,609
227313,2,1,29,580,609
227322,1,999,23,577,600
227322,2,1,23,577,600
227331,1,999,781,2114,2895
227331,2,1,467,1224,1691
227331,4,3,314,890,1204
227368,1,999,9627,13014,22641
227368,2,1,8448,11166,19614
227368,4,3,1179,1848,3027
227377,1,999,8890,12478,21368
227377,2,1,8419,11668,20087
227377,4,3,471,810,1281
227386,1,999,959,2168,3127
227386,2,1,959,2168,3127
227401,1,999,3054,4744,7798
227401,2,1,3054,4744,7798
227429,1,999,99,99,198
227429,2,1,98,96,194
227429,4,3,1,3,4
227526,1,999,3866,6006,9872
227526,2,1,3095,4164,7259
227526,4,3,771,1842,2613
227687,1,999,848,851,1699
227687,2,1,848,851,1699
227748,1,999,105,5,110
227748,2,1,105,5,110
227757,1,999,3294,2507,5801
227757,2,1,1802,1647,3449
227757,4,3,1492,860,2352
227766,1,999,14380,18949,33329
227766,2,1,14380,18949,33329
227836,1,999,788,1064,1852
227836,2,1,788,1064,1852
227845,1,999,2425,3598,6023
227845,2,1,1989,2852,4841
227845,4,3,436,746,1182
227854,1,999,5935,7569,13504
227854,2,1,5935,7569,13504
227863,1,999,1602,2464,4066
227863,2,1,815,1134,1949
227863,4,3,787,1330,2117
227881,1,999,8160,11070,19230
227881,2,1,7031,8923,15954
227881,4,3,1129,2147,3276
227924,1,999,14548,20089,34637
227924,2,1,14548,20089,34637
227979,1,999,17066,22189,39255
227979,2,1,17066,22189,39255
228042,1,999,492,705,1197
228042,2,1,491,678,1169
228042,4,3,1,27,28
228088,1,999,6,86,92
228088,2,1,6,86,92
228149,1,999,1904,2340,4244
228149,2,1,1021,1474,2495
228149,4,3,883,866,1749
228158,1,999,7529,6435,13964
228158,2,1,7529,6435,13964
228185,1,999,47,24,71
228185,2,1,47,24,71
228194,1,999,710,663,1373
228194,4,3,710,663,1373
228200,1,999,1163,898,2061
228200,2,1,1163,898,2061
228219,1,999,903,1869,2772
228219,2,1,903,1869,2772
228246,1,999,6184,6059,12243
228246,2,1,3215,3558,6773
228246,4,3,2969,2501,5470
228282,1,999,32,387,419
228282,2,1,32,387,419
228291,1,999,45,2,47
228291,2,1,45,2,47
228316,1,999,3349,4609,7958
228316,2,1,3349,4609,7958
228325,1,999,1187,1140,2327
228325,2,1,964,935,1899
228325,4,3,223,205,428
228343,1,999,528,848,1376
228343,2,1,528,848,1376
228431,1,999,5733,9080,14813
228431,2,1,4949,7538,12487
228431,4,3,784,1542,2326
228459,1,999,15452,19561,35013
228459,2,1,13157,15681,28838
228459,4,3,2295,3880,6175
228468,1,999,430,562,992
228468,2,1,404,540,944
228468,4,3,26,22,48
228486,1,999,118,110,228
228486,2,1,118,110,228
228501,1,999,1627,2297,3924
228501,2,1,1172,1483,2655
228501,4,3,455,814,1269
228529,1,999,5372,7648,13020
228529,2,1,4429,5847,10276
228529,4,3,943,1801,2744
228547,1,999,29373,40701,70074
228547,2,1,29373,40701,70074
228608,1,999,2745,5359,8104
228608,2,1,2745,5359,8104
228635,1,999,1293,1359,2652
228635,2,1,23,90,113
228635,4,3,1270,1269,2539
228644,1,999,1499,2221,3720
228644,2,1,446,769,1215
228644,4,3,1053,1452,2505
228653,1,999,917,1835,2752
228653,2,1,125,552,677
228653,4,3,792,1283,2075
228680,1,999,6491,2592,9083
228680,2,1,6491,2592,9083
228699,1,999,2575,3988,6563
228699,2,1,2575,3988,6563
228705,1,999,4695,5111,9806
228705,2,1,3604,3823,7427
228705,4,3,1091,1288,2379
228714,1,999,1543,991,2534
228714,2,1,1505,922,2427
228714,4,3,38,69,107
228723,1,999,27448,23989,51437
228723,2,1,21133,19271,40404
228723,4,3,6315,4718,11033
228769,1,999,16989,21221,38210
228769,2,1,12518,15971,28489
228769,4,3,4471,5250,9721
228778,1,999,26787,27477,54264
228778,2,1,19799,20813,40612
228778,4,3,6988,6664,13652
228787,1,999,10557,8412,18969
228787,2,1,6162,5169,11331
228787,4,3,4395,3243,7638
228796,1,999,11161,13660,24821
228796,2,1,8957,10890,19847
228796,4,3,2204,2770,4974
228802,1,999,3049,4407,7456
228802,2,1,2307,3147,5454
228802,4,3,742,1260,2002
228866,1,999,248,190,438
228866,4,3,248,190,438
228875,1,999,3898,5408,9306
228875,2,1,3278,4710,7988
228875,4,3,620,698,1318
228884,1,999,618,534,1152
228884,2,1,598,515,1113
228884,4,3,20,19,39
228909,1,999,790,901,1691
228909,4,3,790,901,1691
228981,1,999,690,751,1441
228981,2,1,690,751,1441
229018,1,999,1908,2918,4826
229018,2,1,1401,2081,3482
229018,4,3,507,837,1344
229027,1,999,16356,17179,33535
229027,2,1,14181,14342,28523
229027,4,3,2175,2837,5012
229036,1,999,217,884,1101
229036,2,1,217,884,1101
229063,1,999,4541,6209,10750
229063,2,1,3584,4658,8242
229063,4,3,957,1551,2508
229115,1,999,18119,14710,32829
229115,2,1,14540,11449,25989
229115,4,3,3579,3261,6840
229151,1,999,129,95,224
229151,2,1,129,95,224
229160,1,999,1377,2279,3656
229160,2,1,715,1311,2026
229160,4,3,662,968,1630
229179,1,999,1797,14754,16551
229179,2,1,725,7640,8365
229179,4,3,1072,7114,8186
229267,1,999,1279,1489,2768
229267,2,1,1183,1365,2548
229267,4,3,96,124,220
229300,1,999,1894,3159,5053
229300,2,1,91,600,691
229300,4,3,1803,2559,4362
229319,1,999,3897,4715,8612
229319,2,1,3897,4715,8612
229328,1,999,1321,1001,2322
229328,2,1,1321,1001,2322
229337,1,999,1341,2957,4298
229337,2,1,182,874,1056
229337,4,3,1159,2083,3242
229355,1,999,6262,8902,15164
229355,2,1,6262,8902,15164
229416,1,999,3946,83,4029
229416,2,1,3946,83,4029
229425,1,999,16,777,793
229425,2,1,16,777,793
229504,1,999,3257,4198,7455
229504,2,1,3257,4198,7455
229522,1,999,13,105,118
229522,2,1,13,105,118
229540,1,999,2004,3657,5661
229540,2,1,2004,3657,5661
229638,1,999,5,56,61
229638,2,1,5,56,61
229780,1,999,5207,4951,10158
229780,2,1,4160,3619,7779
229780,4,3,1047,1332,2379
229799,1,999,2981,4463,7444
229799,2,1,2981,4463,7444
229814,1,999,4026,5164,9190
229814,2,1,3272,3921,7193
229814,4,3,754,1243,1997
229832,1,999,2352,2442,4794
229832,2,1,2352,2442,4794
229841,1,999,4283,5657,9940
229841,2,1,4283,5657,9940
229887,1,999,521,871,1392
229887,2,1,521,871,1392
229957,1,999,24,91,115
229957,2,1,24,91,115
230010,1,999,714,769,1483
230010,2,1,714,769,1483
230038,1,999,20991,18355,39346
230038,2,1,18666,16926,35592
230038,4,3,2325,1429,3754
230047,1,999,1572,1922,3494
230047,2,1,1572,1922,3494
230056,1,999,271,914,1185
230056,2,1,271,914,1185
230065,1,999,22,394,416
230065,2,1,22,394,416
230092,1,999,1386,2005,3391
230092,2,1,1386,2005,3391
230135,1,999,10,77,87
230135,2,1,10,77,87
230144,1,999,2,75,77
230144,2,1,2,75,77
230162,1,999,4464,3896,8360
230162,2,1,4464,3896,8360
230171,1,999,6219,6685,12904
230171,2,1,6219,6685,12904
230199,1,999,0,88,88
230199,2,1,0,88,88
230205,1,999,1,29,30
230205,2,1,1,29,30
230214,1,999,70,437,507
230214,2,1,70,437,507
230223,1,999,10,73,83
230223,2,1,10,73,83
230366,1,999,293,580,873
230366,2,1,293,580,873
230384,1,999,1185,218,1403
230384,2,1,1185,218,1403
230418,1,999,1206,972,2178
230418,2,1,1206,972,2178
230472,1,999,291,740,1031
230472,2,1,291,740,1031
230490,1,999,2758,2387,5145
230490,2,1,2758,2387,5145
230597,1,999,2667,2832,5499
230597,2,1,2667,2832,5499
230603,1,999,4599,8190,12789
230603,2,1,4027,7195,11222
230603,4,3,572,995,1567
230621,1,999,232,520,752
230621,2,1,227,511,738
230621,4,3,5,9,14
230630,1,999,336,428,764
230630,2,1,336,428,764
230676,1,999,599,626,1225
230676,2,1,599,626,1225
230728,1,999,9545,8355,17900
230728,2,1,8202,7473,15675
230728,4,3,1343,882,2225
230737,1,999,21177,15568,36745
230737,2,1,21165,15532,36697
230737,4,3,12,36,48
230746,1,999,25899,26560,52459
230746,2,1,25899,26560,52459
230764,1,999,19611,15896,35507
230764,2,1,15312,12505,27817
230764,4,3,4299,3391,7690
230782,1,999,15011,15873,30884
230782,2,1,14568,15511,30079
230782,4,3,443,362,805
230807,1,999,1780,1876,3656
230807,2,1,1162,1379,2541
230807,4,3,618,497,1115
230816,1,999,275,582,857
230816,2,1,228,456,684
230816,4,3,47,126,173
230825,1,999,117,107,224
230825,2,1,117,107,224
230834,1,999,1231,1819,3050
230834,2,1,1063,1218,2281
230834,4,3,168,601,769
230852,1,999,1876,1606,3482
230852,2,1,1694,1374,3068
230852,4,3,182,232,414
230861,1,999,3496,7334,10830
230861,2,1,3496,7334,10830
230889,1,999,307,675,982
230889,2,1,121,234,355
230889,4,3,186,441,627
230898,1,999,402,509,911
230898,2,1,360,423,783
230898,4,3,42,86,128
230913,1,999,905,1714,2619
230913,2,1,772,1258,2030
230913,4,3,133,456,589
230931,1,999,882,972,1854
230931,2,1,848,777,1625
230931,4,3,34,195,229
230940,1,999,165,170,335
230940,2,1,165,170,335
230959,1,999,1964,2520,4484
230959,2,1,1720,1940,3660
230959,4,3,244,580,824
230977,1,999,466,341,807
230977,2,1,466,341,807
230995,1,999,3695,1585,5280
230995,2,1,1685,683,2368
230995,4,3,2010,902,2912
231004,1,999,8,41,49
231004,2,1,8,41,49
231059,1,999,1293,2145,3438
231059,2,1,991,1117,2108
231059,4,3,302,1028,1330
231068,1,999,200,527,727
231068,4,3,200,527,727
231077,1,999,159,388,547
231077,2,1,94,195,289
231077,4,3,65,193,258
231086,1,999,195,348,543
231086,2,1,195,348,543
231095,1,999,75,66,141
231095,2,1,75,66,141
231147,1,999,351,397,748
231147,4,3,351,397,748
231165,1,999,1103,807,1910
231165,2,1,1103,807,1910
231174,1,999,6672,9113,15785
231174,2,1,5779,7772,13551
231174,4,3,893,1341,2234
231280,1,999,14,97,111
231280,2,1,14,97,111
231411,1,999,1518,48,1566
231411,2,1,1518,48,1566
231420,1,999,522,537,1059
231420,2,1,506,475,981
231420,4,3,16,62,78
231536,1,999,2940,3891,6831
231536,2,1,2940,3891,6831
231554,1,999,368,526,894
231554,2,1,368,526,894
231581,1,999,670,969,1639
231581,2,1,670,969,1639
231624,1,999,4161,5012,9173
231624,2,1,2898,3498,6396
231624,4,3,1263,1514,2777
231642,1,999,35,180,215
231642,2,1,35,180,215
231651,1,999,2323,3519,5842
231651,2,1,868,1564,2432
231651,4,3,1455,1955,3410
231688,1,999,4,49,53
231688,2,1,4,49,53
231697,1,999,3642,4365,8007
231697,2,1,3642,4365,8007
231712,1,999,2261,2941,5202
231712,2,1,2181,2739,4920
231712,4,3,80,202,282
231721,1,999,6,105,111
231721,2,1,6,105,111
231785,1,999,257,872,1129
231785,2,1,257,872,1129
231828,1,999,189,960,1149
231828,2,1,189,960,1149
231837,1,999,166,984,1150
231837,2,1,145,857,1002
231837,4,3,21,127,148
231873,1,999,1027,1220,2247
231873,2,1,1027,1220,2247
231882,1,999,2918,4033,6951
231882,2,1,2918,4033,6951
231970,1,999,342,512,854
231970,2,1,4,19,23
231970,4,3,338,493,831
232016,1,999,242,1462,1704
232016,2,1,242,1462,1704
232025,1,999,538,547,1085
232025,2,1,520,503,1023
232025,4,3,18,44,62
232043,1,999,712,1502,2214
232043,2,1,435,827,1262
232043,4,3,277,675,952
232052,1,999,453,993,1446
232052,2,1,453,993,1446
232089,1,999,751,757,1508
232089,2,1,751,757,1508
232186,1,999,17647,22330,39977
232186,2,1,11252,12536,23788
232186,4,3,6395,9794,16189
232195,1,999,3607,6167,9774
232195,2,1,3607,6167,9774
232256,1,999,1091,8,1099
232256,2,1,1091,8,1099
232265,1,999,2340,3991,6331
232265,2,1,1988,3416,5404
232265,4,3,352,575,927
232308,1,999,91,1186,1277
232308,2,1,5,834,839
232308,4,3,86,352,438
232414,1,999,7847,11816,19663
232414,2,1,7847,11816,19663
232423,1,999,8305,12825,21130
232423,2,1,7620,10999,18619
232423,4,3,685,1826,2511
232450,1,999,5488,8205,13693
232450,2,1,5488,8205,13693
232502,1,999,253,943,1196
232502,2,1,253,943,1196
232557,1,999,29984,34626,64610
232557,2,1,18204,21022,39226
232557,4,3,11780,13604,25384
232566,1,999,1673,3897,5570
232566,2,1,1508,2770,4278
232566,4,3,165,1127,1292
232575,1,999,3324,5669,8993
232575,2,1,3324,5669,8993
232593,1,999,2,27,29
232593,2,1,2,27,29
232609,1,999,1114,1882,2996
232609,2,1,926,1433,2359
232609,4,3,188,449,637
232618,1,999,18,298,316
232618,2,1,18,298,316
232672,1,999,230,1994,2224
232672,2,1,152,1629,1781
232672,4,3,78,365,443
232681,1,999,2116,4128,6244
232681,2,1,1753,3222,4975
232681,4,3,363,906,1269
232706,1,999,1058,2995,4053
232706,2,1,706,1818,2524
232706,4,3,352,1177,1529
232724,1,999,10,107,117
232724,2,1,10,107,117
232788,1,999,1793,2714,4507
232788,2,1,1793,2714,4507
232797,1,999,2346,8135,10481
232797,2,1,2335,8100,10435
232797,4,3,11,35,46
232867,1,999,4095,4336,8431
232867,2,1,4095,4336,8431
232885,1,999,48,445,493
232885,2,1,48,445,493
232919,1,999,237,12,249
232919,2,1,237,12,249
232937,1,999,2840,5237,8077
232937,2,1,2535,4423,6958
232937,4,3,305,814,1119
232946,1,999,33696,38867,72563
232946,2,1,33696,38867,72563
232982,1,999,12550,16233,28783
232982,2,1,9471,11207,20678
232982,4,3,3079,5026,8105
233019,1,999,1938,3109,5047
233019,2,1,1938,3109,5047
233037,1,999,913,1602,2515
233037,2,1,913,1602,2515
233082,1,999,27,164,191
233082,2,1,27,164,191
233091,1,999,157,758,915
233091,2,1,157,758,915
233116,1,999,2947,4538,7485
233116,2,1,2947,4538,7485
233277,1,999,3873,5763,9636
233277,2,1,3525,4653,8178
233277,4,3,348,1110,1458
233286,1,999,3,35,38
233286,2,1,3,35,38
233295,1,999,600,685,1285
233295,2,1,600,685,1285
233301,1,999,152,392,544
233301,2,1,146,378,524
233301,4,3,6,14,20
233310,1,999,1594,2996,4590
233310,2,1,1594,2996,4590
233329,1,999,47,600,647
233329,2,1,47,600,647
233338,1,999,722,1363,2085
233338,2,1,722,1363,2085
233356,1,999,19,317,336
233356,2,1,19,317,336
233374,1,999,2362,3187,5549
233374,2,1,1794,2311,4105
233374,4,3,568,876,1444
233408,1,999,30,403,433
233408,2,1,30,403,433
233426,1,999,921,1182,2103
233426,2,1,921,1182,2103
233480,1,999,18,42,60
233480,2,1,18,42,60
233499,1,999,338,336,674
233499,2,1,338,336,674
233541,1,999,1764,3680,5444
233541,2,1,946,1498,2444
233541,4,3,818,2182,3000
233611,1,999,367,392,759
233611,2,1,367,392,759
233639,1,999,3750,5631,9381
233639,2,1,3750,5631,9381
233648,1,999,2617,3014,5631
233648,2,1,2617,3014,5631
233657,1,999,16,153,169
233657,2,1,16,153,169
233666,1,999,1,40,41
233666,2,1,1,40,41
233684,1,999,8333,11915,20248
233684,2,1,6243,8519,14762
233684,4,3,2090,3396,5486
233718,1,999,19,955,974
233718,2,1,11,877,888
233718,4,3,8,78,86
233754,1,999,6530,9304,15834
233754,2,1,6530,9304,15834
233772,1,999,17853,27517,45370
233772,2,1,17853,27517,45370
233842,1,999,148,206,354
233842,4,3,148,206,354
233897,1,999,1071,1250,2321
233897,2,1,1071,1250,2321
233903,1,999,1588,2230,3818
233903,2,1,1588,2230,3818
233912,1,999,223,446,669
233912,2,1,223,446,669
233921,1,999,18985,14095,33080
233921,2,1,14157,10383,24540
233921,4,3,4828,3712,8540
233949,1,999,5827,7397,13224
233949,2,1,5827,7397,13224
234030,1,999,15486,21067,36553
234030,2,1,11331,14147,25478
234030,4,3,4155,6920,11075
234076,1,999,13295,17862,31157
234076,2,1,8321,10164,18485
234076,4,3,4974,7698,12672
234085,1,999,1471,155,1626
234085,2,1,1471,155,1626
234119,1,999,33,153,186
234119,2,1,33,153,186
234137,1,999,171,228,399
234137,2,1,119,170,289
234137,4,3,52,58,110
234155,1,999,2355,3865,6220
234155,2,1,2098,3316,5414
234155,4,3,257,549,806
234164,1,999,878,977,1855
234164,2,1,646,769,1415
234164,4,3,232,208,440
234173,1,999,559,953,1512
234173,2,1,559,953,1512
234191,1,999,52,197,249
234191,2,1,52,197,249
234207,1,999,1124,1066,2190
234207,2,1,894,893,1787
234207,4,3,230,173,403
234216,1,999,485,940,1425
234216,2,1,485,940,1425
234225,1,999,77,80,157
234225,2,1,77,80,157
234359,1,999,289,153,442
234359,2,1,289,153,442
234377,1,999,1989,3253,5242
234377,2,1,1989,3253,5242
234401,1,999,9,147,156
234401,2,1,9,147,156
234492,1,999,1609,1580,3189
234492,2,1,1609,1580,3189
234650,1,999,5,64,69
234650,2,1,5,64,69
234669,1,999,11541,14459,26000
234669,2,1,11541,14459,26000
234687,1,999,4,88,92
234687,2,1,4,88,92
234696,1,999,2920,2856,5776
234696,2,1,2920,2856,5776
234711,1,999,1337,1929,3266
234711,2,1,1337,1929,3266
234739,1,999,378,470,848
234739,2,1,378,470,848
234784,1,999,368,1353,1721
234784,2,1,368,1353,1721
234827,1,999,6625,7200,13825
234827,2,1,6283,6668,12951
234827,4,3,342,532,874
234845,1,999,2615,3679,6294
234845,2,1,2615,3679,6294
234915,1,999,1986,2592,4578
234915,2,1,972,1173,2145
234915,4,3,1014,1419,2433
234924,1,999,7,119,126
234924,2,1,7,119,126
234933,1,999,8676,11500,20176
234933,2,1,8676,11500,20176
234951,1,999,5763,9039,14802
234951,2,1,5763,9039,14802
234979,1,999,4737,5518,10255
234979,2,1,4737,5518,10255
235024,1,999,297,515,812
235024,2,1,297,515,812
235088,1,999,457,8,465
235088,2,1,457,8,465
235097,1,999,6284,8486,14770
235097,2,1,5442,6958,12400
235097,4,3,842,1528,2370
235103,1,999,7270,8487,15757
235103,2,1,7270,8487,15757
235149,1,999,5054,7443,12497
235149,2,1,5054,7443,12497
235158,1,999,7,157,164
235158,2,1,7,157,164
235167,1,999,2574,3164,5738
235167,2,1,2440,2906,5346
235167,4,3,134,258,392
235237,1,999,7641,7586,15227
235237,2,1,7641,7586,15227
235307,1,999,13,274,287
235307,2,1,13,274,287
235316,1,999,3949,4826,8775
235316,2,1,2287,2640,4927
235316,4,3,1662,2186,3848
235334,1,999,1930,2244,4174
235334,2,1,1930,2244,4174
235343,1,999,5819,6731,12550
235343,2,1,5819,6731,12550
235352,1,999,12,84,96
235352,2,1,12,84,96
235422,1,999,357,1013,1370
235422,2,1,234,705,939
235422,4,3,123,308,431
235431,1,999,4180,6349,10529
235431,2,1,4180,6349,10529
235495,1,999,109,166,275
235495,2,1,109,166,275
235501,1,999,477,297,774
235501,2,1,477,297,774
235510,1,999,953,293,1246
235510,2,1,953,293,1246
235529,1,999,686,214,900
235529,2,1,686,214,900
235547,1,999,167,779,946
235547,2,1,29,174,203
235547,4,3,138,605,743
235583,1,999,59,536,595
235583,2,1,59,536,595
235671,1,999,6751,4429,11180
235671,2,1,6751,4429,11180
235699,1,999,3194,3734,6928
235699,2,1,3194,3734,6928
235750,1,999,2277,4144,6421
235750,2,1,2277,4144,6421
235769,1,999,76,78,154
235769,2,1,76,78,154
235954,1,999,2,55,57
235954,2,1,2,55,57
236018,1,999,26,77,103
236018,2,1,26,77,103
236027,1,999,25,370,395
236027,2,1,25,370,395
236072,1,999,4563,6610,11173
236072,2,1,4563,6610,11173
236090,1,999,65,18,83
236090,4,3,65,18,83
236133,1,999,610,923,1533
236133,2,1,512,757,1269
236133,4,3,98,166,264
236188,1,999,5544,6617,12161
236188,2,1,5544,6617,12161
236212,1,999,711,226,937
236212,2,1,711,226,937
236230,1,999,1499,2514,4013
236230,2,1,1336,2188,3524
236230,4,3,163,326,489
236258,1,999,2994,3124,6118
236258,2,1,2994,3124,6118
236328,1,999,1201,1840,3041
236328,2,1,1122,1589,2711
236328,4,3,79,251,330
236382,1,999,5460,2744,8204
236382,2,1,5460,2744,8204
236452,1,999,835,1068,1903
236452,2,1,671,809,1480
236452,4,3,164,259,423
236504,1,999,5684,4391,10075
236504,2,1,5684,4391,10075
236513,1,999,5236,7367,12603
236513,2,1,5236,7367,12603
236531,1,999,125,378,503
236531,2,1,125,378,503
236577,1,999,1439,3009,4448
236577,2,1,1057,2175,3232
236577,4,3,382,834,1216
236595,1,999,3617,5219,8836
236595,2,1,1867,2876,4743
236595,4,3,1750,2343,4093
236610,1,999,4048,5682,9730
236610,2,1,4048,5682,9730
236638,1,999,3646,5396,9042
236638,2,1,3646,5396,9042
236656,1,999,4224,5859,10083
236656,2,1,4224,5859,10083
236692,1,999,6053,6054,12107
236692,2,1,6053,6054,12107
236708,1,999,6618,9570,16188
236708,2,1,6618,9570,16188
236744,1,999,7,132,139
236744,2,1,7,132,139
236753,1,999,4268,7090,11358
236753,2,1,4268,7090,11358
236887,1,999,5021,3614,8635
236887,2,1,5021,3614,8635
236896,1,999,1005,1164,2169
236896,2,1,901,913,1814
236896,4,3,104,251,355
236939,1,999,13974,15787,29761
236939,2,1,11756,12986,24742
236939,4,3,2218,2801,5019
236948,1,999,23648,26158,49806
236948,2,1,17069,18535,35604
236948,4,3,6579,7623,14202
236975,1,999,2119,3285,5404
236975,2,1,2119,3285,5404
236993,1,999,228,578,806
236993,2,1,228,578,806
237011,1,999,7279,9173,16452
237011,2,1,6640,8166,14806
237011,4,3,639,1007,1646
237039,1,999,2924,3712,6636
237039,2,1,2924,3712,6636
237057,1,999,680,950,1630
237057,2,1,680,950,1630
237066,1,999,1419,2107,3526
237066,2,1,1162,1563,2725
237066,4,3,257,544,801
237109,1,999,3067,5893,8960
237109,2,1,3067,5893,8960
237118,1,999,259,530,789
237118,2,1,218,436,654
237118,4,3,41,94,135
237127,1,999,1,24,25
237127,2,1,1,24,25
237136,1,999,186,154,340
237136,2,1,174,152,326
237136,4,3,12,2,14
237145,1,999,0,20,20
237145,2,1,0,20,20
237154,1,999,3158,5874,9032
237154,2,1,2641,5194,7835
237154,4,3,517,680,1197
237172,1,999,325,158,483
237172,2,1,325,158,483
237181,1,999,484,461,945
237181,2,1,484,461,945
237215,1,999,1015,1622,2637
237215,2,1,1015,1622,2637
237242,1,999,160,61,221
237242,2,1,160,61,221
237303,1,999,72,106,178
237303,2,1,72,106,178
237312,1,999,651,904,1555
237312,2,1,447,671,1118
237312,4,3,204,233,437
237321,1,999,14,99,113
237321,2,1,14,99,113
237330,1,999,1394,2056,3450
237330,2,1,1330,1808,3138
237330,4,3,64,248,312
237358,1,999,336,529,865
237358,2,1,336,529,865
237367,1,999,2343,3081,5424
237367,2,1,2190,2781,4971
237367,4,3,153,300,453
237385,1,999,1130,842,1972
237385,2,1,1130,842,1972
237419,1,999,24,6,30
237419,2,1,24,6,30
237437,1,999,442,1229,1671
237437,2,1,442,1229,1671
237473,1,999,131,54,185
237473,2,1,131,54,185
237491,1,999,2,28,30
237491,2,1,2,28,30
237525,1,999,6695,10523,17218
237525,2,1,4864,6138,11002
237525,4,3,1831,4385,6216
237543,1,999,126,221,347
237543,2,1,126,221,347
237552,1,999,29,162,191
237552,2,1,29,162,191
237561,1,999,63,63,126
237561,2,1,63,63,126
237570,1,999,12,108,120
237570,2,1,12,108,120
237598,1,999,31,140,171
237598,2,1,31,140,171
237604,1,999,257,938,1195
237604,2,1,257,938,1195
237613,1,999,10,112,122
237613,2,1,10,112,122
237640,1,999,258,344,602
237640,2,1,251,310,561
237640,4,3,7,34,41
237686,1,999,2412,3151,5563
237686,2,1,2412,3151,5563
237701,1,999,1012,1107,2119
237701,2,1,1012,1107,2119
237729,1,999,87,213,300
237729,2,1,87,213,300
237783,1,999,765,839,1604
237783,2,1,459,501,960
237783,4,3,306,338,644
237792,1,999,2085,2822,4907
237792,2,1,2005,2694,4699
237792,4,3,80,128,208
237817,1,999,1114,2176,3290
237817,2,1,1114,2176,3290
237844,1,999,88,32,120
237844,2,1,88,32,120
237880,1,999,410,371,781
237880,4,3,410,371,781
237899,1,999,2097,3148,5245
237899,2,1,2080,3114,5194
237899,4,3,17,34,51
237905,1,999,6,51,57
237905,2,1,6,45,51
237905,4,3,0,6,6
237932,1,999,1291,1671,2962
237932,2,1,1244,1593,2837
237932,4,3,47,78,125
237950,1,999,897,538,1435
237950,2,1,897,538,1435
237969,1,999,669,799,1468
237969,2,1,637,756,1393
237969,4,3,32,43,75
237978,1,999,29,113,142
237978,2,1,29,113,142
237987,1,999,83,274,357
237987,2,1,83,274,357
237996,1,999,101,179,280
237996,2,1,101,179,280
238005,1,999,3,73,76
238005,2,1,3,73,76
238014,1,999,2410,3636,6046
238014,2,1,2410,3636,6046
238032,1,999,16504,16345,32849
238032,2,1,12706,10504,23210
238032,4,3,3798,5841,9639
238078,1,999,544,914,1458
238078,2,1,448,679,1127
238078,4,3,96,235,331
238096,1,999,6,25,31
238096,2,1,6,25,31
238166,1,999,12,132,144
238166,2,1,12,132,144
238175,1,999,8,178,186
238175,2,1,8,178,186
238193,1,999,61,3138,3199
238193,2,1,8,2651,2659
238193,4,3,53,487,540
238263,1,999,10757,13241,23998
238263,2,1,10741,13200,23941
238263,4,3,16,41,57
238315,1,999,1,12,13
238315,2,1,1,12,13
238324,1,999,32,351,383
238324,2,1,32,303,335
238324,4,3,0,48,48
238333,1,999,620,826,1446
238333,2,1,620,826,1446
238397,1,999,1691,2363,4054
238397,2,1,1691,2363,4054
238421,1,999,23,141,164
238421,2,1,23,141,164
238430,1,999,3157,7734,10891
238430,2,1,1334,2489,3823
238430,4,3,1823,5245,7068
238458,1,999,1290,2626,3916
238458,2,1,1156,2240,3396
238458,4,3,134,386,520
238476,1,999,1431,1735,3166
238476,2,1,1389,1679,3068
238476,4,3,42,56,98
238616,1,999,2446,4951,7397
238616,2,1,1494,2738,4232
238616,4,3,952,2213,3165
238661,1,999,1033,2468,3501
238661,2,1,604,1380,1984
238661,4,3,429,1088,1517
238722,1,999,9165,8041,17206
238722,2,1,9165,8041,17206
238759,1,999,5281,7599,12880
238759,2,1,5281,7599,12880
238786,1,999,7,236,243
238786,2,1,7,236,243
238810,1,999,5,127,132
238810,2,1,5,127,132
238892,1,999,1628,563,2191
238892,2,1,1628,563,2191
238935,1,999,321,354,675
238935,2,1,184,193,377
238935,4,3,137,161,298
238980,1,999,1821,3257,5078
238980,2,1,1431,2329,3760
238980,4,3,390,928,1318
239008,1,999,1893,2882,4775
239008,2,1,1893,2882,4775
239017,1,999,703,798,1501
239017,2,1,703,798,1501
239071,1,999,458,463,921
239071,2,1,364,449,813
239071,4,3,94,14,108
239080,1,999,1232,3035,4267
239080,2,1,637,1651,2288
239080,4,3,595,1384,1979
239105,1,999,6041,6518,12559
239105,2,1,4060,4431,8491
239105,4,3,1981,2087,4068
239132,1,999,53,231,284
239132,2,1,53,231,284
239169,1,999,639,624,1263
239169,4,3,639,624,1263
239220,1,999,2166,2981,5147
239220,2,1,2166,2981,5147
239248,1,999,13436,15750,29186
239248,2,1,13436,15750,29186
239309,1,999,318,399,717
239309,2,1,318,399,717
239318,1,999,2282,546,2828
239318,2,1,2090,483,2573
239318,4,3,192,63,255
239372,1,999,6022,5987,12009
239372,2,1,6022,5987,12009
239390,1,999,122,2327,2449
239390,2,1,65,1621,1686
239390,4,3,57,706,763
239424,1,999,98,27,125
239424,4,3,98,27,125
239442,1,999,813,1378,2191
239442,2,1,813,1378,2191
239460,1,999,3428,4825,8253
239460,2,1,3428,4825,8253
239488,1,999,5925,8481,14406
239488,2,1,5925,8481,14406
239503,1,999,393,377,770
239503,2,1,271,331,602
239503,4,3,122,46,168
239512,1,999,298,368,666
239512,2,1,294,359,653
239512,4,3,4,9,13
239628,1,999,524,561,1085
239628,2,1,524,561,1085
239637,1,999,119,12,131
239637,4,3,119,12,131
239716,1,999,1006,1378,2384
239716,2,1,962,1266,2228
239716,4,3,44,112,156
239743,1,999,319,1037,1356
239743,2,1,187,455,642
239743,4,3,132,582,714
239877,1,999,3,81,84
239877,2,1,3,81,84
239910,1,999,2208,2373,4581
239910,2,1,2208,2373,4581
239929,1,999,306,1304,1610
239929,2,1,306,1304,1610
239965,1,999,3,25,28
239965,2,1,3,25,28
240055,1,999,8533,10146,18679
240055,2,1,8533,10146,18679
240107,1,999,2730,9864,12594
240107,2,1,714,1714,2428
240107,4,3,2016,8150,10166
240116,1,999,2989,3777,6766
240116,2,1,2989,3777,6766
240125,1,999,7159,7249,14408
240125,2,1,7159,7249,14408
240170,1,999,3615,4302,7917
240170,2,1,3615,4302,7917
240189,1,999,6329,6619,12948
240189,2,1,5437,5360,10797
240189,4,3,892,1259,2151
240198,1,999,2646,4142,6788
240198,2,1,2646,4142,6788
240213,1,999,12,63,75
240213,4,3,12,63,75
240240,1,999,4,108,112
240240,2,1,4,108,112
240268,1,999,5195,7430,12625
240268,2,1,4866,6825,11691
240268,4,3,329,605,934
240277,1,999,2765,5160,7925
240277,2,1,2641,4688,7329
240277,4,3,124,472,596
240329,1,999,4671,6937,11608
240329,2,1,4156,5553,9709
240329,4,3,515,1384,1899
240338,1,999,402,495,897
240338,2,1,402,495,897
240365,1,999,6047,9598,15645
240365,2,1,5374,7687,13061
240365,4,3,673,1911,2584
240374,1,999,2816,3569,6385
240374,2,1,2703,3421,6124
240374,4,3,113,148,261
240392,1,999,1385,4833,6218
240392,2,1,1330,4713,6043
240392,4,3,55,120,175
240417,1,999,5287,5701,10988
240417,2,1,4697,4366,9063
240417,4,3,590,1335,1925
240426,1,999,1418,1963,3381
240426,2,1,1305,1745,3050
240426,4,3,113,218,331
240444,1,999,22200,24145,46345
240444,2,1,15927,17631,33558
240444,4,3,6273,6514,12787
240453,1,999,16719,19222,35941
240453,2,1,14225,15242,29467
240453,4,3,2494,3980,6474
240462,1,999,5381,3584,8965
240462,2,1,4832,2992,7824
240462,4,3,549,592,1141
240471,1,999,3113,4716,7829
240471,2,1,2829,4079,6908
240471,4,3,284,637,921
240480,1,999,4933,5827,10760
240480,2,1,4644,5158,9802
240480,4,3,289,669,958
240505,1,999,2647,3425,6072
240505,2,1,2647,3425,6072
240514,1,999,1438,1997,3435
240514,2,1,1438,1997,3435
240596,1,999,837,1252,2089
240596,2,1,837,1252,2089
240620,1,999,3304,4645,7949
240620,2,1,3304,4645,7949
240657,1,999,1187,1638,2825
240657,2,1,1187,1638,2825
240666,1,999,3748,2562,6310
240666,2,1,3748,2562,6310
240693,1,999,2964,4226,7190
240693,2,1,2964,4226,7190
240709,1,999,2,51,53
240709,2,1,2,51,53
240718,1,999,1910,66,1976
240718,2,1,1910,66,1976
240727,1,999,6685,7861,14546
240727,2,1,5270,5909,11179
240727,4,3,1415,1952,3367
240736,1,999,1115,1785,2900
240736,2,1,1115,1785,2900
240745,1,999,1398,1795,3193
240745,2,1,1398,1795,3193
240754,1,999,1706,2627,4333
240754,2,1,1571,2368,3939
240754,4,3,135,259,394
240790,1,999,454,680,1134
240790,2,1,454,680,1134
240879,1,999,195,612,807
240879,2,1,195,612,807
240985,1,999,388,291,679
240985,2,1,388,291,679
241100,1,999,918,1125,2043
241100,2,1,885,978,1863
241100,4,3,33,147,180
241128,1,999,709,1008,1717
241128,2,1,680,930,1610
241128,4,3,29,78,107
241146,1,999,502,797,1299
241146,2,1,502,797,1299
241182,1,999,188,396,584
241182,2,1,188,396,584
241191,1,999,494,699,1193
241191,2,1,480,637,1117
241191,4,3,14,62,76
241216,1,999,1260,502,1762
241216,2,1,1186,456,1642
241216,4,3,74,46,120
241225,1,999,839,2038,2877
241225,2,1,699,1535,2234
241225,4,3,140,503,643
241304,1,999,624,1349,1973
241304,2,1,593,1246,1839
241304,4,3,31,103,134
241331,1,999,138,842,980
241331,2,1,18,214,232
241331,4,3,120,628,748
241377,1,999,1110,1645,2755
241377,2,1,1028,1284,2312
241377,4,3,82,361,443
241386,1,999,318,819,1137
241386,2,1,272,605,877
241386,4,3,46,214,260
241395,1,999,255,544,799
241395,2,1,223,336,559
241395,4,3,32,208,240
241410,1,999,3189,5436,8625
241410,2,1,2253,3685,5938
241410,4,3,936,1751,2687
241517,1,999,573,1232,1805
241517,2,1,573,1232,1805
241614,1,999,140,115,255
241614,2,1,140,115,255
241720,1,999,934,1145,2079
241720,2,1,934,1145,2079
241739,1,999,4881,10038,14919
241739,2,1,4093,8014,12107
241739,4,3,788,2024,2812
241766,1,999,298,123,421
241766,2,1,281,109,390
241766,4,3,17,14,31
241793,1,999,295,450,745
241793,4,3,295,450,745
241836,1,999,542,1033,1575
241836,2,1,542,1033,1575
241906,1,999,130,448,578
241906,2,1,130,448,578
241951,1,999,272,343,615
241951,2,1,272,343,615
242042,1,999,566,371,937
242042,2,1,566,371,937
242112,1,999,1345,1685,3030
242112,2,1,1345,1685,3030
242121,1,999,350,711,1061
242121,2,1,350,711,1061
242130,1,999,229,301,530
242130,2,1,229,301,530
242149,1,999,383,409,792
242149,2,1,383,409,792
242316,1,999,179,274,453
242316,2,1,179,274,453
242413,1,999,244,301,545
242413,2,1,244,301,545
242422,1,999,9660,13901,23561
242422,2,1,9660,13901,23561
242556,1,999,656,261,917
242556,2,1,656,261,917
242565,1,999,560,250,810
242565,2,1,560,250,810
242583,1,999,526,282,808
242583,2,1,526,282,808
242617,1,999,2687,3335,6022
242617,2,1,2394,2674,5068
242617,4,3,293,661,954
242626,1,999,2215,2723,4938
242626,2,1,2130,2499,4629
242626,4,3,85,224,309
242635,1,999,2061,3283,5344
242635,2,1,1976,2977,4953
242635,4,3,85,306,391
242644,1,999,1041,1845,2886
242644,2,1,1000,1698,2698
242644,4,3,41,147,188
242653,1,999,4712,6818,11530
242653,2,1,3620,4191,7811
242653,4,3,1092,2627,3719
242662,1,999,2612,3863,6475
242662,2,1,2508,3605,6113
242662,4,3,104,258,362
242680,1,999,931,1558,2489
242680,2,1,892,1518,2410
242680,4,3,39,40,79
242699,1,999,875,1812,2687
242699,2,1,833,1763,2596
242699,4,3,42,49,91
242705,1,999,3043,2465,5508
242705,2,1,3003,2394,5397
242705,4,3,40,71,111
242723,1,999,411,496,907
242723,4,3,411,496,907
242750,1,999,118,85,203
242750,2,1,118,85,203
242820,1,999,1590,127,1717
242820,2,1,1590,127,1717
242884,1,999,555,1367,1922
242884,2,1,555,1367,1922
242945,1,999,186,357,543
242945,2,1,186,357,543
242954,1,999,19,89,108
242954,2,1,19,89,108
242972,1,999,1048,2648,3696
242972,2,1,1048,2648,3696
242981,1,999,820,1493,2313
242981,2,1,820,1493,2313
243072,1,999,1715,3098,4813
243072,2,1,1715,3098,4813
243081,1,999,219,453,672
243081,4,3,219,453,672
243106,1,999,1229,2019,3248
243106,2,1,1229,2019,3248
243115,1,999,1580,2793,4373
243115,2,1,1580,2793,4373
243133,1,999,2679,2988,5667
243133,2,1,2679,2988,5667
243142,1,999,1749,3038,4787
243142,2,1,1749,3038,4787
243151,1,999,1174,2802,3976
243151,2,1,1174,2802,3976
243179,1,999,1630,3304,4934
243179,2,1,1630,3304,4934
243188,1,999,757,1024,1781
243188,2,1,757,1024,1781
243197,1,999,7455,6980,14435
243197,2,1,6773,6445,13218
243197,4,3,682,535,1217
243203,1,999,621,1834,2455
243203,2,1,111,453,564
243203,4,3,510,1381,1891
243212,1,999,1459,2133,3592
243212,2,1,1459,2133,3592
243221,1,999,7133,13002,20135
243221,2,1,5707,10450,16157
243221,4,3,1426,2552,3978
243346,1,999,5265,9925,15190
243346,2,1,4903,8821,13724
243346,4,3,362,1104,1466
243407,1,999,6,21,27
243407,2,1,6,21,27
243416,1,999,106,332,438
243416,2,1,106,332,438
243443,1,999,2556,4334,6890
243443,2,1,2170,3358,5528
243443,4,3,386,976,1362
243498,1,999,190,124,314
243498,4,3,190,124,314
243568,1,999,212,295,507
243568,2,1,61,131,192
243568,4,3,151,164,315
243577,1,999,4912,1546,6458
243577,2,1,4301,1232,5533
243577,4,3,611,314,925
243586,1,999,663,1064,1727
243586,2,1,598,946,1544
243586,4,3,65,118,183
243601,1,999,7254,11146,18400
243601,2,1,6227,8628,14855
243601,4,3,1027,2518,3545
243638,1,999,2229,2576,4805
243638,2,1,2229,2576,4805
243647,1,999,412,578,990
243647,2,1,412,578,990
243665,1,999,899,2484,3383
243665,2,1,851,2282,3133
243665,4,3,48,202,250
243744,1,999,12098,9194,21292
243744,2,1,4126,3954,8080
243744,4,3,7972,5240,13212
243780,1,999,26137,18792,44929
243780,2,1,20264,14389,34653
243780,4,3,5873,4403,10276
243799,1,999,5,52,57
243799,2,1,5,52,57
243823,1,999,704,480,1184
243823,2,1,144,168,312
243823,4,3,560,312,872
243832,1,999,633,823,1456
243832,2,1,582,777,1359
243832,4,3,51,46,97
243841,1,999,422,607,1029
243841,2,1,422,607,1029
244011,1,999,1232,458,1690
244011,2,1,1232,458,1690
244154,1,999,1042,279,1321
244154,2,1,1042,279,1321
244190,1,999,687,776,1463
244190,2,1,53,212,265
244190,4,3,634,564,1198
244233,1,999,452,800,1252
244233,2,1,452,800,1252
244279,1,999,48,427,475
244279,2,1,48,427,475
244437,1,999,14109,23288,37397
244437,2,1,14109,23288,37397
244446,1,999,3202,5014,8216
244446,2,1,3202,5014,8216
244491,1,999,4,143,147
244491,2,1,4,143,147
244561,1,999,295,949,1244
244561,2,1,295,949,1244
244613,1,999,289,0,289
244613,2,1,289,0,289
245032,1,999,215,940,1155
245032,2,1,215,940,1155
245069,1,999,3,61,64
245069,2,1,3,61,64
245281,1,999,57,16,73
245281,2,1,57,16,73
245290,1,999,115,130,245
245290,2,1,115,130,245
245342,1,999,1543,945,2488
245342,2,1,1543,945,2488
245421,1,999,14,135,149
245421,2,1,14,135,149
245430,1,999,66,415,481
245430,2,1,66,415,481
245625,1,999,1120,1647,2767
245625,2,1,1120,1647,2767
245652,1,999,354,219,573
245652,2,1,274,173,447
245652,4,3,80,46,126
245731,1,999,33,0,33
245731,2,1,19,0,19
245731,4,3,14,0,14
245777,1,999,16,0,16
245777,2,1,12,0,12
245777,4,3,4,0,4
245838,1,999,366,1035,1401
245838,2,1,76,180,256
245838,4,3,290,855,1145
245847,1,999,115,352,467
245847,2,1,44,114,158
245847,4,3,71,238,309
245865,1,999,221,675,896
245865,4,3,221,675,896
245883,1,999,313,969,1282
245883,2,1,103,257,360
245883,4,3,210,712,922
245892,1,999,322,672,994
245892,2,1,66,168,234
245892,4,3,256,504,760
245953,1,999,742,969,1711
245953,2,1,599,753,1352
245953,4,3,143,216,359
245962,1,999,192,772,964
245962,2,1,192,772,964
245980,1,999,6,41,47
245980,2,1,6,41,47
245999,1,999,1392,1243,2635
245999,2,1,1392,1243,2635
246008,1,999,35,412,447
246008,2,1,35,412,447
246017,1,999,699,448,1147
246017,2,1,699,448,1147
246035,1,999,317,1326,1643
246035,2,1,317,1326,1643
246071,1,999,13,89,102
246071,2,1,13,89,102
246202,1,999,239,1129,1368
246202,2,1,239,1129,1368
246266,1,999,446,835,1281
246266,2,1,446,835,1281
246345,1,999,115,112,227
246345,4,3,115,112,227
246354,1,999,3932,6381,10313
246354,2,1,3932,6381,10313
246406,1,999,8,43,51
246406,2,1,8,43,51
246415,1,999,9,127,136
246415,2,1,9,127,136
246460,1,999,19,107,126
246460,2,1,19,107,126
246594,1,999,15,153,168
246594,2,1,15,153,168
246789,1,999,85,42,127
246789,4,3,85,42,127
246813,1,999,2737,5136,7873
246813,2,1,2737,5136,7873
246895,1,999,546,942,1488
246895,2,1,546,942,1488
246974,1,999,152,1286,1438
246974,2,1,152,1286,1438
247010,1,999,1,71,72
247010,2,1,1,71,72
247047,1,999,9,150,159
247047,2,1,9,150,159
247065,1,999,309,1098,1407
247065,2,1,309,1098,1407
247153,1,999,70,555,625
247153,2,1,70,555,625
247162,1,999,58,89,147
247162,2,1,6,2,8
247162,4,3,52,87,139
247409,1,999,22,413,435
247409,2,1,22,413,435
247603,1,999,2431,3080,5511
247603,2,1,2431,3080,5511
247649,1,999,436,162,598
247649,2,1,436,162,598
247700,1,999,387,1181,1568
247700,2,1,387,1181,1568
247773,1,999,81,0,81
247773,2,1,68,0,68
247773,4,3,13,0,13
247825,1,999,58,17,75
247825,2,1,25,10,35
247825,4,3,33,7,40
247834,1,999,17017,21836,38853
247834,2,1,17017,21836,38853
247922,1,999,0,7,7
247922,4,3,0,7,7
247940,1,999,4107,4799,8906
247940,2,1,4107,4799,8906
248165,1,999,0,30,30
248165,2,1,0,30,30
248192,1,999,2,22,24
248192,2,1,2,22,24
248305,1,999,14,433,447
248305,2,1,14,433,447
248314,1,999,5,104,109
248314,2,1,5,104,109
248527,1,999,5,60,65
248527,2,1,5,60,65
248606,1,999,583,456,1039
248606,2,1,583,456,1039
248624,1,999,11,126,137
248624,2,1,11,126,137
248633,1,999,2,69,71
248633,2,1,2,69,71
248660,1,999,5,85,90
248660,2,1,5,85,90
248703,1,999,24,337,361
248703,2,1,24,337,361
248776,1,999,1097,1952,3049
248776,2,1,1097,1952,3049
248846,1,999,26,350,376
248846,2,1,26,350,376
248882,1,999,187,579,766
248882,2,1,187,579,766
248925,1,999,664,607,1271
248925,2,1,664,607,1271
248934,1,999,8051,12758,20809
248934,2,1,8051,12758,20809
248943,1,999,212,75,287
248943,2,1,212,75,287
249061,1,999,8,140,148
249061,2,1,8,140,148
249140,1,999,529,806,1335
249140,2,1,529,806,1335
249238,1,999,40,344,384
249238,2,1,40,344,384
249247,1,999,633,1841,2474
249247,2,1,633,1841,2474
249566,1,999,484,39,523
249566,2,1,484,39,523
249609,1,999,262,596,858
249609,2,1,262,596,858
250027,1,999,103,356,459
250027,2,1,103,356,459
250072,1,999,8,177,185
250072,2,1,8,177,185
250285,1,999,249,20,269
250285,2,1,249,20,269
250407,1,999,233,2027,2260
250407,2,1,233,2027,2260
250498,1,999,61,253,314
250498,2,1,61,253,314
250601,1,999,371,798,1169
250601,2,1,371,798,1169
250744,1,999,152,1070,1222
250744,2,1,152,1070,1222
250832,1,999,7,120,127
250832,2,1,7,120,127
250902,1,999,6,112,118
250902,2,1,6,112,118
250920,1,999,2367,1935,4302
250920,2,1,2367,1935,4302
250993,1,999,115,86,201
250993,2,1,115,86,201
251075,1,999,236,854,1090
251075,2,1,236,854,1090
251251,1,999,652,350,1002
251251,2,1,652,350,1002
251260,1,999,3299,4231,7530
251260,2,1,3299,4231,7530
251312,1,999,372,1692,2064
251312,2,1,305,1377,1682
251312,4,3,67,315,382
260293,1,999,3928,16222,20150
260293,2,1,3826,15935,19761
260293,4,3,102,287,389
260336,1,999,1,28,29
260336,2,1,1,28,29
260354,1,999,32,188,220
260354,2,1,32,188,220
260363,1,999,1,39,40
260363,2,1,1,39,40
260372,1,999,252,467,719
260372,2,1,252,467,719
260664,1,999,432,49,481
260664,2,1,432,49,481
260691,1,999,544,2024,2568
260691,2,1,544,2024,2568
260789,1,999,191,240,431
260789,2,1,191,240,431
260813,1,999,44,184,228
260813,2,1,44,184,228
260901,1,999,30025,81330,111355
260901,2,1,27074,73557,100631
260901,4,3,2951,7773,10724
260910,1,999,317,894,1211
260910,2,1,317,894,1211
260929,1,999,23,306,329
260929,2,1,23,306,329
260947,1,999,28,26,54
260947,2,1,28,26,54
260956,1,999,59,25,84
260956,4,3,59,25,84
260965,1,999,7,126,133
260965,2,1,7,126,133
260974,1,999,772,145,917
260974,2,1,772,145,917
260992,1,999,294,1132,1426
260992,2,1,294,1132,1426
261375,1,999,788,1095,1883
261375,2,1,788,1095,1883
261384,1,999,527,208,735
261384,2,1,527,208,735
261393,1,999,245,169,414
261393,2,1,245,169,414
261436,1,999,28,753,781
261436,2,1,28,753,781
261472,1,999,1855,577,2432
261472,2,1,1855,577,2432
261676,1,999,28,372,400
261676,2,1,28,372,400
261685,1,999,41,364,405
261685,2,1,41,364,405
261719,1,999,5,73,78
261719,2,1,5,73,78
261773,1,999,26,33,59
261773,2,1,26,33,59
261861,1,999,68,203,271
261861,2,1,68,203,271
261931,1,999,245,410,655
261931,2,1,245,410,655
262022,1,999,109,80,189
262022,4,3,109,80,189
262031,1,999,4669,6574,11243
262031,2,1,4669,6574,11243
262086,1,999,3285,7327,10612
262086,2,1,1608,2849,4457
262086,4,3,1677,4478,6155
262129,1,999,319,521,840
262129,2,1,319,521,840
262235,1,999,7,140,147
262235,2,1,7,140,147
262299,1,999,12,175,187
262299,2,1,12,175,187
262332,1,999,1368,934,2302
262332,2,1,1368,934,2302
262341,1,999,611,47,658
262341,2,1,611,47,658
262369,1,999,6,197,203
262369,2,1,6,197,203
262402,1,999,680,30,710
262402,2,1,680,30,710
262457,1,999,618,1186,1804
262457,2,1,618,1186,1804
262509,1,999,269,698,967
262509,2,1,269,698,967
262660,1,999,21,211,232
262660,2,1,21,211,232
362700,1,999,115,558,673
362700,2,1,115,558,673
362782,1,999,3,98,101
362782,2,1,3,98,101
363013,1,999,27,304,331
363013,2,1,27,304,331
363077,1,999,53,292,345
363077,2,1,53,292,345
363147,1,999,3,57,60
363147,2,1,3,57,60
363165,1,999,679,507,1186
363165,2,1,679,507,1186
363387,1,999,539,1357,1896
363387,2,1,539,1357,1896
363439,1,999,219,757,976
363439,2,1,219,757,976
363457,1,999,129,363,492
363457,2,1,129,363,492
363590,1,999,239,1260,1499
363590,2,1,239,1260,1499
363633,1,999,1545,2160,3705
363633,2,1,1545,2160,3705
363679,1,999,6,158,164
363679,2,1,6,158,164
363712,1,999,66,0,66
363712,2,1,66,0,66
363721,1,999,134,181,315
363721,4,3,134,181,315
363882,1,999,7,62,69
363882,2,1,7,62,69
363907,1,999,945,1190,2135
363907,2,1,827,726,1553
363907,4,3,118,464,582
363916,1,999,311,818,1129
363916,2,1,243,531,774
363916,4,3,68,287,355
363934,1,999,1459,162,1621
363934,2,1,1378,146,1524
363934,4,3,81,16,97
364016,1,999,6767,8906,15673
364016,2,1,6767,8906,15673
364025,1,999,7616,8772,16388
364025,2,1,7616,8772,16388
364122,1,999,4,8,12
364122,2,1,4,8,12
364168,1,999,564,75,639
364168,2,1,564,75,639
364317,1,999,163,1559,1722
364317,2,1,163,1559,1722
364326,1,999,145,1066,1211
364326,2,1,145,1066,1211
364335,1,999,239,1137,1376
364335,2,1,239,1137,1376
364548,1,999,161,186,347
364548,2,1,161,186,347
364566,1,999,6,125,131
364566,2,1,6,125,131
364575,1,999,8,58,66
364575,2,1,8,58,66
364584,1,999,17,119,136
364584,2,1,17,119,136
364593,1,999,58,208,266
364593,2,1,58,208,266
364618,1,999,10,93,103
364618,2,1,10,93,103
364627,1,999,248,252,500
364627,2,1,248,252,500
364636,1,999,34,39,73
364636,2,1,34,39,73
364751,1,999,12,228,240
364751,2,1,12,228,240
364760,1,999,4,5,9
364760,2,1,4,5,9
364812,1,999,0,149,149
364812,2,1,0,149,149
364885,1,999,149,429,578
364885,2,1,149,429,578
364946,1,999,179,286,465
364946,2,1,179,286,465
364955,1,999,510,1473,1983
364955,2,1,510,1473,1983
364964,1,999,17,106,123
364964,2,1,17,106,123
364973,1,999,867,676,1543
364973,2,1,867,676,1543
365055,1,999,888,1156,2044
365055,2,1,888,1156,2044
365073,1,999,6,223,229
365073,2,1,6,223,229
365091,1,999,15,551,566
365091,2,1,15,551,566
365107,1,999,5,89,94
365107,2,1,5,89,94
365125,1,999,3,280,283
365125,2,1,3,280,283
365198,1,999,338,371,709
365198,2,1,338,371,709
365204,1,999,567,1281,1848
365204,2,1,567,1281,1848
365213,1,999,346,321,667
365213,2,1,346,321,667
365240,1,999,430,503,933
365240,2,1,430,503,933
365374,1,999,666,676,1342
365374,2,1,666,676,1342
365383,1,999,22,166,188
365383,2,1,22,166,188
365426,1,999,147,152,299
365426,4,3,147,152,299
365453,1,999,1,30,31
365453,2,1,1,30,31
365480,1,999,400,387,787
365480,2,1,400,387,787
365505,1,999,16,74,90
365505,2,1,16,74,90
365569,1,999,23,30,53
365569,2,1,23,30,53
365693,1,999,1,122,123
365693,2,1,1,122,123
365763,1,999,26,26,52
365763,2,1,26,26,52
365824,1,999,3,295,298
365824,2,1,3,295,298
365833,1,999,32,347,379
365833,2,1,32,347,379
366003,1,999,65,44,109
366003,2,1,57,29,86
366003,4,3,8,15,23
366155,1,999,36,22,58
366155,2,1,36,22,58
366191,1,999,2959,49,3008
366191,2,1,2959,49,3008
366252,1,999,4945,2830,7775
366252,2,1,4945,2830,7775
366261,1,999,112,137,249
366261,2,1,112,137,249
366270,1,999,28,590,618
366270,2,1,28,590,618
366289,1,999,84,44,128
366289,2,1,84,44,128
366340,1,999,466,500,966
366340,2,1,466,500,966
366368,1,999,45,66,111
366368,4,3,45,66,111
366395,1,999,15181,18676,33857
366395,2,1,15181,18676,33857
366401,1,999,6377,7740,14117
366401,2,1,6377,7740,14117
366438,1,999,4,156,160
366438,2,1,4,156,160
366447,1,999,1376,1311,2687
366447,2,1,1376,1311,2687
366465,1,999,1467,2585,4052
366465,2,1,1467,2585,4052
366535,1,999,242,756,998
366535,2,1,242,756,998
366544,1,999,581,920,1501
366544,2,1,581,920,1501
366553,1,999,1046,2851,3897
366553,2,1,1046,2851,3897
366571,1,999,8,44,52
366571,2,1,8,44,52
366580,1,999,888,113,1001
366580,2,1,888,113,1001
366605,1,999,8,41,49
366605,4,3,8,41,49
366623,1,999,36,26,62
366623,2,1,36,26,62
366632,1,999,20,90,110
366632,2,1,20,90,110
366650,1,999,1296,475,1771
366650,2,1,1296,475,1771
366678,1,999,1299,286,1585
366678,2,1,1299,286,1585
366696,1,999,1528,338,1866
366696,2,1,1528,338,1866
366711,1,999,3871,6360,10231
366711,2,1,3566,5510,9076
366711,4,3,305,850,1155
366748,1,999,162,462,624
366748,2,1,53,85,138
366748,4,3,109,377,486
366793,1,999,58,62,120
366793,4,3,58,62,120
366960,1,999,347,1439,1786
366960,2,1,347,1439,1786
367024,1,999,476,1150,1626
367024,2,1,476,1150,1626
367051,1,999,2,141,143
367051,2,1,2,141,143
367088,1,999,4,72,76
367088,2,1,4,72,76
367097,1,999,81,233,314
367097,2,1,81,233,314
367103,1,999,18,41,59
367103,2,1,18,41,59
367112,1,999,342,974,1316
367112,2,1,342,974,1316
367130,1,999,31,253,284
367130,2,1,31,253,284
367158,1,999,16,161,177
367158,2,1,16,161,177
367176,1,999,6,124,130
367176,2,1,6,124,130
367194,1,999,580,154,734
367194,2,1,580,154,734
367264,1,999,159,923,1082
367264,2,1,159,923,1082
367316,1,999,116,377,493
367316,2,1,116,377,493
367334,1,999,497,24,521
367334,2,1,497,24,521
367361,1,999,14,19,33
367361,2,1,14,19,33
367398,1,999,36,304,340
367398,2,1,36,304,340
367413,1,999,709,494,1203
367413,2,1,709,494,1203
367431,1,999,6,45,51
367431,2,1,6,45,51
367459,1,999,4995,6817,11812
367459,2,1,4995,6817,11812
367662,1,999,3,222,225
367662,2,1,3,222,225
367839,1,999,47,69,116
367839,2,1,23,33,56
367839,4,3,24,36,60
367875,1,999,262,520,782
367875,2,1,262,520,782
367884,1,999,1063,2308,3371
367884,2,1,932,2075,3007
367884,4,3,131,233,364
367893,1,999,38,30,68
367893,2,1,8,6,14
367893,4,3,30,24,54
367909,1,999,466,1542,2008
367909,2,1,466,1542,2008
367936,1,999,854,2988,3842
367936,2,1,126,383,509
367936,4,3,728,2605,3333
367954,1,999,665,1076,1741
367954,4,3,665,1076,1741
367972,1,999,28,231,259
367972,2,1,28,231,259
367981,1,999,3,228,231
367981,2,1,3,228,231
368036,1,999,10,71,81
368036,2,1,10,71,81
368160,1,999,6,60,66
368160,2,1,6,60,66
368188,1,999,9,98,107
368188,2,1,9,98,107
368230,1,999,63,300,363
368230,2,1,63,300,363
368364,1,999,79,112,191
368364,2,1,79,112,191
368407,1,999,11,67,78
368407,2,1,11,67,78
368443,1,999,324,986,1310
368443,2,1,324,986,1310
368452,1,999,297,363,660
368452,2,1,297,363,660
368540,1,999,4,66,70
368540,2,1,4,66,70
368601,1,999,1425,809,2234
368601,2,1,1425,809,2234
368629,1,999,302,1033,1335
368629,2,1,302,1033,1335
368647,1,999,4,38,42
368647,2,1,4,38,42
368771,1,999,104,219,323
368771,2,1,104,219,323
368780,1,999,123,244,367
368780,2,1,123,244,367
368799,1,999,409,878,1287
368799,2,1,409,878,1287
368805,1,999,566,679,1245
368805,2,1,566,679,1245
368832,1,999,13,88,101
368832,2,1,13,88,101
368911,1,999,969,2492,3461
368911,2,1,969,2492,3461
369002,1,999,341,391,732
369002,4,3,341,391,732
369020,1,999,0,57,57
369020,2,1,0,57,57
369084,1,999,877,459,1336
369084,2,1,877,459,1336
369109,1,999,29,153,182
369109,2,1,29,153,182
369400,1,999,6391,156,6547
369400,2,1,6391,156,6547
369419,1,999,718,1113,1831
369419,2,1,718,1113,1831
369446,1,999,11,162,173
369446,2,1,11,162,173
369455,1,999,59,63,122
369455,2,1,59,63,122
369516,1,999,142,285,427
369516,2,1,142,285,427
369659,1,999,85,270,355
369659,4,3,85,270,355
369668,1,999,101,75,176
369668,2,1,101,75,176
369686,1,999,51,313,364
369686,2,1,51,313,364
369695,1,999,18,90,108
369695,2,1,18,90,108
369783,1,999,135,1121,1256
369783,2,1,135,1121,1256
369792,1,999,2,20,22
369792,2,1,2,20,22
369817,1,999,89,50,139
369817,4,3,89,50,139
369862,1,999,104,553,657
369862,2,1,104,553,657
369905,1,999,192,1138,1330
369905,2,1,192,1138,1330
369950,1,999,337,55,392
369950,2,1,337,55,392
371034,1,999,9,24,33
371034,2,1,9,24,33
371052,1,999,38,652,690
371052,2,1,38,652,690
371140,1,999,3,96,99
371140,2,1,3,96,99
371265,1,999,464,1385,1849
371265,2,1,464,1385,1849
371690,1,999,12,43,55
371690,2,1,12,43,55
371760,1,999,896,2089,2985
371760,2,1,896,2089,2985
371779,1,999,799,2044,2843
371779,2,1,799,2044,2843
371830,1,999,32,18,50
371830,2,1,32,18,50
371928,1,999,119,128,247
371928,2,1,119,128,247
371964,1,999,156,522,678
371964,2,1,156,522,678
371982,1,999,1487,501,1988
371982,2,1,1487,501,1988
372000,1,999,4,58,62
372000,2,1,4,58,62
372028,1,999,21,290,311
372028,2,1,21,290,311
372037,1,999,1845,613,2458
372037,2,1,1845,613,2458
372073,1,999,179,331,510
372073,2,1,179,331,510
372082,1,999,1128,2264,3392
372082,2,1,1128,2264,3392
372213,1,999,153347,349672,503019
372213,2,1,125867,285796,411663
372213,4,3,27480,63876,91356
372222,1,999,3068,3559,6627
372222,2,1,2627,2960,5587
372222,4,3,441,599,1040
372240,1,999,2,54,56
372240,2,1,2,54,56
372329,1,999,112,687,799
372329,2,1,112,687,799
372356,1,999,13,218,231
372356,2,1,13,218,231
372462,1,999,20,153,173
372462,2,1,20,153,173
372523,1,999,276,793,1069
372523,2,1,276,793,1069
372578,1,999,1006,268,1274
372578,2,1,1006,268,1274
372718,1,999,80,354,434
372718,2,1,80,354,434
372772,1,999,226,495,721
372772,2,1,226,495,721
372921,1,999,446,580,1026
372921,2,1,446,580,1026
372958,1,999,307,728,1035
372958,2,1,307,728,1035
373058,1,999,409,440,849
373058,2,1,409,440,849
373085,1,999,89,498,587
373085,2,1,89,498,587
373119,1,999,274,2,276
373119,2,1,274,2,276
373216,1,999,13,291,304
373216,2,1,13,291,304
373340,1,999,10,161,171
373340,2,1,10,161,171
373447,1,999,3,54,57
373447,2,1,3,54,57
373526,1,999,490,65,555
373526,2,1,490,65,555
373605,1,999,2,59,61
373605,2,1,2,59,61
373678,1,999,129,153,282
373678,2,1,129,153,282
373696,1,999,154,194,348
373696,2,1,154,194,348
373711,1,999,6,54,60
373711,2,1,6,54,60
373784,1,999,1031,590,1621
373784,2,1,1031,590,1621
373827,1,999,403,145,548
373827,2,1,403,145,548
373890,1,999,346,1277,1623
373890,2,1,346,1277,1623
374024,1,999,92,361,453
374024,4,3,92,361,453
374112,1,999,25,50,75
374112,2,1,25,50,75
374291,1,999,8,74,82
374291,2,1,8,74,82
374316,1,999,103,75,178
374316,2,1,103,75,178
374440,1,999,1,7,8
374440,2,1,1,7,8
374574,1,999,233,1608,1841
374574,2,1,233,1608,1841
374592,1,999,47,114,161
374592,2,1,47,114,161
374875,1,999,339,1000,1339
374875,2,1,339,1000,1339
374927,1,999,3,127,130
374927,2,1,3,127,130
374972,1,999,595,2483,3078
374972,2,1,595,2483,3078
374990,1,999,12,171,183
374990,2,1,12,171,183
375106,1,999,207,8,215
375106,2,1,207,8,215
375230,1,999,124,0,124
375230,2,1,124,0,124
375300,1,999,45,587,632
375300,2,1,45,587,632
375319,1,999,25,271,296
375319,2,1,25,271,296
375373,1,999,77,274,351
375373,2,1,77,274,351
375407,1,999,67,189,256
375407,2,1,67,189,256
375416,1,999,273,896,1169
375416,2,1,273,896,1169
375489,1,999,364,1611,1975
375489,2,1,364,1611,1975
375540,1,999,11,234,245
375540,2,1,11,234,245
375559,1,999,28,517,545
375559,2,1,28,517,545
375568,1,999,3,34,37
375568,2,1,3,34,37
375647,1,999,58,676,734
375647,2,1,58,676,734
375656,1,999,78,105,183
375656,2,1,78,105,183
375683,1,999,561,367,928
375683,2,1,561,367,928
375692,1,999,27,35,62
375692,2,1,27,35,62
375708,1,999,123,96,219
375708,2,1,123,96,219
375717,1,999,122,118,240
375717,2,1,122,118,240
375726,1,999,158,137,295
375726,2,1,158,137,295
375735,1,999,63,114,177
375735,2,1,63,114,177
375744,1,999,278,158,436
375744,2,1,278,158,436
375753,1,999,73,45,118
375753,2,1,73,45,118
375762,1,999,23,27,50
375762,2,1,23,27,50
375799,1,999,2,43,45
375799,2,1,2,43,45
375841,1,999,588,475,1063
375841,2,1,588,475,1063
375939,1,999,74,413,487
375939,2,1,74,413,487
375948,1,999,527,834,1361
375948,2,1,527,834,1361
375966,1,999,22,161,183
375966,2,1,22,161,183
375984,1,999,105,856,961
375984,2,1,105,856,961
376039,1,999,18,45,63
376039,2,1,18,45,63
376136,1,999,171,975,1146
376136,2,1,171,975,1146
376224,1,999,267,772,1039
376224,2,1,267,772,1039
376242,1,999,364,214,578
376242,2,1,364,214,578
376288,1,999,20,128,148
376288,2,1,20,128,148
376321,1,999,622,1559,2181
376321,2,1,622,1559,2181
376330,1,999,163,727,890
376330,2,1,163,727,890
376385,1,999,802,1118,1920
376385,2,1,802,1118,1920
376446,1,999,21,237,258
376446,2,1,21,237,258
376631,1,999,9,59,68
376631,2,1,9,59,68
376668,1,999,19,70,89
376668,2,1,19,70,89
376677,1,999,79,176,255
376677,2,1,79,176,255
376695,1,999,564,600,1164
376695,2,1,564,600,1164
376950,1,999,45,95,140
376950,2,1,45,95,140
376987,1,999,10,184,194
376987,2,1,10,184,194
377069,1,999,1201,215,1416
377069,2,1,1201,215,1416
377111,1,999,294,1056,1350
377111,2,1,294,1056,1350
377193,1,999,10,116,126
377193,2,1,10,116,126
377218,1,999,135,0,135
377218,2,1,135,0,135
377272,1,999,7,45,52
377272,2,1,7,45,52
377281,1,999,3,48,51
377281,2,1,3,48,51
377315,1,999,11,152,163
377315,2,1,11,152,163
377342,1,999,26,143,169
377342,2,1,26,143,169
377421,1,999,121,441,562
377421,2,1,121,441,562
377449,1,999,75,257,332
377449,2,1,75,257,332
377458,1,999,22,371,393
377458,2,1,22,371,393
377485,1,999,5,40,45
377485,2,1,5,40,45
377546,1,999,35,70,105
377546,2,1,35,70,105
377555,1,999,1551,1950,3501
377555,2,1,1360,1636,2996
377555,4,3,191,314,505
377564,1,999,1555,2356,3911
377564,2,1,1371,1855,3226
377564,4,3,184,501,685
377634,1,999,1,13,14
377634,2,1,1,13,14
377643,1,999,15,156,171
377643,2,1,15,156,171
377652,1,999,23,105,128
377652,2,1,23,105,128
377661,1,999,18,113,131
377661,2,1,18,113,131
377670,1,999,8,61,69
377670,2,1,8,61,69
377722,1,999,31,635,666
377722,2,1,31,635,666
377759,1,999,92,91,183
377759,2,1,92,91,183
378105,1,999,74,308,382
378105,2,1,74,308,382
378406,1,999,1232,512,1744
378406,2,1,1232,512,1744
378576,1,999,195,507,702
378576,2,1,32,59,91
378576,4,3,163,448,611
378886,1,999,360,266,626
378886,2,1,360,266,626
378956,1,999,735,25,760
378956,2,1,735,25,760
379029,1,999,373,1921,2294
379029,2,1,373,1921,2294
379135,1,999,128,13,141
379135,2,1,128,13,141
379463,1,999,17,68,85
379463,2,1,17,68,85
379621,1,999,22,159,181
379621,2,1,22,159,181
379746,1,999,2,54,56
379746,2,1,2,54,56
379782,1,999,47,205,252
379782,2,1,24,128,152
379782,4,3,23,77,100
380067,1,999,0,38,38
380067,2,1,0,38,38
380094,1,999,298,757,1055
380094,2,1,298,757,1055
380359,1,999,278,564,842
380359,2,1,278,564,842
380368,1,999,1288,1554,2842
380368,2,1,1288,1554,2842
380377,1,999,565,878,1443
380377,2,1,565,878,1443
380401,1,999,11,208,219
380401,2,1,11,208,219
380410,1,999,7,268,275
380410,2,1,7,268,275
380438,1,999,289,752,1041
380438,2,1,289,752,1041
380447,1,999,11,230,241
380447,2,1,11,230,241
380456,1,999,15,321,336
380456,2,1,15,321,336
380465,1,999,2047,1894,3941
380465,2,1,1241,995,2236
380465,4,3,806,899,1705
380474,1,999,149,364,513
380474,2,1,149,364,513
381255,1,999,217,90,307
381255,2,1,217,90,307
381282,1,999,147,149,296
381282,2,1,147,149,296
381325,1,999,199,195,394
381325,2,1,199,195,394
381334,1,999,68,125,193
381334,2,1,68,125,193
381352,1,999,29,80,109
381352,4,3,29,80,109
381361,1,999,31,74,105
381361,2,1,31,74,105
381370,1,999,16,314,330
381370,2,1,16,314,330
381404,1,999,46,545,591
381404,2,1,46,545,591
381459,1,999,173,70,243
381459,4,3,173,70,243
381486,1,999,2,31,33
381486,2,1,2,31,33
381529,1,999,195,453,648
381529,2,1,195,453,648
381617,1,999,837,1855,2692
381617,2,1,837,1850,2687
381617,4,3,0,5,5
381635,1,999,3,195,198
381635,2,1,3,195,198
381644,1,999,30,285,315
381644,2,1,30,285,315
381699,1,999,3,37,40
381699,2,1,3,37,40
381705,1,999,2,48,50
381705,2,1,2,48,50
381732,1,999,77,370,447
381732,2,1,77,370,447
381741,1,999,84,292,376
381741,2,1,84,292,376
381750,1,999,8,157,165
381750,2,1,8,157,165
381787,1,999,445,413,858
381787,2,1,445,413,858
381796,1,999,89,417,506
381796,2,1,89,417,506
381909,1,999,1929,672,2601
381909,2,1,1929,672,2601
381945,1,999,32,56,88
381945,2,1,32,56,88
382054,1,999,186,585,771
382054,2,1,186,585,771
382063,1,999,1374,2089,3463
382063,2,1,671,749,1420
382063,4,3,703,1340,2043
382258,1,999,158,656,814
382258,2,1,158,656,814
382267,1,999,8,170,178
382267,2,1,8,170,178
382276,1,999,151,892,1043
382276,2,1,151,892,1043
382416,1,999,22,60,82
382416,2,1,22,60,82
382461,1,999,4,96,100
382461,2,1,4,96,100
382504,1,999,185,601,786
382504,2,1,185,601,786
382771,1,999,175,1090,1265
382771,2,1,175,1090,1265
382780,1,999,72,529,601
382780,2,1,72,529,601
382896,1,999,145,524,669
382896,2,1,145,524,669
382902,1,999,7,106,113
382902,2,1,7,106,113
382911,1,999,75,64,139
382911,2,1,75,64,139
382957,1,999,76,560,636
382957,2,1,76,560,636
383020,1,999,27,95,122
383020,4,3,27,95,122
383084,1,999,2442,3498,5940
383084,2,1,2442,3498,5940
383163,1,999,11,319,330
383163,2,1,11,319,330
383172,1,999,44,82,126
383172,2,1,44,82,126
383190,1,999,1694,2578,4272
383190,2,1,1694,2578,4272
383251,1,999,13,206,219
383251,2,1,13,206,219
383279,1,999,25,182,207
383279,2,1,25,182,207
383297,1,999,22,405,427
383297,2,1,22,405,427
383312,1,999,92,151,243
383312,2,1,92,151,243
383330,1,999,45,171,216
383330,2,1,45,171,216
383367,1,999,106,155,261
383367,2,1,106,155,261
383400,1,999,18,100,118
383400,2,1,18,100,118
383464,1,999,4,96,100
383464,2,1,4,96,100
383507,1,999,8,15,23
383507,2,1,8,15,23
383525,1,999,26,165,191
383525,2,1,26,165,191
383765,1,999,18,309,327
383765,2,1,18,309,327
383792,1,999,7,369,376
383792,2,1,7,369,376
383899,1,999,115,542,657
383899,2,1,115,542,657
383950,1,999,117,624,741
383950,2,1,117,624,741
383996,1,999,578,1081,1659
383996,2,1,578,1081,1659
384184,1,999,89,366,455
384184,2,1,89,366,455
384193,1,999,135,819,954
384193,2,1,135,819,954
384209,1,999,339,908,1247
384209,2,1,339,908,1247
384254,1,999,93,48,141
384254,2,1,93,48,141
384306,1,999,44,179,223
384306,4,3,44,179,223
384333,1,999,4550,7086,11636
384333,2,1,4550,7086,11636
384342,1,999,4994,5174,10168
384342,2,1,4994,5174,10168
384360,1,999,738,1480,2218
384360,2,1,738,1480,2218
384379,1,999,719,1230,1949
384379,2,1,719,1230,1949
384388,1,999,488,766,1254
384388,2,1,488,766,1254
384397,1,999,1235,701,1936
384397,2,1,1235,701,1936
384412,1,999,252,368,620
384412,2,1,252,368,620
384421,1,999,77,0,77
384421,2,1,77,0,77
385008,1,999,255,1405,1660
385008,2,1,255,1405,1660
385132,1,999,18,122,140
385132,2,1,18,122,140
385503,1,999,79,530,609
385503,2,1,79,530,609
385549,1,999,49,320,369
385549,2,1,49,320,369
385619,1,999,957,816,1773
385619,2,1,865,778,1643
385619,4,3,92,38,130
386153,1,999,0,420,420
386153,2,1,0,420,420
386472,1,999,219,420,639
386472,2,1,219,420,639
387235,1,999,3,41,44
387235,2,1,3,41,44
387660,1,999,8,3,11
387660,2,1,8,3,11
387819,1,999,11,88,99
387819,2,1,11,88,99
387925,1,999,143,583,726
387925,2,1,143,583,726
388043,1,999,796,2739,3535
388043,2,1,796,2739,3535
388520,1,999,465,359,824
388520,2,1,465,359,824
388663,1,999,15,230,245
388663,2,1,15,230,245
389727,1,999,133,766,899
389727,2,1,133,766,899
389860,1,999,318,540,858
389860,2,1,318,540,858
390701,1,999,4445,14925,19370
390701,2,1,4359,14745,19104
390701,4,3,86,180,266
390905,1,999,125,185,310
390905,2,1,125,185,310
391005,1,999,13,408,421
391005,2,1,13,408,421
391333,1,999,10,75,85
391333,2,1,10,75,85
391546,1,999,27,191,218
391546,2,1,27,191,218
391564,1,999,72,605,677
391564,2,1,72,605,677
391582,1,999,156,1157,1313
391582,2,1,156,1157,1313
391759,1,999,6,71,77
391759,2,1,6,71,77
391810,1,999,30,93,123
391810,2,1,30,93,123
392257,1,999,113,286,399
392257,2,1,113,286,399
392354,1,999,9,6,15
392354,2,1,9,6,15
392415,1,999,133,774,907
392415,2,1,133,774,907
392798,1,999,2,106,108
392798,2,1,2,106,108
392840,1,999,206,216,422
392840,2,1,206,216,422
393180,1,999,449,561,1010
393180,2,1,449,561,1010
393524,1,999,38,232,270
393524,2,1,38,232,270
393649,1,999,270,5,275
393649,2,1,270,5,275
393861,1,999,76,297,373
393861,2,1,76,297,373
393977,1,999,3,104,107
393977,2,1,3,104,107
395362,1,999,1009,1823,2832
395362,2,1,1009,1823,2832
395690,1,999,368,496,864
395690,2,1,368,496,864
397270,1,999,28,67,95
397270,2,1,28,67,95
397641,1,999,481,49,530
397641,2,1,481,49,530
397942,1,999,125,180,305
397942,2,1,125,180,305
398130,1,999,496,158,654
398130,2,1,496,158,654
398574,1,999,3207,446,3653
398574,2,1,3207,446,3653
399212,1,999,14623,7033,21656
399212,2,1,14623,7033,21656
399869,1,999,922,200,1122
399869,2,1,922,200,1122
399911,1,999,158,280,438
399911,2,1,157,277,434
399911,4,3,1,3,4
400080,1,999,495,2375,2870
400080,2,1,495,2375,2870
400187,1,999,233,955,1188
400187,2,1,233,955,1188
400637,1,999,187,983,1170
400637,2,1,187,983,1170
401223,1,999,167,167,334
401223,2,1,53,92,145
401223,4,3,114,75,189
401250,1,999,49,136,185
401250,4,3,49,136,185
401339,1,999,347,208,555
401339,2,1,347,208,555
401481,1,999,2,183,185
401481,2,1,2,183,185
402563,1,999,25,579,604
402563,2,1,25,579,604
402615,1,999,491,1008,1499
402615,2,1,412,928,1340
402615,4,3,79,80,159
402776,1,999,147,199,346
402776,2,1,147,199,346
402800,1,999,20,482,502
402800,2,1,20,482,502
402828,1,999,289,324,613
402828,4,3,289,324,613
403414,1,999,1,31,32
403414,2,1,1,31,32
403469,1,999,4060,4871,8931
403469,2,1,4060,4871,8931
403478,1,999,1213,1037,2250
403478,2,1,1213,1037,2250
403487,1,999,13214,4490,17704
403487,2,1,13214,4490,17704
404037,1,999,1,19,20
404037,2,1,1,19,20
404055,1,999,170,640,810
404055,2,1,170,640,810
404073,1,999,1767,4485,6252
404073,2,1,1764,4459,6223
404073,4,3,3,26,29
404082,1,999,2644,6240,8884
404082,2,1,2642,6222,8864
404082,4,3,2,18,20
404222,1,999,91,122,213
404222,4,3,91,122,213
404338,1,999,362,226,588
404338,2,1,117,106,223
404338,4,3,245,120,365
404365,1,999,338,451,789
404365,2,1,338,451,789
404374,1,999,225,481,706
404374,2,1,225,481,706
404383,1,999,1044,434,1478
404383,2,1,1044,434,1478
404426,1,999,2822,3589,6411
404426,2,1,2822,3589,6411
404499,1,999,368,2286,2654
404499,2,1,368,2286,2654
404505,1,999,190,1449,1639
404505,2,1,190,1449,1639
404514,1,999,290,1706,1996
404514,2,1,290,1706,1996
404648,1,999,1037,2023,3060
404648,2,1,1036,2022,3058
404648,4,3,1,1,2
404684,1,999,278,534,812
404684,2,1,278,534,812
404718,1,999,9,122,131
404718,2,1,9,122,131
404806,1,999,195,568,763
404806,2,1,195,568,763
404912,1,999,336,1548,1884
404912,2,1,336,1548,1884
404921,1,999,528,956,1484
404921,2,1,528,956,1484
404994,1,999,2403,5125,7528
404994,2,1,2403,5125,7528
405003,1,999,3,46,49
405003,2,1,3,46,49
405012,1,999,7,111,118
405012,2,1,7,111,118
405021,1,999,6,92,98
405021,2,1,6,92,98
405058,1,999,151,0,151
405058,2,1,151,0,151
405076,1,999,62,352,414
405076,2,1,62,352,414
405748,1,999,83,44,127
405748,2,1,83,44,127
405854,1,999,170,0,170
405854,2,1,170,0,170
405872,1,999,2102,3340,5442
405872,2,1,2102,3340,5442
405979,1,999,1252,1773,3025
405979,2,1,944,1291,2235
405979,4,3,308,482,790
405988,1,999,1141,2129,3270
405988,2,1,690,1197,1887
405988,4,3,451,932,1383
405997,1,999,2557,3880,6437
405997,2,1,2212,3284,5496
405997,4,3,345,596,941
406006,1,999,1271,1867,3138
406006,2,1,1025,1544,2569
406006,4,3,246,323,569
406015,1,999,5112,9081,14193
406015,2,1,4185,7049,11234
406015,4,3,927,2032,2959
406024,1,999,123,544,667
406024,2,1,123,544,667
406033,1,999,141,902,1043
406033,2,1,141,902,1043
406051,1,999,4,89,93
406051,2,1,4,89,93
406060,1,999,30,76,106
406060,2,1,30,76,106
406149,1,999,29,75,104
406149,2,1,29,75,104
406194,1,999,626,463,1089
406194,2,1,626,463,1089
406200,1,999,482,2017,2499
406200,2,1,482,2017,2499
406219,1,999,484,872,1356
406219,2,1,484,872,1356
406264,1,999,336,1621,1957
406264,2,1,336,1621,1957
406325,1,999,12,159,171
406325,2,1,12,159,171
406361,1,999,23,80,103
406361,2,1,23,80,103
406413,1,999,26,182,208
406413,2,1,26,182,208
406422,1,999,9,127,136
406422,2,1,9,127,136
406486,1,999,22,70,92
406486,2,1,22,70,92
406495,1,999,16,199,215
406495,2,1,16,199,215
406547,1,999,154,706,860
406547,2,1,154,706,860
406556,1,999,6,27,33
406556,2,1,6,27,33
407054,1,999,67,251,318
407054,2,1,67,251,318
407063,1,999,957,208,1165
407063,2,1,957,208,1165
407090,1,999,18,388,406
407090,2,1,18,388,406
407142,1,999,6,133,139
407142,2,1,6,133,139
407151,1,999,8,148,156
407151,2,1,8,148,156
407179,1,999,22,330,352
407179,2,1,22,330,352
407285,1,999,302,686,988
407285,2,1,302,686,988
407319,1,999,943,284,1227
407319,2,1,943,284,1227
407328,1,999,43,270,313
407328,2,1,43,270,313
407355,1,999,15,482,497
407355,2,1,15,482,497
407391,1,999,34,216,250
407391,2,1,34,216,250
407407,1,999,18,179,197
407407,2,1,18,179,197
407425,1,999,17,303,320
407425,2,1,17,303,320
407434,1,999,8,152,160
407434,2,1,8,152,160
407452,1,999,121,59,180
407452,2,1,121,59,180
407461,1,999,148,121,269
407461,2,1,148,121,269
407470,1,999,6,80,86
407470,2,1,6,80,86
407489,1,999,98,103,201
407489,2,1,98,103,201
407504,1,999,353,863,1216
407504,2,1,353,863,1216
407513,1,999,209,225,434
407513,2,1,209,225,434
407522,1,999,17,59,76
407522,2,1,17,59,76
407568,1,999,2,83,85
407568,2,1,2,83,85
407577,1,999,202,230,432
407577,2,1,202,230,432
407595,1,999,56,206,262
407595,2,1,56,206,262
407601,1,999,17,16,33
407601,2,1,17,16,33
407629,1,999,1378,1400,2778
407629,4,3,1378,1400,2778
407683,1,999,13,221,234
407683,2,1,13,221,234
407708,1,999,25,581,606
407708,2,1,25,581,606
407726,1,999,18,168,186
407726,2,1,18,168,186
407735,1,999,31,246,277
407735,2,1,31,246,277
407744,1,999,1,101,102
407744,2,1,1,101,102
407832,1,999,492,280,772
407832,2,1,492,280,772
408039,1,999,788,2488,3276
408039,2,1,788,2488,3276
408057,1,999,4,160,164
408057,2,1,4,160,164
408066,1,999,17,178,195
408066,2,1,17,178,195
408163,1,999,10,107,117
408163,2,1,10,107,117
408312,1,999,6,112,118
408312,2,1,6,112,118
408385,1,999,92,326,418
408385,2,1,92,326,418
408394,1,999,933,372,1305
408394,2,1,933,372,1305
408437,1,999,6,30,36
408437,2,1,6,30,36
408844,1,999,1727,3508,5235
408844,2,1,1727,3508,5235
408862,1,999,14,247,261
408862,2,1,14,247,261
409032,1,999,27,617,644
409032,2,1,27,617,644
409069,1,999,1299,333,1632
409069,2,1,1299,333,1632
409120,1,999,73,167,240
409120,2,1,73,167,240
409166,1,999,9,153,162
409166,2,1,9,153,162
409193,1,999,755,14,769
409193,2,1,755,14,769
409209,1,999,10,141,151
409209,2,1,10,141,151
409245,1,999,0,30,30
409245,2,1,0,30,30
409254,1,999,9,344,353
409254,4,3,9,344,353
409315,1,999,15361,20808,36169
409315,2,1,15361,20808,36169
409333,1,999,69,71,140
409333,2,1,69,71,140
409537,1,999,48,77,125
409537,2,1,48,77,125
409591,1,999,99,198,297
409591,2,1,99,198,297
409616,1,999,277,292,569
409616,4,3,277,292,569
409670,1,999,833,1185,2018
409670,2,1,833,1185,2018
409698,1,999,1918,2893,4811
409698,2,1,1780,2573,4353
409698,4,3,138,320,458
409829,1,999,220,1438,1658
409829,2,1,220,1438,1658
409838,1,999,370,1138,1508
409838,2,1,370,1138,1508
409874,1,999,482,1411,1893
409874,2,1,482,1411,1893
410034,1,999,51,179,230
410034,2,1,51,179,230
410070,1,999,320,1015,1335
410070,2,1,320,1015,1335
410256,1,999,29,111,140
410256,2,1,29,111,140
410283,1,999,480,1727,2207
410283,2,1,480,1727,2207
410496,1,999,177,537,714
410496,2,1,177,537,714
410502,1,999,800,1211,2011
410502,2,1,800,1211,2011
410520,1,999,35,717,752
410520,2,1,35,717,752
410539,1,999,132,451,583
410539,2,1,132,451,583
410788,1,999,485,420,905
410788,2,1,485,420,905
410797,1,999,204,96,300
410797,2,1,204,96,300
410964,1,999,0,60,60
410964,2,1,0,60,60
411055,1,999,253,259,512
411055,2,1,253,259,512
411374,1,999,76,1034,1110
411374,2,1,76,1034,1110
411684,1,999,88,170,258
411684,2,1,88,170,258
411754,1,999,16,28,44
411754,2,1,16,28,44
412003,1,999,32,75,107
412003,2,1,32,75,107
412173,1,999,76,643,719
412173,2,1,76,643,719
412535,1,999,5,33,38
412535,2,1,5,33,38
412544,1,999,53,168,221
412544,2,1,53,168,221
412599,1,999,508,1380,1888
412599,2,1,508,1380,1888
412650,1,999,338,14,352
412650,2,1,338,14,352
413176,1,999,14,17,31
413176,2,1,14,17,31
413185,1,999,44,12,56
413185,2,1,44,12,56
413343,1,999,4,38,42
413343,2,1,4,38,42
413413,1,999,16458,41008,57466
413413,2,1,5502,8056,13558
413413,4,3,10956,32952,43908
413617,1,999,284,619,903
413617,2,1,284,619,903
413626,1,999,125,202,327
413626,2,1,125,202,327
413635,1,999,259,901,1160
413635,2,1,259,901,1160
413644,1,999,24,83,107
413644,4,3,24,83,107
413680,1,999,639,39,678
413680,2,1,639,39,678
413778,1,999,53,491,544
413778,2,1,53,491,544
413802,1,999,380,336,716
413802,2,1,380,336,716
413820,1,999,0,41,41
413820,2,1,0,41,41
413839,1,999,956,389,1345
413839,2,1,956,389,1345
413848,1,999,630,220,850
413848,2,1,630,220,850
413857,1,999,1511,372,1883
413857,2,1,1511,372,1883
413866,1,999,994,307,1301
413866,2,1,994,307,1301
413884,1,999,1255,542,1797
413884,2,1,1255,542,1797
413918,1,999,15,17,32
413918,2,1,15,17,32
413945,1,999,63,136,199
413945,2,1,63,136,199
413972,1,999,13,177,190
413972,2,1,13,177,190
414036,1,999,221,158,379
414036,2,1,221,158,379
414054,1,999,1,89,90
414054,2,1,1,89,90
414063,1,999,12,278,290
414063,2,1,12,278,290
414124,1,999,210,113,323
414124,2,1,210,113,323
414160,1,999,960,2590,3550
414160,2,1,957,2585,3542
414160,4,3,3,5,8
414452,1,999,5,58,63
414452,2,1,5,58,63
414461,1,999,4393,535,4928
414461,2,1,4393,535,4928
414489,1,999,9,164,173
414489,2,1,9,164,173
414531,1,999,869,225,1094
414531,2,1,869,225,1094
414540,1,999,16,382,398
414540,2,1,16,382,398
414559,1,999,2,47,49
414559,2,1,2,47,49
414568,1,999,1518,549,2067
414568,2,1,1518,549,2067
414586,1,999,759,210,969
414586,2,1,759,210,969
414595,1,999,191,496,687
414595,2,1,28,44,72
414595,4,3,163,452,615
414708,1,999,3358,5923,9281
414708,2,1,2853,5057,7910
414708,4,3,505,866,1371
414823,1,999,1024,1259,2283
414823,2,1,1024,1259,2283
414841,1,999,687,136,823
414841,2,1,687,136,823
414850,1,999,71,743,814
414850,2,1,71,743,814
414869,1,999,7,195,202
414869,2,1,7,195,202
414878,1,999,82,162,244
414878,2,1,81,151,232
414878,4,3,1,11,12
414911,1,999,1534,2168,3702
414911,2,1,1534,2168,3702
414939,1,999,31,198,229
414939,2,1,31,198,229
414966,1,999,99,95,194
414966,4,3,99,95,194
415039,1,999,5,200,205
415039,2,1,5,200,205
415057,1,999,203,3,206
415057,2,1,203,3,206
415729,1,999,14,58,72
415729,2,1,14,58,72
415774,1,999,203,1384,1587
415774,2,1,203,1384,1587
415987,1,999,84,909,993
415987,2,1,84,909,993
416458,1,999,223,581,804
416458,2,1,223,581,804
416670,1,999,3,140,143
416670,2,1,3,140,143
416801,1,999,90,124,214
416801,2,1,90,124,214
416962,1,999,1282,2535,3817
416962,2,1,1005,1836,2841
416962,4,3,277,699,976
416971,1,999,2,82,84
416971,2,1,2,82,84
416980,1,999,5,113,118
416980,2,1,5,113,118
417008,1,999,5,78,83
417008,2,1,5,78,83
417062,1,999,10,181,191
417062,2,1,10,181,191
417105,1,999,604,876,1480
417105,2,1,604,876,1480
417123,1,999,183,219,402
417123,2,1,183,219,402
417132,1,999,28,773,801
417132,2,1,28,773,801
417150,1,999,9,29,38
417150,2,1,9,29,38
417178,1,999,9,52,61
417178,2,1,9,52,61
417187,1,999,4,36,40
417187,2,1,4,36,40
417211,1,999,3,19,22
417211,2,1,3,19,22
417248,1,999,38,29,67
417248,2,1,38,29,67
417257,1,999,4,26,30
417257,2,1,4,26,30
417275,1,999,0,17,17
417275,2,1,0,17,17
417318,1,999,18,47,65
417318,2,1,18,47,65
417327,1,999,186,338,524
417327,2,1,186,338,524
417345,1,999,0,12,12
417345,4,3,0,12,12
417381,1,999,42,294,336
417381,2,1,42,294,336
417390,1,999,12,121,133
417390,2,1,12,121,133
417406,1,999,1,64,65
417406,2,1,1,64,65
417442,1,999,18,176,194
417442,2,1,18,176,194
417503,1,999,20,380,400
417503,2,1,20,380,400
417549,1,999,15,511,526
417549,2,1,15,511,526
417567,1,999,8,189,197
417567,2,1,8,189,197
417576,1,999,8,139,147
417576,2,1,8,139,147
417600,1,999,4,33,37
417600,2,1,4,33,37
417628,1,999,31,80,111
417628,2,1,31,80,111
417637,1,999,62,111,173
417637,2,1,62,111,173
417646,1,999,3,33,36
417646,2,1,3,33,36
417655,1,999,2,38,40
417655,2,1,2,38,40
417673,1,999,6,55,61
417673,2,1,6,55,61
417682,1,999,0,28,28
417682,2,1,0,28,28
417716,1,999,14,130,144
417716,2,1,14,130,144
417725,1,999,4,155,159
417725,2,1,4,155,159
417734,1,999,44,216,260
417734,2,1,44,216,260
417752,1,999,54,47,101
417752,2,1,54,47,101
417789,1,999,4,213,217
417789,2,1,4,213,217
417804,1,999,18,179,197
417804,2,1,18,179,197
417831,1,999,110,32,142
417831,2,1,110,32,142
417840,1,999,49,492,541
417840,2,1,49,492,541
417868,1,999,5,30,35
417868,2,1,5,30,35
417886,1,999,11,102,113
417886,2,1,11,102,113
417901,1,999,5,7,12
417901,2,1,5,7,12
417910,1,999,38,162,200
417910,2,1,38,162,200
417947,1,999,10,30,40
417947,2,1,10,30,40
417983,1,999,12,109,121
417983,2,1,12,109,121
417992,1,999,7,102,109
417992,2,1,7,102,109
418001,1,999,17,137,154
418001,2,1,17,137,154
418010,1,999,2,68,70
418010,2,1,2,68,70
418029,1,999,11,133,144
418029,2,1,11,133,144
418038,1,999,36,120,156
418038,2,1,36,120,156
418056,1,999,30,162,192
418056,2,1,30,162,192
418065,1,999,63,489,552
418065,2,1,63,489,552
418083,1,999,20,87,107
418083,2,1,20,87,107
418126,1,999,342,771,1113
418126,2,1,307,716,1023
418126,4,3,35,55,90
418162,1,999,849,528,1377
418162,2,1,849,528,1377
418171,1,999,60,1,61
418171,2,1,60,1,61
418199,1,999,114,65,179
418199,2,1,114,65,179
418205,1,999,704,911,1615
418205,2,1,704,911,1615
418223,1,999,7,68,75
418223,2,1,7,68,75
418250,1,999,243,122,365
418250,2,1,243,122,365
418269,1,999,89,63,152
418269,2,1,89,63,152
418278,1,999,54,214,268
418278,2,1,54,214,268
418287,1,999,301,308,609
418287,2,1,301,308,609
418296,1,999,479,298,777
418296,2,1,479,298,777
418302,1,999,287,309,596
418302,2,1,287,309,596
418320,1,999,453,423,876
418320,2,1,453,423,876
418339,1,999,182,160,342
418339,2,1,182,160,342
418348,1,999,448,235,683
418348,2,1,448,235,683
418357,1,999,116,186,302
418357,2,1,116,186,302
418384,1,999,5,40,45
418384,2,1,5,40,45
418409,1,999,46,86,132
418409,2,1,46,86,132
418427,1,999,28,190,218
418427,2,1,28,190,218
418445,1,999,0,46,46
418445,2,1,0,46,46
418454,1,999,249,273,522
418454,2,1,249,273,522
418481,1,999,2,56,58
418481,2,1,2,56,58
418506,1,999,3,40,43
418506,2,1,3,40,43
418515,1,999,32,170,202
418515,2,1,32,170,202
418524,1,999,12,61,73
418524,2,1,12,61,73
418533,1,999,102,442,544
418533,2,1,102,442,544
418542,1,999,14,88,102
418542,2,1,14,88,102
418560,1,999,44,166,210
418560,2,1,44,166,210
418588,1,999,1,38,39
418588,2,1,1,38,39
418603,1,999,14,62,76
418603,2,1,14,62,76
418612,1,999,4,40,44
418612,2,1,4,40,44
418658,1,999,318,15,333
418658,2,1,318,15,333
418676,1,999,21,61,82
418676,2,1,21,61,82
418700,1,999,161,386,547
418700,2,1,161,386,547
418755,1,999,33,122,155
418755,2,1,33,122,155
418764,1,999,47,114,161
418764,2,1,47,114,161
418773,1,999,575,1014,1589
418773,2,1,575,1014,1589
418782,1,999,315,5,320
418782,2,1,315,5,320
418870,1,999,155,723,878
418870,2,1,155,723,878
418889,1,999,226,15,241
418889,2,1,226,15,241
418913,1,999,5,85,90
418913,2,1,5,85,90
418968,1,999,17,268,285
418968,2,1,17,268,285
419022,1,999,84,762,846
419022,2,1,84,762,846
419031,1,999,3,24,27
419031,2,1,3,24,27
419095,1,999,7,53,60
419095,2,1,7,53,60
419147,1,999,1,65,66
419147,2,1,1,65,66
419156,1,999,6,143,149
419156,2,1,6,143,149
419183,1,999,91,241,332
419183,2,1,91,241,332
419217,1,999,34,87,121
419217,2,1,34,87,121
419226,1,999,495,465,960
419226,2,1,495,465,960
419235,1,999,88,290,378
419235,2,1,88,290,378
419244,1,999,311,17,328
419244,2,1,311,17,328
419253,1,999,370,129,499
419253,2,1,370,129,499
419262,1,999,10,74,84
419262,2,1,10,74,84
419271,1,999,2,40,42
419271,2,1,2,40,42
419280,1,999,2,59,61
419280,2,1,2,59,61
419314,1,999,0,37,37
419314,2,1,0,37,37
419332,1,999,17,1,18
419332,2,1,17,1,18
419341,1,999,84,54,138
419341,2,1,84,54,138
419411,1,999,152,385,537
419411,2,1,152,385,537
419420,1,999,52,50,102
419420,2,1,52,50,102
419439,1,999,1,66,67
419439,2,1,1,66,67
419457,1,999,378,1279,1657
419457,2,1,31,108,139
419457,4,3,347,1171,1518
419484,1,999,3,25,28
419484,2,1,3,25,28
419509,1,999,1782,3373,5155
419509,2,1,1480,2829,4309
419509,4,3,302,544,846
419572,1,999,88,139,227
419572,2,1,88,139,227
419633,1,999,8,79,87
419633,2,1,8,79,87
419660,1,999,338,966,1304
419660,2,1,338,966,1304
419703,1,999,789,15,804
419703,2,1,789,15,804
419712,1,999,363,10,373
419712,2,1,363,10,373
419721,1,999,387,11,398
419721,2,1,387,11,398
420006,1,999,435,1321,1756
420006,2,1,417,1292,1709
420006,4,3,18,29,47
420024,1,999,44,170,214
420024,2,1,44,170,214
420042,1,999,619,896,1515
420042,2,1,505,718,1223
420042,4,3,114,178,292
420103,1,999,117,473,590
420103,2,1,117,473,590
420130,1,999,79,619,698
420130,2,1,79,619,698
420194,1,999,11,339,350
420194,2,1,11,339,350
420200,1,999,2,195,197
420200,2,1,2,195,197
420246,1,999,116,315,431
420246,4,3,116,315,431
420255,1,999,107,1,108
420255,2,1,107,1,108
420307,1,999,2430,13025,15455
420307,2,1,2353,12854,15207
420307,4,3,77,171,248
420316,1,999,436,1222,1658
420316,2,1,436,1222,1658
420325,1,999,76,0,76
420325,2,1,73,0,73
420325,4,3,3,0,3
420343,1,999,1376,34,1410
420343,2,1,1376,34,1410
420352,1,999,45,21,66
420352,2,1,45,21,66
420370,1,999,246,356,602
420370,2,1,246,356,602
420398,1,999,8321,9797,18118
420398,2,1,8321,9797,18118
420404,1,999,1131,227,1358
420404,2,1,1131,227,1358
420431,1,999,767,1009,1776
420431,2,1,767,1009,1776
420440,1,999,818,1264,2082
420440,2,1,818,1264,2082
420459,1,999,292,230,522
420459,2,1,292,230,522
420468,1,999,137,342,479
420468,2,1,137,342,479
420495,1,999,299,2239,2538
420495,2,1,299,2239,2538
420501,1,999,397,2178,2575
420501,2,1,397,2178,2575
420538,1,999,760,1336,2096
420538,2,1,760,1336,2096
420556,1,999,756,1255,2011
420556,2,1,756,1255,2011
420608,1,999,16,356,372
420608,2,1,16,356,372
420705,1,999,244,89,333
420705,4,3,244,89,333
420723,1,999,290,394,684
420723,2,1,290,394,684
420866,1,999,303,778,1081
420866,2,1,87,204,291
420866,4,3,216,574,790
420981,1,999,121,585,706
420981,2,1,121,585,706
421009,1,999,835,2327,3162
421009,2,1,709,1967,2676
421009,4,3,126,360,486
421018,1,999,1176,2235,3411
421018,2,1,1041,1855,2896
421018,4,3,135,380,515
421513,1,999,118,524,642
421513,2,1,118,524,642
421540,1,999,149,107,256
421540,2,1,149,107,256
421559,1,999,69,86,155
421559,2,1,69,86,155
421586,1,999,69,86,155
421586,2,1,69,86,155
421610,1,999,2,48,50
421610,2,1,2,48,50
421665,1,999,3,26,29
421665,2,1,3,26,29
421708,1,999,92,1132,1224
421708,2,1,92,1132,1224
421717,1,999,11,27,38
421717,2,1,11,27,38
421771,1,999,8,66,74
421771,2,1,8,66,74
421832,1,999,422,137,559
421832,2,1,422,137,559
421841,1,999,147,184,331
421841,2,1,147,184,331
421878,1,999,35,294,329
421878,2,1,35,294,329
421896,1,999,132,258,390
421896,2,1,132,258,390
422020,1,999,116,4,120
422020,2,1,116,4,120
422190,1,999,11,138,149
422190,2,1,11,138,149
422695,1,999,43,250,293
422695,2,1,43,250,293
422835,1,999,61,298,359
422835,2,1,61,298,359
423120,1,999,56,1168,1224
423120,2,1,56,1168,1224
423397,1,999,95,1,96
423397,2,1,95,1,96
423412,1,999,108,8,116
423412,2,1,108,8,116
423476,1,999,128,221,349
423476,2,1,128,221,349
423582,1,999,78,348,426
423582,2,1,78,348,426
423643,1,999,1120,1068,2188
423643,2,1,6,5,11
423643,4,3,1114,1063,2177
423652,1,999,347,664,1011
423652,2,1,347,664,1011
423670,1,999,53,283,336
423670,2,1,53,283,336
423980,1,999,1922,1718,3640
423980,2,1,1922,1718,3640
424424,1,999,141,330,471
424424,2,1,141,330,471
425250,1,999,45,188,233
425250,2,1,45,188,233
425393,1,999,7,11,18
425393,2,1,7,11,18
425870,1,999,10,31,41
425870,2,1,10,31,41
425889,1,999,162,1147,1309
425889,2,1,162,1147,1309
425986,1,999,52,401,453
425986,2,1,52,401,453
426314,1,999,18692,6804,25496
426314,2,1,13542,5045,18587
426314,4,3,5150,1759,6909
427025,1,999,762,1260,2022
427025,2,1,762,1260,2022
427308,1,999,55,206,261
427308,2,1,55,206,261
427335,1,999,2,81,83
427335,2,1,2,81,83
427663,1,999,762,182,944
427663,2,1,762,182,944
427894,1,999,213,64,277
427894,2,1,213,64,277
427919,1,999,108,221,329
427919,2,1,108,221,329
427973,1,999,305,21,326
427973,2,1,305,21,326
427982,1,999,55,248,303
427982,2,1,55,248,303
427991,1,999,674,381,1055
427991,2,1,674,381,1055
428000,1,999,141,136,277
428000,2,1,141,136,277
428019,1,999,182,152,334
428019,2,1,182,152,334
428037,1,999,44,2,46
428037,2,1,44,2,46
428055,1,999,74,366,440
428055,2,1,74,366,440
428073,1,999,1,30,31
428073,2,1,1,30,31
428125,1,999,82,20,102
428125,2,1,82,20,102
428143,1,999,13,221,234
428143,2,1,13,221,234
428170,1,999,783,2270,3053
428170,2,1,783,2270,3053
428259,1,999,194,491,685
428259,2,1,159,422,581
428259,4,3,35,69,104
428268,1,999,235,777,1012
428268,2,1,25,111,136
428268,4,3,210,666,876
428286,1,999,861,902,1763
428286,2,1,861,902,1763
428295,1,999,270,14,284
428295,2,1,270,14,284
428329,1,999,36,163,199
428329,2,1,36,163,199
428338,1,999,106,100,206
428338,4,3,106,100,206
428392,1,999,1021,1525,2546
428392,2,1,1021,1525,2546
428444,1,999,859,861,1720
428444,2,1,859,861,1720
429085,1,999,44,88,132
429085,4,3,44,88,132
429094,1,999,60,183,243
429094,4,3,60,183,243
429100,1,999,9,137,146
429100,2,1,9,137,146
429128,1,999,49,919,968
429128,2,1,49,919,968
429599,1,999,1486,467,1953
429599,2,1,1486,467,1953
430050,1,999,142,512,654
430050,2,1,142,512,654
430087,1,999,739,519,1258
430087,2,1,558,417,975
430087,4,3,181,102,283
430096,1,999,336,884,1220
430096,2,1,336,884,1220
430102,1,999,39,122,161
430102,2,1,34,102,136
430102,4,3,5,20,25
430148,1,999,547,970,1517
430148,2,1,547,970,1517
430157,1,999,425,6,431
430157,2,1,425,6,431
430166,1,999,419,5,424
430166,2,1,419,5,424
430175,1,999,379,1375,1754
430175,2,1,379,1375,1754
430184,1,999,2778,5534,8312
430184,2,1,2139,4195,6334
430184,4,3,639,1339,1978
430218,1,999,76,199,275
430218,2,1,76,199,275
430227,1,999,46,263,309
430227,2,1,46,263,309
430245,1,999,111,685,796
430245,2,1,111,685,796
430254,1,999,59,279,338
430254,2,1,59,279,338
430263,1,999,1226,365,1591
430263,2,1,1226,365,1591
430306,1,999,13,78,91
430306,2,1,13,78,91
430342,1,999,208,195,403
430342,2,1,208,195,403
430351,1,999,697,195,892
430351,2,1,697,195,892
430360,1,999,499,121,620
430360,2,1,499,121,620
430379,1,999,1160,381,1541
430379,2,1,1160,381,1541
430388,1,999,805,206,1011
430388,2,1,805,206,1011
430403,1,999,70,483,553
430403,2,1,70,483,553
430421,1,999,177,1160,1337
430421,2,1,177,1160,1337
430485,1,999,52,77,129
430485,2,1,52,77,129
430500,1,999,6,0,6
430500,2,1,6,0,6
430564,1,999,38,228,266
430564,2,1,38,228,266
430582,1,999,102,231,333
430582,2,1,102,231,333
430591,1,999,92,259,351
430591,4,3,92,259,351
430670,1,999,129,143,272
430670,4,3,129,143,272
430704,1,999,37,58,95
430704,4,3,37,58,95
430795,1,999,134,139,273
430795,2,1,134,139,273
430810,1,999,145,315,460
430810,2,1,145,315,460
430847,1,999,13,77,90
430847,2,1,13,77,90
430883,1,999,3,64,67
430883,2,1,3,64,67
430908,1,999,6,83,89
430908,2,1,6,83,89
430935,1,999,672,78,750
430935,2,1,672,78,750
430971,1,999,16,102,118
430971,2,1,16,102,118
430980,1,999,241,270,511
430980,2,1,241,270,511
430999,1,999,48,220,268
430999,2,1,48,220,268
431017,1,999,45,66,111
431017,2,1,45,66,111
431026,1,999,552,639,1191
431026,2,1,552,639,1191
431071,1,999,39,156,195
431071,2,1,39,156,195
431099,1,999,11,249,260
431099,2,1,11,249,260
431105,1,999,26,134,160
431105,2,1,26,134,160
431123,1,999,534,7,541
431123,2,1,534,7,541
431141,1,999,1919,1930,3849
431141,2,1,1919,1930,3849
431169,1,999,47,100,147
431169,2,1,47,100,147
431187,1,999,34,2,36
431187,2,1,34,2,36
431196,1,999,16,162,178
431196,2,1,16,162,178
431202,1,999,4,34,38
431202,2,1,4,34,38
431248,1,999,3,16,19
431248,4,3,3,16,19
431266,1,999,4,53,57
431266,2,1,4,53,57
431275,1,999,10,112,122
431275,2,1,10,112,122
431284,1,999,18,76,94
431284,2,1,18,76,94
431309,1,999,532,519,1051
431309,2,1,532,519,1051
431558,1,999,137,307,444
431558,2,1,137,307,444
431594,1,999,0,10,10
431594,4,3,0,10,10
431600,1,999,12,124,136
431600,2,1,12,124,136
431637,1,999,371,711,1082
431637,2,1,371,711,1082
431691,1,999,12,25,37
431691,2,1,12,25,37
431707,1,999,0,30,30
431707,2,1,0,30,30
431716,1,999,323,291,614
431716,2,1,323,291,614
431770,1,999,5,68,73
431770,2,1,5,68,73
431877,1,999,8,43,51
431877,2,1,8,43,51
431886,1,999,319,1379,1698
431886,2,1,319,1379,1698
431929,1,999,82,250,332
431929,2,1,82,250,332
431956,1,999,19,95,114
431956,2,1,19,95,114
431965,1,999,14,122,136
431965,2,1,14,122,136
431983,1,999,102,0,102
431983,2,1,102,0,102
432074,1,999,100,148,248
432074,2,1,100,148,248
432117,1,999,11,215,226
432117,2,1,11,215,226
432199,1,999,2272,1260,3532
432199,2,1,1667,685,2352
432199,4,3,605,575,1180
432214,1,999,600,658,1258
432214,2,1,423,370,793
432214,4,3,177,288,465
432223,1,999,504,584,1088
432223,2,1,406,498,904
432223,4,3,98,86,184
432232,1,999,799,1367,2166
432232,2,1,642,1126,1768
432232,4,3,157,241,398
432241,1,999,717,941,1658
432241,2,1,577,789,1366
432241,4,3,140,152,292
432269,1,999,197,70,267
432269,2,1,197,70,267
432302,1,999,403,1108,1511
432302,2,1,403,1108,1511
432348,1,999,213,125,338
432348,4,3,213,125,338
432357,1,999,82,310,392
432357,4,3,82,310,392
432384,1,999,248,471,719
432384,2,1,248,471,719
432524,1,999,99,140,239
432524,2,1,99,140,239
432533,1,999,1833,1103,2936
432533,2,1,1833,1103,2936
433004,1,999,39,76,115
433004,2,1,39,74,113
433004,4,3,0,2,2
433013,1,999,376,741,1117
433013,2,1,376,741,1117
433040,1,999,6,26,32
433040,2,1,6,26,32
433068,1,999,250,290,540
433068,2,1,250,290,540
433101,1,999,321,1715,2036
433101,2,1,321,1715,2036
433138,1,999,264,413,677
433138,2,1,264,413,677
433165,1,999,1,4,5
433165,2,1,1,4,5
433174,1,999,95,627,722
433174,2,1,95,627,722
433217,1,999,1,6,7
433217,4,3,1,6,7
433387,1,999,7545,11854,19399
433387,2,1,5999,8726,14725
433387,4,3,1546,3128,4674
433420,1,999,135,612,747
433420,2,1,135,612,747
433466,1,999,215,859,1074
433466,2,1,215,859,1074
433536,1,999,95,509,604
433536,2,1,95,509,604
433563,1,999,463,637,1100
433563,2,1,463,637,1100
433660,1,999,5462,7593,13055
433660,2,1,4848,6224,11072
433660,4,3,614,1369,1983
433970,1,999,93,711,804
433970,2,1,93,711,804
434016,1,999,67,150,217
434016,2,1,67,150,217
434034,1,999,1114,250,1364
434034,2,1,1114,250,1364
434052,1,999,1111,241,1352
434052,2,1,1111,241,1352
434061,1,999,2847,3379,6226
434061,2,1,2847,3379,6226
434122,1,999,15,3,18
434122,2,1,15,3,18
434140,1,999,474,1256,1730
434140,2,1,474,1256,1730
434159,1,999,549,579,1128
434159,2,1,549,579,1128
434274,1,999,16,134,150
434274,2,1,16,134,150
434283,1,999,12,66,78
434283,2,1,12,66,78
434308,1,999,269,902,1171
434308,2,1,269,902,1171
434317,1,999,298,1138,1436
434317,2,1,298,1138,1436
434326,1,999,7,94,101
434326,2,1,7,94,101
434344,1,999,0,23,23
434344,2,1,0,23,23
434362,1,999,62,2,64
434362,2,1,62,2,64
434371,1,999,25,120,145
434371,2,1,25,120,145
434380,1,999,20,59,79
434380,2,1,20,59,79
434414,1,999,140,254,394
434414,2,1,140,254,394
434432,1,999,14,55,69
434432,2,1,14,55,69
434441,1,999,43,104,147
434441,4,3,43,104,147
434469,1,999,67,114,181
434469,2,1,67,114,181
434496,1,999,6,114,120
434496,2,1,6,114,120
434502,1,999,17,150,167
434502,2,1,17,150,167
434520,1,999,292,876,1168
434520,2,1,292,876,1168
434539,1,999,312,324,636
434539,2,1,312,324,636
434548,1,999,1208,286,1494
434548,2,1,1208,286,1494
434557,1,999,653,160,813
434557,2,1,653,160,813
434566,1,999,906,163,1069
434566,2,1,906,163,1069
434575,1,999,638,101,739
434575,2,1,638,101,739
434584,1,999,317,362,679
434584,2,1,317,362,679
434672,1,999,13073,20764,33837
434672,2,1,13073,20764,33837
434690,1,999,540,7,547
434690,2,1,540,7,547
434715,1,999,913,814,1727
434715,4,3,913,814,1727
434751,1,999,58,110,168
434751,2,1,58,110,168
434812,1,999,13,189,202
434812,2,1,13,189,202
434821,1,999,60,461,521
434821,2,1,60,461,521
434830,1,999,13,290,303
434830,2,1,13,290,303
434900,1,999,925,800,1725
434900,2,1,925,800,1725
434937,1,999,63,0,63
434937,2,1,63,0,63
434946,1,999,896,2081,2977
434946,2,1,694,1642,2336
434946,4,3,202,439,641
434955,1,999,741,1123,1864
434955,2,1,602,912,1514
434955,4,3,139,211,350
434964,1,999,553,714,1267
434964,2,1,421,583,1004
434964,4,3,132,131,263
434973,1,999,393,519,912
434973,2,1,329,453,782
434973,4,3,64,66,130
434982,1,999,361,854,1215
434982,2,1,324,774,1098
434982,4,3,37,80,117
434991,1,999,410,676,1086
434991,2,1,370,617,987
434991,4,3,40,59,99
435000,1,999,394,556,950
435000,2,1,25,91,116
435000,4,3,369,465,834
436003,1,999,31,250,281
436003,2,1,31,250,281
436012,1,999,97,985,1082
436012,2,1,97,985,1082
436021,1,999,6,37,43
436021,4,3,6,37,43
436067,1,999,4,60,64
436067,2,1,4,60,64
436094,1,999,329,868,1197
436094,2,1,55,155,210
436094,4,3,274,713,987
436100,1,999,1,44,45
436100,2,1,1,44,45
436182,1,999,124,431,555
436182,2,1,124,431,555
436191,1,999,938,386,1324
436191,2,1,938,386,1324
436225,1,999,236,827,1063
436225,2,1,236,827,1063
436261,1,999,39,103,142
436261,4,3,39,103,142
436270,1,999,98,246,344
436270,2,1,98,246,344
436289,1,999,8,101,109
436289,2,1,8,101,109
436304,1,999,1154,1642,2796
436304,2,1,1154,1642,2796
436429,1,999,1150,189,1339
436429,2,1,1150,189,1339
436438,1,999,455,914,1369
436438,2,1,116,190,306
436438,4,3,339,724,1063
436465,1,999,737,564,1301
436465,2,1,737,564,1301
436483,1,999,204,568,772
436483,2,1,204,568,772
436526,1,999,257,34,291
436526,2,1,257,34,291
436553,1,999,176,400,576
436553,2,1,176,400,576
436562,1,999,53,371,424
436562,2,1,53,371,424
436599,1,999,58,36,94
436599,2,1,58,36,94
436614,1,999,51,60,111
436614,2,1,38,53,91
436614,4,3,13,7,20
436632,1,999,36,182,218
436632,2,1,36,182,218
436641,1,999,16,198,214
436641,2,1,16,198,214
436650,1,999,52,548,600
436650,2,1,52,548,600
436702,1,999,82,308,390
436702,2,1,82,308,390
436775,1,999,52,244,296
436775,2,1,52,244,296
436784,1,999,512,751,1263
436784,2,1,512,751,1263
436818,1,999,1447,1577,3024
436818,2,1,1447,1577,3024
436827,1,999,434,417,851
436827,2,1,434,417,851
436836,1,999,778,930,1708
436836,2,1,778,930,1708
436854,1,999,10,76,86
436854,2,1,10,76,86
437042,1,999,1090,420,1510
437042,2,1,1090,420,1510
437051,1,999,1107,388,1495
437051,2,1,1107,388,1495
437060,1,999,303,322,625
437060,2,1,303,322,625
437103,1,999,5561,7981,13542
437103,2,1,5561,7981,13542
437219,1,999,957,284,1241
437219,2,1,957,284,1241
437237,1,999,61,2,63
437237,2,1,61,2,63
437316,1,999,47,341,388
437316,2,1,47,341,388
437325,1,999,205,555,760
437325,2,1,167,521,688
437325,4,3,38,34,72
437501,1,999,62,195,257
437501,2,1,62,195,257
437529,1,999,320,345,665
437529,2,1,320,345,665
437556,1,999,516,650,1166
437556,2,1,516,650,1166
437565,1,999,33,289,322
437565,2,1,33,289,322
437583,1,999,14,250,264
437583,2,1,14,250,264
437608,1,999,52,67,119
437608,2,1,52,67,119
437635,1,999,69,177,246
437635,2,1,69,177,246
437653,1,999,153,159,312
437653,2,1,153,159,312
437662,1,999,1805,3419,5224
437662,2,1,1805,3419,5224
437705,1,999,0,20,20
437705,2,1,0,20,20
437723,1,999,121,273,394
437723,2,1,121,273,394
437732,1,999,163,792,955
437732,2,1,163,792,955
437750,1,999,660,27,687
437750,2,1,660,27,687
437769,1,999,94,906,1000
437769,2,1,94,906,1000
437778,1,999,53,441,494
437778,2,1,53,441,494
437848,1,999,1061,930,1991
437848,2,1,1061,930,1991
437857,1,999,3,260,263
437857,2,1,3,260,263
437884,1,999,81,29,110
437884,2,1,81,29,110
437927,1,999,141,781,922
437927,2,1,141,781,922
437936,1,999,349,1317,1666
437936,2,1,349,1317,1666
438036,1,999,122,71,193
438036,2,1,122,71,193
438151,1,999,669,1029,1698
438151,2,1,578,946,1524
438151,4,3,91,83,174
438179,1,999,381,986,1367
438179,2,1,381,986,1367
438197,1,999,190,1891,2081
438197,2,1,190,1891,2081
438212,1,999,2277,6043,8320
438212,2,1,2277,6043,8320
438258,1,999,176,826,1002
438258,2,1,176,826,1002
438267,1,999,191,360,551
438267,2,1,191,360,551
438285,1,999,157,706,863
438285,2,1,157,706,863
438294,1,999,103,353,456
438294,2,1,103,353,456
438337,1,999,144,308,452
438337,2,1,144,308,452
438382,1,999,392,549,941
438382,2,1,282,328,610
438382,4,3,110,221,331
438416,1,999,377,617,994
438416,2,1,362,586,948
438416,4,3,15,31,46
438498,1,999,1452,1118,2570
438498,2,1,540,793,1333
438498,4,3,912,325,1237
438504,1,999,3152,63,3215
438504,2,1,3152,63,3215
438586,1,999,1343,1854,3197
438586,2,1,1216,1640,2856
438586,4,3,127,214,341
438601,1,999,606,780,1386
438601,2,1,528,670,1198
438601,4,3,78,110,188
438610,1,999,444,819,1263
438610,2,1,408,759,1167
438610,4,3,36,60,96
438629,1,999,109,127,236
438629,2,1,94,110,204
438629,4,3,15,17,32
438638,1,999,942,1873,2815
438638,2,1,942,1873,2815
438647,1,999,573,1314,1887
438647,2,1,573,1314,1887
438656,1,999,354,1804,2158
438656,2,1,354,1804,2158
438674,1,999,5,147,152
438674,2,1,5,147,152
438708,1,999,249,627,876
438708,2,1,249,627,876
438735,1,999,183,18,201
438735,2,1,183,18,201
438805,1,999,657,1081,1738
438805,2,1,657,1081,1738
438869,1,999,160,745,905
438869,2,1,160,745,905
438887,1,999,84,427,511
438887,2,1,84,427,511
438902,1,999,716,1864,2580
438902,2,1,693,1810,2503
438902,4,3,23,54,77
438966,1,999,160,736,896
438966,2,1,160,736,896
438984,1,999,136,97,233
438984,2,1,136,97,233
439020,1,999,68,137,205
439020,4,3,68,137,205
439039,1,999,226,551,777
439039,2,1,226,551,777
439057,1,999,269,471,740
439057,2,1,71,89,160
439057,4,3,198,382,580
439118,1,999,227,1166,1393
439118,2,1,227,1166,1393
439127,1,999,143,652,795
439127,2,1,143,652,795
439136,1,999,885,97,982
439136,2,1,885,97,982
439145,1,999,2124,3307,5431
439145,2,1,2124,3307,5431
439163,1,999,4506,3237,7743
439163,2,1,3795,2435,6230
439163,4,3,711,802,1513
439190,1,999,2071,2008,4079
439190,2,1,2071,2008,4079
439279,1,999,392,704,1096
439279,2,1,364,659,1023
439279,4,3,28,45,73
439288,1,999,773,920,1693
439288,2,1,773,920,1693
439297,1,999,259,515,774
439297,2,1,223,440,663
439297,4,3,36,75,111
439303,1,999,18,83,101
439303,2,1,18,83,101
439312,1,999,17,64,81
439312,2,1,17,64,81
439330,1,999,152,134,286
439330,2,1,74,59,133
439330,4,3,78,75,153
439367,1,999,165,402,567
439367,2,1,165,402,567
439394,1,999,35,91,126
439394,4,3,35,91,126
439400,1,999,81,50,131
439400,2,1,81,50,131
439437,1,999,102,677,779
439437,2,1,102,677,779
439446,1,999,34,89,123
439446,2,1,8,11,19
439446,4,3,26,78,104
439455,1,999,41,648,689
439455,2,1,41,648,689
439473,1,999,59,193,252
439473,2,1,59,193,252
439482,1,999,25,275,300
439482,2,1,25,275,300
439491,1,999,35,117,152
439491,2,1,35,117,152
439507,1,999,112,492,604
439507,2,1,112,492,604
439525,1,999,236,752,988
439525,2,1,236,752,988
439570,1,999,84,738,822
439570,2,1,84,738,822
439589,1,999,20,239,259
439589,2,1,20,239,259
439604,1,999,0,40,40
439604,2,1,0,40,40
439613,1,999,201,134,335
439613,2,1,201,134,335
439622,1,999,57,273,330
439622,2,1,57,273,330
439631,1,999,2,46,48
439631,2,1,2,46,48
439668,1,999,219,16,235
439668,2,1,219,16,235
439686,1,999,75,471,546
439686,2,1,75,471,546
439695,1,999,10,99,109
439695,2,1,10,99,109
439701,1,999,401,255,656
439701,2,1,206,133,339
439701,4,3,195,122,317
439729,1,999,1,60,61
439729,2,1,1,60,61
439738,1,999,110,827,937
439738,2,1,110,827,937
439747,1,999,31,151,182
439747,2,1,31,151,182
439756,1,999,24,5,29
439756,2,1,24,5,29
439774,1,999,20,40,60
439774,2,1,20,40,60
439783,1,999,89,100,189
439783,2,1,51,52,103
439783,4,3,38,48,86
439792,1,999,99,680,779
439792,2,1,99,680,779
439817,1,999,88,55,143
439817,4,3,88,55,143
439826,1,999,157,334,491
439826,2,1,157,334,491
439844,1,999,0,91,91
439844,2,1,0,91,91
439862,1,999,47,48,95
439862,2,1,47,48,95
439871,1,999,41,208,249
439871,2,1,41,208,249
439899,1,999,51,44,95
439899,2,1,51,44,95
439905,1,999,73,374,447
439905,2,1,73,374,447
439914,1,999,11,25,36
439914,4,3,11,25,36
439932,1,999,4,33,37
439932,2,1,4,33,37
439969,1,999,72,141,213
439969,2,1,29,58,87
439969,4,3,43,83,126
439978,1,999,8,136,144
439978,2,1,8,136,144
439996,1,999,42,114,156
439996,2,1,42,114,156
440004,1,999,28,31,59
440004,4,3,28,31,59
440031,1,999,112,58,170
440031,4,3,112,58,170
440059,1,999,519,37,556
440059,2,1,519,37,556
440077,1,999,0,74,74
440077,2,1,0,74,74
440086,1,999,93,159,252
440086,2,1,93,159,252
440101,1,999,26,270,296
440101,2,1,26,270,296
440110,1,999,199,843,1042
440110,2,1,199,843,1042
440129,1,999,215,1040,1255
440129,2,1,215,1040,1255
440147,1,999,575,712,1287
440147,2,1,575,712,1287
440165,1,999,1235,485,1720
440165,2,1,1235,485,1720
440174,1,999,8,124,132
440174,2,1,8,124,132
440217,1,999,0,34,34
440217,2,1,0,34,34
440226,1,999,4,162,166
440226,2,1,4,162,166
440235,1,999,19,82,101
440235,2,1,19,82,101
440244,1,999,3787,5163,8950
440244,2,1,3787,5163,8950
440253,1,999,252,154,406
440253,2,1,37,35,72
440253,4,3,215,119,334
440262,1,999,612,12,624
440262,2,1,612,12,624
440271,1,999,128,697,825
440271,2,1,128,697,825
440299,1,999,651,1055,1706
440299,2,1,651,1055,1706
440305,1,999,2181,3109,5290
440305,2,1,2181,3109,5290
440323,1,999,155,937,1092
440323,2,1,155,937,1092
440332,1,999,270,452,722
440332,2,1,270,452,722
440341,1,999,1621,1442,3063
440341,2,1,1621,1442,3063
440369,1,999,563,2030,2593
440369,2,1,563,2030,2593
440378,1,999,48,315,363
440378,2,1,48,315,363
440396,1,999,90,94,184
440396,2,1,78,86,164
440396,4,3,12,8,20
440402,1,999,1641,2001,3642
440402,2,1,1641,2001,3642
440411,1,999,92,96,188
440411,2,1,16,5,21
440411,4,3,76,91,167
440420,1,999,178,169,347
440420,2,1,136,124,260
440420,4,3,42,45,87
440439,1,999,729,1099,1828
440439,2,1,555,861,1416
440439,4,3,174,238,412
440448,1,999,1500,2785,4285
440448,2,1,1245,2354,3599
440448,4,3,255,431,686
440457,1,999,401,576,977
440457,2,1,371,546,917
440457,4,3,30,30,60
440466,1,999,388,465,853
440466,2,1,323,416,739
440466,4,3,65,49,114
440484,1,999,1133,1011,2144
440484,2,1,1133,1011,2144
440536,1,999,1525,833,2358
440536,2,1,1247,575,1822
440536,4,3,278,258,536
440545,1,999,1144,630,1774
440545,2,1,894,420,1314
440545,4,3,250,210,460
440590,1,999,1685,1135,2820
440590,2,1,1453,874,2327
440590,4,3,232,261,493
440624,1,999,948,1605,2553
440624,2,1,948,1605,2553
440642,1,999,1040,290,1330
440642,2,1,1040,290,1330
440651,1,999,472,1483,1955
440651,2,1,472,1483,1955
440721,1,999,268,691,959
440721,2,1,268,691,959
440730,1,999,412,898,1310
440730,2,1,412,898,1310
440749,1,999,454,208,662
440749,2,1,454,208,662
440758,1,999,120,257,377
440758,2,1,120,257,377
440767,1,999,298,816,1114
440767,2,1,298,816,1114
440776,1,999,19,51,70
440776,2,1,19,51,70
440794,1,999,157,189,346
440794,2,1,157,189,346
440800,1,999,41,42,83
440800,2,1,41,42,83
440819,1,999,91,86,177
440819,2,1,91,86,177
440828,1,999,324,559,883
440828,2,1,291,438,729
440828,4,3,33,121,154
440846,1,999,73,658,731
440846,2,1,73,658,731
440855,1,999,16,386,402
440855,2,1,16,386,402
440873,1,999,587,429,1016
440873,2,1,587,429,1016
440882,1,999,323,159,482
440882,2,1,323,159,482
440891,1,999,301,309,610
440891,2,1,301,309,610
440907,1,999,104,654,758
440907,2,1,104,654,758
440916,1,999,454,552,1006
440916,4,3,454,552,1006
440925,1,999,669,1054,1723
440925,2,1,669,1054,1723
440952,1,999,280,860,1140
440952,2,1,280,860,1140
440970,1,999,148,180,328
440970,2,1,148,180,328
440989,1,999,1317,671,1988
440989,2,1,1317,671,1988
441016,1,999,364,1787,2151
441016,2,1,364,1787,2151
441025,1,999,230,1351,1581
441025,2,1,230,1351,1581
441052,1,999,520,1538,2058
441052,2,1,520,1538,2058
441070,1,999,55,125,180
441070,2,1,55,125,180
441089,1,999,2111,53,2164
441089,2,1,2111,53,2164
441104,1,999,60,259,319
441104,4,3,60,259,319
441131,1,999,108,176,284
441131,4,3,108,176,284
441168,1,999,17,174,191
441168,2,1,17,174,191
441186,1,999,310,758,1068
441186,2,1,238,578,816
441186,4,3,72,180,252
441195,1,999,92,39,131
441195,2,1,92,39,131
441201,1,999,53,279,332
441201,2,1,53,279,332
441210,1,999,200,216,416
441210,2,1,200,216,416
441229,1,999,404,606,1010
441229,2,1,404,606,1010
441238,1,999,41,48,89
441238,4,3,41,48,89
441256,1,999,11,145,156
441256,2,1,11,145,156
441274,1,999,19,203,222
441274,2,1,19,203,222
441308,1,999,680,1829,2509
441308,4,3,680,1829,2509
441317,1,999,12,38,50
441317,2,1,12,38,50
441335,1,999,2,40,42
441335,2,1,2,40,42
441353,1,999,0,17,17
441353,2,1,0,17,17
441362,1,999,115,1177,1292
441362,2,1,115,1177,1292
441371,1,999,388,964,1352
441371,2,1,388,964,1352
441380,1,999,262,55,317
441380,2,1,262,55,317
441399,1,999,158,854,1012
441399,2,1,158,854,1012
441405,1,999,25,130,155
441405,2,1,25,130,155
441414,1,999,223,357,580
441414,2,1,223,357,580
441423,1,999,114,491,605
441423,2,1,114,491,605
441432,1,999,100,456,556
441432,2,1,100,456,556
441441,1,999,57,329,386
441441,2,1,57,329,386
441478,1,999,365,121,486
441478,2,1,39,8,47
441478,4,3,326,113,439
441487,1,999,57,231,288
441487,2,1,57,231,288
441496,1,999,180,15,195
441496,2,1,180,15,195
441502,1,999,44,378,422
441502,2,1,44,378,422
441511,1,999,102,147,249
441511,2,1,59,85,144
441511,4,3,43,62,105
441548,1,999,38,123,161
441548,2,1,38,123,161
441575,1,999,197,798,995
441575,2,1,197,798,995
441584,1,999,354,972,1326
441584,2,1,354,972,1326
441593,1,999,7,59,66
441593,2,1,7,59,66
441609,1,999,23,0,23
441609,2,1,23,0,23
441618,1,999,7,94,101
441618,2,1,7,94,101
441627,1,999,19,14,33
441627,2,1,19,14,33
441636,1,999,74,243,317
441636,2,1,74,243,317
441645,1,999,10,224,234
441645,2,1,10,224,234
441663,1,999,27,242,269
441663,2,1,27,242,269
441672,1,999,1,7,8
441672,2,1,1,7,8
441681,1,999,12,77,89
441681,2,1,12,77,89
441690,1,999,183,153,336
441690,2,1,183,153,336
441706,1,999,122,142,264
441706,2,1,122,142,264
441733,1,999,12,71,83
441733,2,1,12,71,83
441742,1,999,139,909,1048
441742,2,1,139,909,1048
441751,1,999,2,32,34
441751,2,1,2,32,34
441760,1,999,2262,1854,4116
441760,2,1,2262,1854,4116
441779,1,999,2,105,107
441779,2,1,2,105,107
441788,1,999,576,33,609
441788,2,1,576,33,609
441797,1,999,1,59,60
441797,2,1,1,59,60
441830,1,999,16,65,81
441830,2,1,16,65,81
441858,1,999,27,361,388
441858,2,1,27,361,388
441876,1,999,15,173,188
441876,2,1,15,173,188
441894,1,999,19,17,36
441894,2,1,19,17,36
441900,1,999,965,2920,3885
441900,2,1,965,2920,3885
441919,1,999,355,1492,1847
441919,2,1,355,1492,1847
441928,1,999,282,1440,1722
441928,2,1,282,1440,1722
441937,1,999,1426,2542,3968
441937,2,1,1354,2323,3677
441937,4,3,72,219,291
441955,1,999,1247,339,1586
441955,2,1,1247,339,1586
441964,1,999,859,206,1065
441964,2,1,859,206,1065
441973,1,999,1456,1291,2747
441973,2,1,1456,1291,2747
441982,1,999,193,154,347
441982,2,1,193,154,347
442000,1,999,1086,154,1240
442000,2,1,1086,154,1240
442037,1,999,388,755,1143
442037,2,1,388,755,1143
442046,1,999,412,1612,2024
442046,2,1,412,1612,2024
442064,1,999,13,45,58
442064,4,3,13,45,58
442073,1,999,442,1289,1731
442073,2,1,442,1289,1731
442134,1,999,133,1126,1259
442134,2,1,133,1126,1259
442143,1,999,439,760,1199
442143,2,1,377,684,1061
442143,4,3,62,76,138
442152,1,999,795,1564,2359
442152,2,1,632,1282,1914
442152,4,3,163,282,445
442161,1,999,735,1075,1810
442161,2,1,651,972,1623
442161,4,3,84,103,187
442170,1,999,699,1306,2005
442170,2,1,623,1204,1827
442170,4,3,76,102,178
442189,1,999,486,384,870
442189,2,1,375,318,693
442189,4,3,111,66,177
442204,1,999,21,94,115
442204,2,1,21,94,115
442213,1,999,1,40,41
442213,2,1,1,40,41
442222,1,999,201,626,827
442222,2,1,82,152,234
442222,4,3,119,474,593
442231,1,999,1017,757,1774
442231,2,1,1017,757,1774
442240,1,999,29,451,480
442240,2,1,29,451,480
442295,1,999,217,161,378
442295,4,3,217,161,378
442310,1,999,820,1054,1874
442310,2,1,820,1054,1874
442329,1,999,1477,45,1522
442329,2,1,1477,45,1522
442338,1,999,1518,610,2128
442338,2,1,1518,610,2128
442347,1,999,981,267,1248
442347,2,1,981,267,1248
442356,1,999,161,911,1072
442356,2,1,161,911,1072
442365,1,999,642,730,1372
442365,2,1,451,440,891
442365,4,3,191,290,481
442383,1,999,98,338,436
442383,2,1,98,338,436
442392,1,999,54,83,137
442392,4,3,54,83,137
442408,1,999,559,7,566
442408,2,1,559,7,566
442426,1,999,26,187,213
442426,2,1,26,187,213
442435,1,999,16,38,54
442435,2,1,16,38,54
442444,1,999,568,1004,1572
442444,2,1,568,1004,1572
442462,1,999,313,597,910
442462,2,1,313,597,910
442499,1,999,442,416,858
442499,2,1,442,416,858
442505,1,999,613,677,1290
442505,2,1,613,677,1290
442514,1,999,2,17,19
442514,2,1,2,17,19
442523,1,999,22,30,52
442523,2,1,22,30,52
442541,1,999,77,42,119
442541,2,1,40,26,66
442541,4,3,37,16,53
442569,1,999,10147,3420,13567
442569,2,1,9228,2977,12205
442569,4,3,919,443,1362
442578,1,999,225,623,848
442578,2,1,225,623,848
442602,1,999,329,1503,1832
442602,2,1,329,1503,1832
442611,1,999,2672,69,2741
442611,2,1,2672,69,2741
442620,1,999,242,517,759
442620,2,1,242,517,759
442639,1,999,55,47,102
442639,2,1,55,47,102
442648,1,999,259,1021,1280
442648,2,1,259,1021,1280
442657,1,999,54,391,445
442657,2,1,54,391,445
442684,1,999,15,295,310
442684,2,1,15,295,310
442718,1,999,122,673,795
442718,2,1,122,673,795
442727,1,999,650,2050,2700
442727,2,1,650,2050,2700
442736,1,999,278,1179,1457
442736,2,1,278,1179,1457
442745,1,999,578,1079,1657
442745,2,1,578,1079,1657
442781,1,999,138,241,379
442781,2,1,138,241,379
442790,1,999,795,1984,2779
442790,2,1,795,1984,2779
442806,1,999,359,362,721
442806,4,3,359,362,721
442815,1,999,155,953,1108
442815,2,1,155,953,1108
442824,1,999,2259,2028,4287
442824,2,1,1867,1555,3422
442824,4,3,392,473,865
442833,1,999,7526,11075,18601
442833,2,1,6206,8809,15015
442833,4,3,1320,2266,3586
442842,1,999,70,171,241
442842,2,1,26,34,60
442842,4,3,44,137,181
442851,1,999,103,155,258
442851,2,1,103,155,258
442879,1,999,352,1696,2048
442879,2,1,352,1696,2048
442888,1,999,111,61,172
442888,2,1,111,61,172
442897,1,999,71,169,240
442897,2,1,55,140,195
442897,4,3,16,29,45
442921,1,999,0,52,52
442921,2,1,0,52,52
442930,1,999,407,1101,1508
442930,2,1,407,1101,1508
442949,1,999,0,114,114
442949,2,1,0,114,114
442958,1,999,6,80,86
442958,2,1,6,80,86
442967,1,999,12,50,62
442967,2,1,12,50,62
442976,1,999,9,102,111
442976,2,1,9,102,111
442985,1,999,54,101,155
442985,2,1,54,101,155
443021,1,999,133,57,190
443021,2,1,133,57,190
443030,1,999,7,56,63
443030,4,3,7,56,63
443049,1,999,235,73,308
443049,2,1,89,26,115
443049,4,3,146,47,193
443058,1,999,24,33,57
443058,2,1,24,33,57
443076,1,999,148,143,291
443076,2,1,9,14,23
443076,4,3,139,129,268
443100,1,999,108,97,205
443100,2,1,108,97,205
443137,1,999,81,298,379
443137,2,1,81,298,379
443146,1,999,206,176,382
443146,2,1,206,176,382
443173,1,999,8,65,73
443173,2,1,8,65,73
443207,1,999,652,27,679
443207,2,1,652,27,679
443216,1,999,78,7,85
443216,2,1,78,7,85
443225,1,999,55,3,58
443225,2,1,55,3,58
443234,1,999,51,445,496
443234,2,1,51,445,496
443252,1,999,1048,301,1349
443252,2,1,1048,301,1349
443261,1,999,91,404,495
443261,2,1,91,404,495
443270,1,999,89,220,309
443270,2,1,89,220,309
443289,1,999,4,88,92
443289,2,1,4,88,92
443298,1,999,286,17,303
443298,2,1,286,17,303
443322,1,999,285,343,628
443322,2,1,285,343,628
443331,1,999,297,993,1290
443331,2,1,297,993,1290
443340,1,999,131,106,237
443340,2,1,131,106,237
443359,1,999,183,68,251
443359,2,1,183,68,251
443377,1,999,261,5,266
443377,2,1,261,5,266
443410,1,999,784,137,921
443410,2,1,738,129,867
443410,4,3,46,8,54
443429,1,999,25,166,191
443429,2,1,25,166,191
443438,1,999,236,938,1174
443438,2,1,236,938,1174
443456,1,999,103,113,216
443456,2,1,76,72,148
443456,4,3,27,41,68
443465,1,999,52,54,106
443465,2,1,52,54,106
443474,1,999,592,1095,1687
443474,2,1,461,911,1372
443474,4,3,131,184,315
443483,1,999,44,190,234
443483,2,1,44,190,234
443492,1,999,1478,2173,3651
443492,2,1,1478,2173,3651
443517,1,999,4,105,109
443517,2,1,4,105,109
443526,1,999,997,251,1248
443526,2,1,997,251,1248
443535,1,999,702,237,939
443535,2,1,702,237,939
443544,1,999,225,417,642
443544,2,1,173,319,492
443544,4,3,52,98,150
443553,1,999,418,803,1221
443553,2,1,418,803,1221
443562,1,999,868,1247,2115
443562,2,1,868,1247,2115
443571,1,999,98,61,159
443571,2,1,98,61,159
443605,1,999,103,553,656
443605,2,1,103,553,656
443623,1,999,905,711,1616
443623,2,1,905,711,1616
443632,1,999,139,53,192
443632,2,1,139,53,192
443641,1,999,23,317,340
443641,2,1,23,317,340
443650,1,999,180,1000,1180
443650,2,1,180,1000,1180
443669,1,999,79,574,653
443669,2,1,79,574,653
443678,1,999,9,177,186
443678,2,1,9,177,186
443687,1,999,921,930,1851
443687,2,1,921,930,1851
443696,1,999,44,45,89
443696,2,1,44,45,89
443702,1,999,7,10,17
443702,4,3,7,10,17
443739,1,999,93,685,778
443739,2,1,93,685,778
443748,1,999,205,1716,1921
443748,2,1,205,1716,1921
443766,1,999,1218,3531,4749
443766,2,1,901,2500,3401
443766,4,3,317,1031,1348
443784,1,999,1958,3222,5180
443784,2,1,1468,2461,3929
443784,4,3,490,761,1251
443827,1,999,642,540,1182
443827,2,1,642,540,1182
443836,1,999,182,1223,1405
443836,2,1,182,1223,1405
443845,1,999,497,2180,2677
443845,2,1,497,2180,2677
443854,1,999,452,1257,1709
443854,2,1,452,1257,1709
443881,1,999,465,1345,1810
443881,2,1,442,1275,1717
443881,4,3,23,70,93
443890,1,999,465,1256,1721
443890,2,1,392,1123,1515
443890,4,3,73,133,206
443906,1,999,130,198,328
443906,2,1,102,148,250
443906,4,3,28,50,78
443915,1,999,69,62,131
443915,2,1,55,53,108
443915,4,3,14,9,23
443924,1,999,496,1175,1671
443924,2,1,457,1075,1532
443924,4,3,39,100,139
443942,1,999,13,193,206
443942,2,1,13,193,206
443951,1,999,121,145,266
443951,2,1,121,145,266
443979,1,999,6,132,138
443979,2,1,6,132,138
443997,1,999,334,267,601
443997,2,1,262,181,443
443997,4,3,72,86,158
444015,1,999,462,2989,3451
444015,2,1,462,2989,3451
444024,1,999,575,893,1468
444024,2,1,575,893,1468
444033,1,999,238,154,392
444033,2,1,162,92,254
444033,4,3,76,62,138
444042,1,999,622,1493,2115
444042,2,1,622,1493,2115
444051,1,999,29,207,236
444051,2,1,29,207,236
444060,1,999,608,442,1050
444060,2,1,608,442,1050
444079,1,999,260,387,647
444079,2,1,260,387,647
444088,1,999,189,611,800
444088,2,1,189,611,800
444103,1,999,12,0,12
444103,4,3,12,0,12
444121,1,999,194,591,785
444121,2,1,194,591,785
444130,1,999,5907,6307,12214
444130,2,1,358,302,660
444130,4,3,5549,6005,11554
444158,1,999,17030,32759,49789
444158,2,1,15127,30338,45465
444158,4,3,1903,2421,4324
444167,1,999,1397,3515,4912
444167,2,1,1397,3515,4912
444176,1,999,131,290,421
444176,2,1,131,290,421
444194,1,999,25,175,200
444194,2,1,25,175,200
444200,1,999,59,574,633
444200,2,1,59,574,633
444219,1,999,5598,8248,13846
444219,2,1,5598,8248,13846
444228,1,999,3,52,55
444228,2,1,3,52,55
444237,1,999,407,1261,1668
444237,2,1,407,1261,1668
444255,1,999,145,612,757
444255,2,1,145,612,757
444264,1,999,65,199,264
444264,2,1,65,199,264
444282,1,999,21,200,221
444282,2,1,21,200,221
444291,1,999,19,204,223
444291,2,1,19,204,223
444307,1,999,33,192,225
444307,2,1,33,192,225
444316,1,999,9,234,243
444316,2,1,9,234,243
444325,1,999,51,197,248
444325,2,1,51,197,248
444334,1,999,44,110,154
444334,2,1,44,110,154
444343,1,999,38,316,354
444343,2,1,38,316,354
444352,1,999,71,242,313
444352,2,1,71,242,313
444361,1,999,27,25,52
444361,2,1,27,25,52
444370,1,999,289,1,290
444370,2,1,289,1,290
444389,1,999,237,942,1179
444389,2,1,237,942,1179
444398,1,999,137,89,226
444398,2,1,137,89,226
444404,1,999,79,55,134
444404,2,1,79,55,134
444413,1,999,141,0,141
444413,2,1,122,0,122
444413,4,3,19,0,19
444422,1,999,11,219,230
444422,2,1,11,219,230
444440,1,999,15,252,267
444440,2,1,15,252,267
444459,1,999,13,0,13
444459,2,1,13,0,13
444468,1,999,2,35,37
444468,2,1,2,35,37
444477,1,999,37,129,166
444477,2,1,37,129,166
444486,1,999,24,200,224
444486,2,1,24,200,224
444510,1,999,2,23,25
444510,2,1,2,23,25
444529,1,999,51,272,323
444529,2,1,51,272,323
444547,1,999,1,71,72
444547,2,1,1,71,72
444556,1,999,19,32,51
444556,2,1,19,32,51
444565,1,999,101,109,210
444565,2,1,101,109,210
444574,1,999,189,535,724
444574,2,1,189,535,724
444583,1,999,565,390,955
444583,2,1,565,390,955
444592,1,999,6,149,155
444592,2,1,6,149,155
444608,1,999,0,46,46
444608,2,1,0,46,46
444626,1,999,5,15,20
444626,2,1,5,15,20
444635,1,999,5,59,64
444635,2,1,5,59,64
444644,1,999,4,29,33
444644,2,1,4,29,33
444653,1,999,8,78,86
444653,2,1,8,78,86
444662,1,999,17,68,85
444662,2,1,17,68,85
444671,1,999,208,161,369
444671,2,1,208,161,369
444680,1,999,95,93,188
444680,2,1,95,93,188
444699,1,999,10,25,35
444699,4,3,10,25,35
444705,1,999,10,45,55
444705,2,1,10,45,55
444714,1,999,363,2023,2386
444714,2,1,363,2023,2386
444723,1,999,2839,5148,7987
444723,2,1,1735,2632,4367
444723,4,3,1104,2516,3620
444732,1,999,47,92,139
444732,2,1,47,92,139
444750,1,999,2,26,28
444750,2,1,2,26,28
444769,1,999,31,203,234
444769,2,1,31,203,234
444778,1,999,60,72,132
444778,2,1,45,53,98
444778,4,3,15,19,34
444787,1,999,11,32,43
444787,2,1,11,32,43
444796,1,999,264,146,410
444796,2,1,264,146,410
444857,1,999,0,68,68
444857,2,1,0,68,68
444866,1,999,62,324,386
444866,2,1,62,324,386
444884,1,999,4,14,18
444884,2,1,4,14,18
444893,1,999,25,136,161
444893,2,1,25,136,161
444909,1,999,0,24,24
444909,2,1,0,24,24
444927,1,999,268,278,546
444927,2,1,268,278,546
444936,1,999,4,85,89
444936,2,1,4,85,89
444945,1,999,25,289,314
444945,2,1,25,289,314
444954,1,999,2292,1707,3999
444954,2,1,2292,1707,3999
444972,1,999,64,191,255
444972,2,1,64,191,255
444990,1,999,132,359,491
444990,2,1,132,359,491
445009,1,999,1651,3083,4734
445009,2,1,1651,3083,4734
445018,1,999,831,1534,2365
445018,2,1,831,1534,2365
445027,1,999,14271,27723,41994
445027,2,1,12845,25175,38020
445027,4,3,1426,2548,3974
445054,1,999,11,1,12
445054,4,3,11,1,12
445072,1,999,796,783,1579
445072,2,1,796,783,1579
445081,1,999,1161,156,1317
445081,2,1,1161,156,1317
445090,1,999,181,609,790
445090,2,1,181,609,790
445115,1,999,657,427,1084
445115,2,1,657,427,1084
445124,1,999,751,819,1570
445124,2,1,751,819,1570
445133,1,999,366,418,784
445133,2,1,300,331,631
445133,4,3,66,87,153
445142,1,999,200,678,878
445142,2,1,200,678,878
445188,1,999,1872,1716,3588
445188,2,1,1722,1630,3352
445188,4,3,150,86,236
445197,1,999,599,1148,1747
445197,2,1,599,1148,1747
445203,1,999,256,1084,1340
445203,2,1,256,1084,1340
445212,1,999,83,404,487
445212,2,1,83,404,487
445221,1,999,4,165,169
445221,2,1,4,165,169
445230,1,999,391,1546,1937
445230,2,1,391,1546,1937
445249,1,999,81,753,834
445249,2,1,81,753,834
445258,1,999,224,410,634
445258,2,1,224,410,634
445267,1,999,1477,2873,4350
445267,2,1,1433,2730,4163
445267,4,3,44,143,187
445276,1,999,544,579,1123
445276,2,1,544,579,1123
445300,1,999,373,460,833
445300,2,1,373,460,833
445319,1,999,221,249,470
445319,2,1,184,223,407
445319,4,3,37,26,63
445328,1,999,149,1018,1167
445328,2,1,149,1018,1167
445337,1,999,293,637,930
445337,2,1,293,637,930
445346,1,999,179,822,1001
445346,2,1,179,822,1001
445355,1,999,91,494,585
445355,2,1,91,494,585
445364,1,999,60,257,317
445364,2,1,60,257,317
445373,1,999,142,814,956
445373,2,1,142,814,956
445382,1,999,1103,688,1791
445382,2,1,1103,688,1791
445391,1,999,144,156,300
445391,2,1,130,135,265
445391,4,3,14,21,35
445407,1,999,588,422,1010
445407,2,1,420,282,702
445407,4,3,168,140,308
445416,1,999,102,380,482
445416,2,1,102,380,482
445434,1,999,881,1658,2539
445434,2,1,881,1658,2539
445452,1,999,2885,105,2990
445452,2,1,2885,105,2990
445461,1,999,1420,872,2292
445461,2,1,1420,872,2292
445470,1,999,643,337,980
445470,2,1,643,337,980
445489,1,999,31,104,135
445489,2,1,31,104,135
445498,1,999,120,0,120
445498,2,1,120,0,120
445504,1,999,14,195,209
445504,2,1,14,195,209
445531,1,999,3,40,43
445531,2,1,3,40,43
445540,1,999,5,65,70
445540,2,1,5,65,70
445559,1,999,342,183,525
445559,2,1,342,183,525
445577,1,999,312,499,811
445577,2,1,312,499,811
445601,1,999,243,1121,1364
445601,2,1,243,1121,1364
445610,1,999,52,419,471
445610,2,1,52,419,471
445629,1,999,20,173,193
445629,2,1,20,173,193
445638,1,999,11,123,134
445638,2,1,11,123,134
445647,1,999,14,147,161
445647,2,1,14,147,161
445656,1,999,26,234,260
445656,2,1,26,234,260
445665,1,999,27,350,377
445665,2,1,27,350,377
445674,1,999,685,450,1135
445674,2,1,685,450,1135
445683,1,999,6,130,136
445683,2,1,6,130,136
445692,1,999,243,5,248
445692,2,1,234,5,239
445692,4,3,9,0,9
445708,1,999,1193,1564,2757
445708,2,1,1193,1564,2757
445717,1,999,1069,2206,3275
445717,2,1,926,1839,2765
445717,4,3,143,367,510
445726,1,999,547,344,891
445726,2,1,547,344,891
445735,1,999,404,575,979
445735,2,1,65,198,263
445735,4,3,339,377,716
445744,1,999,80,764,844
445744,2,1,80,764,844
445753,1,999,198,607,805
445753,2,1,198,607,805
445762,1,999,229,16,245
445762,2,1,229,16,245
445771,1,999,283,871,1154
445771,2,1,283,871,1154
445780,1,999,2,60,62
445780,2,1,2,60,62
445799,1,999,2553,50,2603
445799,2,1,2553,50,2603
445814,1,999,259,957,1216
445814,2,1,259,957,1216
445832,1,999,25,263,288
445832,2,1,25,263,288
445841,1,999,12,203,215
445841,2,1,12,203,215
445850,1,999,14,269,283
445850,2,1,14,269,283
445869,1,999,22,55,77
445869,4,3,22,55,77
445896,1,999,5,177,182
445896,2,1,5,177,182
445911,1,999,420,1132,1552
445911,2,1,420,1132,1552
445920,1,999,430,1114,1544
445920,2,1,430,1114,1544
445939,1,999,130,506,636
445939,2,1,130,506,636
445948,1,999,71,362,433
445948,2,1,71,362,433
445957,1,999,196,410,606
445957,2,1,196,410,606
445984,1,999,33,0,33
445984,2,1,33,0,33
445993,1,999,15,107,122
445993,2,1,15,107,122
446002,1,999,31,85,116
446002,4,3,31,85,116
446039,1,999,19,42,61
446039,4,3,19,42,61
446048,1,999,398,429,827
446048,2,1,325,355,680
446048,4,3,73,74,147
446057,1,999,24,161,185
446057,2,1,24,161,185
446075,1,999,2,97,99
446075,2,1,2,97,99
446084,1,999,29,277,306
446084,2,1,29,277,306
446093,1,999,25,297,322
446093,2,1,25,297,322
446109,1,999,58,359,417
446109,2,1,58,359,417
446118,1,999,177,731,908
446118,2,1,177,731,908
446127,1,999,70,374,444
446127,2,1,70,374,444
446136,1,999,133,575,708
446136,2,1,133,575,708
446145,1,999,24,101,125
446145,2,1,24,101,125
446154,1,999,62,507,569
446154,2,1,62,507,569
446163,1,999,69,81,150
446163,2,1,69,81,150
446190,1,999,1,35,36
446190,2,1,1,35,36
446206,1,999,0,24,24
446206,2,1,0,24,24
446215,1,999,8,69,77
446215,2,1,8,69,77
446224,1,999,28,53,81
446224,2,1,28,53,81
446233,1,999,164,113,277
446233,2,1,164,113,277
446242,1,999,78,132,210
446242,2,1,78,132,210
446251,1,999,31,47,78
446251,2,1,31,47,78
446260,1,999,56,196,252
446260,2,1,56,196,252
446288,1,999,16,174,190
446288,2,1,16,174,190
446297,1,999,14,3,17
446297,2,1,14,3,17
446303,1,999,27,198,225
446303,2,1,27,198,225
446312,1,999,10,76,86
446312,2,1,10,76,86
446321,1,999,1,36,37
446321,2,1,1,36,37
446349,1,999,4,26,30
446349,2,1,4,26,30
446358,1,999,11,86,97
446358,2,1,11,86,97
446385,1,999,115,35,150
446385,2,1,115,35,150
446394,1,999,53,101,154
446394,2,1,34,71,105
446394,4,3,19,30,49
446400,1,999,47,391,438
446400,2,1,47,391,438
446419,1,999,27,50,77
446419,2,1,27,50,77
446428,1,999,5,71,76
446428,2,1,5,71,76
446437,1,999,142,173,315
446437,2,1,142,173,315
446446,1,999,24,172,196
446446,2,1,24,172,196
446455,1,999,318,21,339
446455,2,1,318,21,339
446464,1,999,32,124,156
446464,2,1,32,124,156
446491,1,999,2,26,28
446491,2,1,2,26,28
446507,1,999,5,21,26
446507,2,1,5,21,26
446516,1,999,5,25,30
446516,2,1,5,25,30
446525,1,999,156,17,173
446525,2,1,156,17,173
446534,1,999,30,64,94
446534,2,1,30,64,94
446543,1,999,6,26,32
446543,2,1,6,26,32
446552,1,999,708,955,1663
446552,2,1,708,955,1663
446561,1,999,158,256,414
446561,2,1,158,256,414
446570,1,999,23,29,52
446570,2,1,23,29,52
446589,1,999,22,80,102
446589,2,1,22,80,102
446598,1,999,8,85,93
446598,2,1,8,85,93
446604,1,999,1238,0,1238
446604,2,1,1238,0,1238
446613,1,999,40,25,65
446613,2,1,40,25,65
446640,1,999,180,180,360
446640,2,1,129,118,247
446640,4,3,51,62,113
446668,1,999,562,606,1168
446668,2,1,562,606,1168
446677,1,999,184,250,434
446677,2,1,184,250,434
446701,1,999,2,8,10
446701,4,3,2,8,10
446710,1,999,112,159,271
446710,2,1,97,144,241
446710,4,3,15,15,30
446729,1,999,1,1,2
446729,2,1,1,1,2
446738,1,999,591,644,1235
446738,2,1,466,516,982
446738,4,3,125,128,253
446747,1,999,279,342,621
446747,2,1,240,302,542
446747,4,3,39,40,79
446756,1,999,258,349,607
446756,2,1,244,326,570
446756,4,3,14,23,37
446765,1,999,302,483,785
446765,2,1,232,379,611
446765,4,3,70,104,174
446774,1,999,1868,2750,4618
446774,2,1,1868,2750,4618
446783,1,999,124,110,234
446783,2,1,124,110,234
446792,1,999,445,479,924
446792,2,1,445,479,924
446808,1,999,316,489,805
446808,2,1,316,489,805
446817,1,999,512,474,986
446817,2,1,512,474,986
446835,1,999,1042,815,1857
446835,2,1,1042,815,1857
446844,1,999,699,510,1209
446844,2,1,699,510,1209
446853,1,999,137,868,1005
446853,2,1,137,868,1005
446880,1,999,64,345,409
446880,2,1,64,345,409
446899,1,999,1149,366,1515
446899,2,1,1149,366,1515
446905,1,999,885,227,1112
446905,2,1,885,227,1112
446914,1,999,1930,418,2348
446914,2,1,1930,418,2348
446923,1,999,762,221,983
446923,2,1,762,221,983
446932,1,999,353,341,694
446932,4,3,353,341,694
446996,1,999,4,155,159
446996,2,1,4,155,159
447014,1,999,41,181,222
447014,2,1,41,181,222
447023,1,999,329,723,1052
447023,2,1,329,723,1052
447050,1,999,84,230,314
447050,2,1,76,214,290
447050,4,3,8,16,24
447069,1,999,566,448,1014
447069,2,1,566,448,1014
447102,1,999,334,1059,1393
447102,2,1,334,1059,1393
447120,1,999,204,817,1021
447120,2,1,204,817,1021
447148,1,999,18,475,493
447148,2,1,18,475,493
447157,1,999,16,186,202
447157,2,1,16,186,202
447166,1,999,4,147,151
447166,2,1,4,147,151
447175,1,999,18,216,234
447175,2,1,18,216,234
447209,1,999,404,1589,1993
447209,2,1,404,1589,1993
447218,1,999,262,1651,1913
447218,2,1,262,1651,1913
447227,1,999,305,1475,1780
447227,2,1,305,1475,1780
447236,1,999,275,996,1271
447236,2,1,275,996,1271
447245,1,999,232,1369,1601
447245,2,1,232,1369,1601
447254,1,999,3,27,30
447254,2,1,3,27,30
447263,1,999,134,306,440
447263,2,1,134,306,440
447272,1,999,227,517,744
447272,2,1,77,150,227
447272,4,3,150,367,517
447290,1,999,532,1151,1683
447290,2,1,532,1151,1683
447315,1,999,6,151,157
447315,2,1,6,151,157
447324,1,999,7,237,244
447324,2,1,7,237,244
447333,1,999,7,126,133
447333,2,1,7,126,133
447342,1,999,8,165,173
447342,2,1,8,165,173
447351,1,999,303,705,1008
447351,2,1,303,705,1008
447360,1,999,138,159,297
447360,2,1,138,159,297
447379,1,999,44,193,237
447379,2,1,44,193,237
447388,1,999,58,296,354
447388,2,1,58,296,354
447397,1,999,45,395,440
447397,2,1,45,395,440
447403,1,999,1985,43,2028
447403,2,1,1985,43,2028
447421,1,999,286,529,815
447421,2,1,286,529,815
447430,1,999,26,82,108
447430,2,1,26,82,108
447449,1,999,7,50,57
447449,2,1,7,50,57
447458,1,999,1176,175,1351
447458,2,1,1176,175,1351
447467,1,999,33,313,346
447467,2,1,33,313,346
447476,1,999,147,276,423
447476,2,1,147,276,423
447485,1,999,193,121,314
447485,2,1,141,81,222
447485,4,3,52,40,92
447494,1,999,89,828,917
447494,2,1,89,828,917
447519,1,999,114,540,654
447519,2,1,114,540,654
447528,1,999,84,143,227
447528,2,1,84,143,227
447582,1,999,1376,2666,4042
447582,2,1,1376,2666,4042
447591,1,999,35,139,174
447591,2,1,35,139,174
447625,1,999,209,314,523
447625,2,1,209,314,523
447634,1,999,298,874,1172
447634,2,1,298,874,1172
447652,1,999,344,798,1142
447652,2,1,319,756,1075
447652,4,3,25,42,67
447661,1,999,289,478,767
447661,2,1,217,314,531
447661,4,3,72,164,236
447670,1,999,314,780,1094
447670,2,1,314,780,1094
447689,1,999,1862,2089,3951
447689,2,1,1862,2089,3951
447698,1,999,55,88,143
447698,4,3,55,88,143
447704,1,999,5,130,135
447704,2,1,5,130,135
447713,1,999,30,102,132
447713,2,1,30,102,132
447722,1,999,21,116,137
447722,2,1,21,116,137
447731,1,999,7,230,237
447731,2,1,7,230,237
447759,1,999,125,384,509
447759,2,1,125,384,509
447768,1,999,340,1308,1648
447768,2,1,340,1308,1648
447777,1,999,219,167,386
447777,2,1,219,167,386
447795,1,999,14,25,39
447795,2,1,14,25,39
447801,1,999,97,114,211
447801,4,3,97,114,211
447810,1,999,18,150,168
447810,2,1,18,150,168
447829,1,999,75,34,109
447829,2,1,75,34,109
447838,1,999,36,36,72
447838,2,1,36,36,72
447847,1,999,69,6,75
447847,2,1,69,6,75
447856,1,999,31,110,141
447856,2,1,31,110,141
447865,1,999,40,15,55
447865,2,1,40,15,55
447874,1,999,375,2,377
447874,2,1,375,2,377
447883,1,999,129,89,218
447883,2,1,129,89,218
447892,1,999,61,199,260
447892,2,1,61,199,260
447908,1,999,6,69,75
447908,2,1,6,69,75
447917,1,999,19,72,91
447917,2,1,19,72,91
447935,1,999,88,677,765
447935,2,1,88,677,765
447953,1,999,98,82,180
447953,2,1,98,82,180
447962,1,999,15,275,290
447962,2,1,15,275,290
447971,1,999,14,100,114
447971,2,1,14,100,114
447980,1,999,10,75,85
447980,2,1,10,75,85
447999,1,999,101,295,396
447999,2,1,101,295,396
448008,1,999,1,36,37
448008,2,1,1,36,37
448017,1,999,7,19,26
448017,2,1,7,19,26
448026,1,999,5,154,159
448026,2,1,5,154,159
448035,1,999,11,37,48
448035,2,1,11,37,48
448044,1,999,1,12,13
448044,2,1,1,12,13
448053,1,999,6,84,90
448053,2,1,6,84,90
448071,1,999,32,211,243
448071,2,1,32,211,243
448080,1,999,8,29,37
448080,2,1,8,29,37
448099,1,999,2,64,66
448099,2,1,2,64,66
448105,1,999,37,54,91
448105,2,1,37,54,91
448114,1,999,487,874,1361
448114,2,1,487,874,1361
448123,1,999,40,190,230
448123,2,1,40,190,230
448141,1,999,2,71,73
448141,2,1,2,71,73
448150,1,999,9,264,273
448150,2,1,9,264,273
448196,1,999,77,308,385
448196,2,1,77,308,385
448202,1,999,22,87,109
448202,2,1,22,87,109
448211,1,999,3,152,155
448211,2,1,3,152,155
448220,1,999,2,97,99
448220,2,1,2,97,99
448239,1,999,3,178,181
448239,2,1,3,178,181
448248,1,999,704,1146,1850
448248,2,1,704,1146,1850
448257,1,999,1,57,58
448257,2,1,1,57,58
448266,1,999,4,47,51
448266,2,1,4,47,51
448275,1,999,17,49,66
448275,2,1,17,49,66
448284,1,999,931,2410,3341
448284,2,1,456,619,1075
448284,4,3,475,1791,2266
448309,1,999,665,2320,2985
448309,2,1,497,1998,2495
448309,4,3,168,322,490
448345,1,999,648,992,1640
448345,2,1,648,992,1640
448354,1,999,27,204,231
448354,2,1,27,204,231
448363,1,999,133,1025,1158
448363,2,1,133,1025,1158
448372,1,999,229,289,518
448372,2,1,229,289,518
448406,1,999,45,538,583
448406,2,1,45,538,583
448415,1,999,148,1608,1756
448415,2,1,148,1608,1756
448424,1,999,2,112,114
448424,2,1,2,112,114
448433,1,999,2684,50,2734
448433,2,1,2684,50,2734
448442,1,999,1051,436,1487
448442,2,1,1051,436,1487
448451,1,999,746,261,1007
448451,2,1,746,261,1007
448460,1,999,484,121,605
448460,2,1,484,121,605
448479,1,999,1332,517,1849
448479,2,1,1332,517,1849
448488,1,999,890,293,1183
448488,2,1,890,293,1183
448497,1,999,836,345,1181
448497,2,1,836,345,1181
448503,1,999,761,312,1073
448503,2,1,761,312,1073
448512,1,999,726,294,1020
448512,2,1,726,294,1020
448521,1,999,37,31,68
448521,2,1,27,22,49
448521,4,3,10,9,19
448530,1,999,371,521,892
448530,2,1,348,507,855
448530,4,3,23,14,37
448549,1,999,91,166,257
448549,2,1,84,153,237
448549,4,3,7,13,20
448558,1,999,137,178,315
448558,2,1,125,173,298
448558,4,3,12,5,17
448567,1,999,348,726,1074
448567,2,1,312,678,990
448567,4,3,36,48,84
448576,1,999,1059,951,2010
448576,2,1,1059,951,2010
448585,1,999,105,688,793
448585,2,1,105,688,793
448594,1,999,2311,3604,5915
448594,2,1,2311,3604,5915
448600,1,999,55,555,610
448600,2,1,55,555,610
448619,1,999,26,201,227
448619,2,1,26,201,227
448628,1,999,548,367,915
448628,2,1,548,367,915
448646,1,999,20,294,314
448646,2,1,20,294,314
448655,1,999,281,944,1225
448655,2,1,281,944,1225
448664,1,999,650,20,670
448664,2,1,650,20,670
448673,1,999,625,1942,2567
448673,2,1,625,1942,2567
448691,1,999,55,162,217
448691,4,3,55,162,217
448707,1,999,186,266,452
448707,2,1,186,266,452
448716,1,999,135,248,383
448716,2,1,135,248,383
448734,1,999,197,469,666
448734,2,1,69,119,188
448734,4,3,128,350,478
448752,1,999,229,473,702
448752,2,1,229,473,702
448761,1,999,184,435,619
448761,2,1,184,435,619
448770,1,999,492,15,507
448770,2,1,492,15,507
448789,1,999,225,1396,1621
448789,2,1,225,1396,1621
448798,1,999,104,471,575
448798,2,1,104,471,575
448804,1,999,102,323,425
448804,2,1,102,323,425
448822,1,999,34,46,80
448822,2,1,25,29,54
448822,4,3,9,17,26
448831,1,999,40,51,91
448831,2,1,35,41,76
448831,4,3,5,10,15
448840,1,999,1815,3036,4851
448840,2,1,1601,2596,4197
448840,4,3,214,440,654
448859,1,999,216,6,222
448859,2,1,216,6,222
448877,1,999,186,88,274
448877,2,1,122,53,175
448877,4,3,64,35,99
448895,1,999,75,668,743
448895,2,1,75,668,743
448965,1,999,38,281,319
448965,2,1,38,281,319
448974,1,999,84,639,723
448974,2,1,84,639,723
448983,1,999,130,522,652
448983,2,1,130,522,652
449010,1,999,607,522,1129
449010,2,1,607,522,1129
449038,1,999,2180,3179,5359
449038,2,1,1726,2388,4114
449038,4,3,454,791,1245
449074,1,999,251,1180,1431
449074,2,1,251,1180,1431
449083,1,999,241,12,253
449083,2,1,241,12,253
449092,1,999,214,23,237
449092,2,1,214,23,237
449117,1,999,177,1030,1207
449117,2,1,177,1030,1207
449126,1,999,106,675,781
449126,2,1,106,675,781
449135,1,999,163,315,478
449135,2,1,163,315,478
449144,1,999,219,312,531
449144,2,1,219,312,531
449153,1,999,205,240,445
449153,2,1,205,240,445
449162,1,999,5,190,195
449162,2,1,5,190,195
449171,1,999,5,165,170
449171,2,1,5,165,170
449180,1,999,7,207,214
449180,2,1,7,207,214
449199,1,999,7,180,187
449199,2,1,7,180,187
449205,1,999,6,116,122
449205,2,1,6,116,122
449214,1,999,2,121,123
449214,2,1,2,121,123
449223,1,999,7,240,247
449223,2,1,7,240,247
449232,1,999,13,195,208
449232,2,1,13,195,208
449241,1,999,3,152,155
449241,2,1,3,152,155
449250,1,999,92,215,307
449250,2,1,92,215,307
449269,1,999,332,965,1297
449269,2,1,332,965,1297
449278,1,999,317,1180,1497
449278,2,1,317,1180,1497
449302,1,999,61,285,346
449302,2,1,61,285,346
449311,1,999,13,379,392
449311,2,1,13,379,392
449320,1,999,1195,29,1224
449320,2,1,1195,29,1224
449339,1,999,48119,21265,69384
449339,2,1,36896,16190,53086
449339,4,3,11223,5075,16298
449348,1,999,70,87,157
449348,2,1,70,87,157
449357,1,999,24,104,128
449357,2,1,24,104,128
449366,1,999,21,486,507
449366,2,1,21,486,507
449375,1,999,353,91,444
449375,2,1,353,91,444
449384,1,999,631,180,811
449384,2,1,631,180,811
449393,1,999,8,173,181
449393,2,1,8,173,181
449418,1,999,119,33,152
449418,2,1,119,33,152
449436,1,999,10,56,66
449436,2,1,10,56,66
449445,1,999,65,221,286
449445,2,1,65,221,286
449454,1,999,19,42,61
449454,2,1,19,42,61
449463,1,999,5,71,76
449463,2,1,5,71,76
449472,1,999,11,121,132
449472,2,1,11,121,132
449481,1,999,12,36,48
449481,4,3,12,36,48
449490,1,999,33,111,144
449490,2,1,33,111,144
449506,1,999,60,222,282
449506,2,1,60,222,282
449515,1,999,32,181,213
449515,2,1,32,181,213
449524,1,999,16,83,99
449524,2,1,16,83,99
449533,1,999,40,203,243
449533,2,1,40,203,243
449551,1,999,4,32,36
449551,2,1,4,32,36
449579,1,999,8,24,32
449579,4,3,8,24,32
449597,1,999,6,110,116
449597,2,1,6,110,116
449603,1,999,160,25,185
449603,2,1,160,25,185
449612,1,999,109,64,173
449612,2,1,109,64,173
449658,1,999,105,0,105
449658,2,1,105,0,105
449667,1,999,29,183,212
449667,2,1,29,183,212
449676,1,999,40,6,46
449676,2,1,40,6,46
449685,1,999,44,105,149
449685,2,1,44,105,149
449694,1,999,69,446,515
449694,2,1,69,446,515
449700,1,999,222,943,1165
449700,2,1,222,943,1165
449719,1,999,44,418,462
449719,2,1,44,418,462
449728,1,999,3,60,63
449728,2,1,3,60,63
449746,1,999,280,102,382
449746,2,1,280,102,382
449755,1,999,18,0,18
449755,2,1,18,0,18
449764,1,999,79,30,109
449764,2,1,79,30,109
449773,1,999,88,182,270
449773,2,1,88,182,270
449782,1,999,4,54,58
449782,2,1,4,54,58
449791,1,999,29,236,265
449791,2,1,29,236,265
449807,1,999,5,186,191
449807,2,1,5,186,191
449816,1,999,643,403,1046
449816,2,1,643,403,1046
449825,1,999,2,45,47
449825,2,1,2,45,47
449843,1,999,49,226,275
449843,2,1,49,226,275
449852,1,999,5,49,54
449852,2,1,5,49,54
449861,1,999,86,787,873
449861,2,1,86,787,873
449870,1,999,162,164,326
449870,2,1,64,77,141
449870,4,3,98,87,185
449898,1,999,258,867,1125
449898,2,1,258,867,1125
449904,1,999,30,341,371
449904,2,1,30,341,371
449913,1,999,14,115,129
449913,2,1,14,115,129
449922,1,999,99,102,201
449922,4,3,99,102,201
449931,1,999,833,1685,2518
449931,2,1,527,1003,1530
449931,4,3,306,682,988
449940,1,999,114,62,176
449940,2,1,114,62,176
449959,1,999,29,288,317
449959,2,1,29,288,317
449968,1,999,42,378,420
449968,2,1,42,378,420
449977,1,999,32,375,407
449977,2,1,32,375,407
449986,1,999,31,297,328
449986,2,1,31,297,328
449995,1,999,22,296,318
449995,2,1,22,296,318
450003,1,999,218,924,1142
450003,2,1,218,924,1142
450012,1,999,24,101,125
450012,2,1,24,101,125
450021,1,999,45,475,520
450021,2,1,45,475,520
450049,1,999,405,343,748
450049,2,1,405,343,748
450058,1,999,135,1076,1211
450058,2,1,135,1076,1211
450067,1,999,101,861,962
450067,2,1,101,861,962
450076,1,999,143,1441,1584
450076,2,1,143,1441,1584
450085,1,999,371,573,944
450085,2,1,371,573,944
450094,1,999,679,481,1160
450094,2,1,679,481,1160
450119,1,999,56,185,241
450119,2,1,56,185,241
450128,1,999,61,528,589
450128,2,1,61,528,589
450137,1,999,1208,1633,2841
450137,2,1,1208,1633,2841
450146,1,999,10,93,103
450146,2,1,10,93,103
450155,1,999,117,528,645
450155,2,1,117,528,645
450173,1,999,818,4431,5249
450173,2,1,818,4431,5249
450182,1,999,173,512,685
450182,2,1,173,512,685
450191,1,999,112,862,974
450191,2,1,112,862,974
450207,1,999,523,131,654
450207,2,1,523,131,654
450216,1,999,769,273,1042
450216,2,1,769,273,1042
450225,1,999,710,281,991
450225,2,1,710,281,991
450234,1,999,601,175,776
450234,2,1,601,175,776
450243,1,999,928,336,1264
450243,2,1,928,336,1264
450252,1,999,638,212,850
450252,2,1,638,212,850
450261,1,999,444,129,573
450261,2,1,444,129,573
450270,1,999,656,280,936
450270,2,1,656,280,936
450289,1,999,131,560,691
450289,2,1,131,560,691
450298,1,999,264,488,752
450298,2,1,218,388,606
450298,4,3,46,100,146
450304,1,999,117,133,250
450304,4,3,117,133,250
450377,1,999,426,1252,1678
450377,2,1,291,724,1015
450377,4,3,135,528,663
450386,1,999,97,378,475
450386,2,1,97,378,475
450395,1,999,13,231,244
450395,2,1,13,231,244
450401,1,999,10,340,350
450401,2,1,10,340,350
450429,1,999,109,327,436
450429,2,1,109,327,436
450438,1,999,70,238,308
450438,2,1,70,238,308
450447,1,999,250,676,926
450447,2,1,250,676,926
450456,1,999,168,541,709
450456,2,1,139,474,613
450456,4,3,29,67,96
450465,1,999,412,574,986
450465,2,1,412,574,986
450474,1,999,507,1382,1889
450474,2,1,481,1316,1797
450474,4,3,26,66,92
450483,1,999,72,119,191
450483,2,1,66,106,172
450483,4,3,6,13,19
450492,1,999,220,447,667
450492,2,1,206,416,622
450492,4,3,14,31,45
450508,1,999,120,83,203
450508,2,1,120,83,203
450517,1,999,192,340,532
450517,2,1,125,181,306
450517,4,3,67,159,226
450526,1,999,281,698,979
450526,2,1,114,280,394
450526,4,3,167,418,585
450535,1,999,179,548,727
450535,2,1,38,114,152
450535,4,3,141,434,575
450544,1,999,132,323,455
450544,2,1,58,99,157
450544,4,3,74,224,298
450553,1,999,198,377,575
450553,2,1,198,377,575
450562,1,999,100,526,626
450562,2,1,100,526,626
450571,1,999,297,1110,1407
450571,2,1,297,1110,1407
450580,1,999,14,219,233
450580,2,1,14,219,233
450599,1,999,42,332,374
450599,2,1,42,332,374
450605,1,999,30,212,242
450605,2,1,30,212,242
450614,1,999,22,308,330
450614,2,1,22,308,330
450623,1,999,22,369,391
450623,2,1,22,369,391
450632,1,999,43,160,203
450632,2,1,43,160,203
450641,1,999,13,176,189
450641,2,1,13,176,189
450650,1,999,21,222,243
450650,2,1,21,222,243
450669,1,999,81,60,141
450669,2,1,81,60,141
450678,1,999,24,87,111
450678,2,1,24,87,111
450696,1,999,179,806,985
450696,2,1,179,806,985
450702,1,999,182,1133,1315
450702,2,1,182,1133,1315
450720,1,999,18,484,502
450720,2,1,18,484,502
450739,1,999,12,468,480
450739,2,1,12,468,480
450757,1,999,15,183,198
450757,2,1,15,183,198
450766,1,999,148,289,437
450766,2,1,2,18,20
450766,4,3,146,271,417
450775,1,999,112,378,490
450775,2,1,112,378,490
450784,1,999,8,128,136
450784,2,1,8,128,136
450793,1,999,6,204,210
450793,2,1,6,204,210
450809,1,999,6,203,209
450809,2,1,6,203,209
450818,1,999,9,242,251
450818,2,1,9,242,251
450827,1,999,11,253,264
450827,2,1,11,253,264
450836,1,999,9,154,163
450836,2,1,9,154,163
450845,1,999,5,190,195
450845,2,1,5,190,195
450854,1,999,10,186,196
450854,2,1,10,186,196
450863,1,999,5,140,145
450863,2,1,5,140,145
450872,1,999,8,131,139
450872,2,1,8,131,139
450881,1,999,7,104,111
450881,2,1,7,104,111
450933,1,999,15548,7694,23242
450933,2,1,12533,5650,18183
450933,4,3,3015,2044,5059
450942,1,999,269,258,527
450942,4,3,269,258,527
450951,1,999,172,105,277
450951,2,1,172,105,277
450960,1,999,8,338,346
450960,2,1,8,338,346
450979,1,999,11565,5590,17155
450979,2,1,6354,2886,9240
450979,4,3,5211,2704,7915
450988,1,999,84,322,406
450988,2,1,84,322,406
450997,1,999,140,118,258
450997,2,1,140,118,258
451006,1,999,25,57,82
451006,2,1,25,57,82
451015,1,999,76,242,318
451015,2,1,76,242,318
451024,1,999,278,62,340
451024,2,1,278,62,340
451033,1,999,0,21,21
451033,2,1,0,21,21
451042,1,999,7,35,42
451042,2,1,7,35,42
451051,1,999,10,61,71
451051,2,1,10,61,71
451060,1,999,315,126,441
451060,2,1,258,104,362
451060,4,3,57,22,79
451079,1,999,22,56,78
451079,4,3,22,56,78
451088,1,999,259,48,307
451088,2,1,259,48,307
451097,1,999,43,156,199
451097,2,1,43,156,199
451103,1,999,154,421,575
451103,2,1,154,421,575
451112,1,999,115,27,142
451112,2,1,115,27,142
451121,1,999,24,170,194
451121,2,1,24,170,194
451130,1,999,168,160,328
451130,4,3,168,160,328
451149,1,999,28,391,419
451149,2,1,28,391,419
451158,1,999,17,195,212
451158,2,1,17,195,212
451167,1,999,136,57,193
451167,2,1,136,57,193
451194,1,999,3,54,57
451194,2,1,3,54,57
451200,1,999,4,48,52
451200,2,1,4,48,52
451219,1,999,10,17,27
451219,2,1,10,17,27
451228,1,999,102,112,214
451228,2,1,102,112,214
451237,1,999,4,67,71
451237,2,1,4,67,71
451246,1,999,23,49,72
451246,2,1,23,49,72
451255,1,999,3,48,51
451255,2,1,3,48,51
451264,1,999,93,174,267
451264,2,1,93,174,267
451273,1,999,10,165,175
451273,2,1,10,165,175
451282,1,999,23,377,400
451282,2,1,23,377,400
451291,1,999,10,35,45
451291,2,1,10,35,45
451307,1,999,5,76,81
451307,2,1,5,76,81
451316,1,999,5,97,102
451316,2,1,5,97,102
451325,1,999,2,29,31
451325,2,1,2,29,31
451334,1,999,49,156,205
451334,2,1,49,156,205
451343,1,999,8,108,116
451343,2,1,8,108,116
451352,1,999,183,595,778
451352,2,1,183,595,778
451361,1,999,8,45,53
451361,2,1,8,45,53
451370,1,999,42,0,42
451370,2,1,42,0,42
451389,1,999,70,1,71
451389,2,1,70,1,71
451398,1,999,169,0,169
451398,2,1,169,0,169
451404,1,999,160,0,160
451404,2,1,160,0,160
451413,1,999,87,83,170
451413,2,1,87,83,170
451422,1,999,45,573,618
451422,2,1,45,573,618
451431,1,999,24,65,89
451431,2,1,24,65,89
451440,1,999,125,346,471
451440,2,1,125,346,471
451459,1,999,119,142,261
451459,2,1,119,142,261
451468,1,999,7,177,184
451468,2,1,7,177,184
451477,1,999,169,170,339
451477,2,1,169,170,339
451486,1,999,39,20,59
451486,2,1,39,20,59
451495,1,999,14,59,73
451495,2,1,14,59,73
451501,1,999,83,56,139
451501,2,1,83,56,139
451510,1,999,374,304,678
451510,4,3,374,304,678
451529,1,999,2,129,131
451529,2,1,2,129,131
451538,1,999,193,30,223
451538,2,1,193,30,223
451547,1,999,7,68,75
451547,2,1,7,68,75
451556,1,999,497,736,1233
451556,2,1,497,736,1233
451565,1,999,22,332,354
451565,2,1,22,332,354
451574,1,999,1,120,121
451574,2,1,1,120,121
451583,1,999,258,232,490
451583,2,1,258,232,490
451592,1,999,23,60,83
451592,2,1,23,60,83
451608,1,999,73,56,129
451608,2,1,73,56,129
451617,1,999,1,35,36
451617,2,1,1,35,36
451626,1,999,8,119,127
451626,2,1,8,119,127
451635,1,999,8,48,56
451635,2,1,8,48,56
451644,1,999,0,14,14
451644,2,1,0,14,14
451653,1,999,1,27,28
451653,2,1,1,27,28
451662,1,999,10529,17716,28245
451662,2,1,10529,17716,28245
451671,1,999,737,1544,2281
451671,2,1,653,1287,1940
451671,4,3,84,257,341
451680,1,999,626,890,1516
451680,2,1,547,715,1262
451680,4,3,79,175,254
451699,1,999,393,2000,2393
451699,2,1,393,2000,2393
451705,1,999,68,115,183
451705,2,1,68,115,183
451714,1,999,34,365,399
451714,2,1,34,365,399
451741,1,999,312,724,1036
451741,2,1,312,724,1036
451750,1,999,204,1086,1290
451750,2,1,204,1086,1290
451769,1,999,372,1004,1376
451769,2,1,372,1004,1376
451778,1,999,11,114,125
451778,2,1,11,114,125
451796,1,999,442,625,1067
451796,2,1,442,625,1067
451802,1,999,3,77,80
451802,2,1,3,77,80
451811,1,999,3,36,39
451811,2,1,3,36,39
451820,1,999,713,632,1345
451820,2,1,713,632,1345
451848,1,999,418,373,791
451848,2,1,418,373,791
451857,1,999,76,662,738
451857,2,1,76,662,738
451866,1,999,154,718,872
451866,2,1,154,718,872
451875,1,999,104,230,334
451875,2,1,104,230,334
451884,1,999,123,475,598
451884,2,1,123,475,598
451893,1,999,13,82,95
451893,2,1,13,82,95
451909,1,999,80,531,611
451909,2,1,80,531,611
451918,1,999,12,234,246
451918,2,1,12,234,246
451936,1,999,574,186,760
451936,2,1,574,186,760
451945,1,999,569,230,799
451945,2,1,569,230,799
451954,1,999,402,66,468
451954,2,1,402,66,468
451963,1,999,557,214,771
451963,2,1,557,214,771
451972,1,999,657,242,899
451972,2,1,657,242,899
451981,1,999,438,212,650
451981,2,1,438,212,650
451990,1,999,634,286,920
451990,2,1,634,286,920
452009,1,999,0,105,105
452009,2,1,0,105,105
452018,1,999,285,352,637
452018,2,1,285,352,637
452027,1,999,286,337,623
452027,2,1,286,337,623
452036,1,999,467,401,868
452036,2,1,467,401,868
452045,1,999,329,245,574
452045,2,1,329,245,574
452054,1,999,665,412,1077
452054,2,1,665,412,1077
452063,1,999,805,579,1384
452063,2,1,805,579,1384
452072,1,999,22,278,300
452072,2,1,22,278,300
452081,1,999,10,361,371
452081,2,1,10,361,371
452090,1,999,205,266,471
452090,2,1,72,83,155
452090,4,3,133,183,316
452106,1,999,84,2,86
452106,2,1,84,2,86
452115,1,999,86,1350,1436
452115,2,1,86,1350,1436
452124,1,999,243,910,1153
452124,2,1,243,910,1153
452133,1,999,716,2557,3273
452133,2,1,510,2350,2860
452133,4,3,206,207,413
452188,1,999,0,25,25
452188,2,1,0,25,25
452203,1,999,93,0,93
452203,2,1,93,0,93
452212,1,999,0,21,21
452212,2,1,0,21,21
452230,1,999,122,0,122
452230,2,1,122,0,122
452373,1,999,63,205,268
452373,2,1,63,205,268
452522,1,999,1,2,3
452522,2,1,1,2,3
452540,1,999,17,20,37
452540,2,1,17,20,37
452692,1,999,0,12,12
452692,2,1,0,12,12
452771,1,999,1,35,36
452771,2,1,1,35,36
452780,1,999,0,39,39
452780,2,1,0,39,39
452841,1,999,69,271,340
452841,2,1,69,271,340
452948,1,999,70,396,466
452948,2,1,70,396,466
452957,1,999,2,3,5
452957,2,1,2,3,5
452984,1,999,7,22,29
452984,2,1,7,22,29
453075,1,999,29,108,137
453075,2,1,29,108,137
453109,1,999,125,238,363
453109,2,1,125,238,363
453127,1,999,655,1027,1682
453127,2,1,569,888,1457
453127,4,3,86,139,225
453163,1,999,2542,6521,9063
453163,2,1,1738,4139,5877
453163,4,3,804,2382,3186
453215,1,999,390,658,1048
453215,2,1,339,551,890
453215,4,3,51,107,158
453297,1,999,40,40,80
453297,2,1,40,40,80
453349,1,999,431,665,1096
453349,2,1,431,665,1096
453455,1,999,183,669,852
453455,2,1,183,669,852
453464,1,999,278,966,1244
453464,2,1,278,966,1244
453473,1,999,286,715,1001
453473,2,1,286,715,1001
453482,1,999,176,474,650
453482,2,1,176,474,650
453552,1,999,115,837,952
453552,2,1,115,837,952
453570,1,999,8,87,95
453570,2,1,8,87,95
453677,1,999,0,2,2
453677,2,1,0,2,2
453747,1,999,28,266,294
453747,2,1,28,266,294
453756,1,999,155,61,216
453756,2,1,155,61,216
453792,1,999,96,647,743
453792,2,1,96,647,743
453817,1,999,383,14,397
453817,2,1,383,14,397
453923,1,999,1,7,8
453923,2,1,1,7,8
454032,1,999,207,200,407
454032,2,1,207,200,407
454078,1,999,35,47,82
454078,2,1,35,47,82
454175,1,999,206,563,769
454175,2,1,206,563,769
454184,1,999,136,210,346
454184,2,1,136,210,346
454193,1,999,2,84,86
454193,2,1,2,84,86
454209,1,999,101,70,171
454209,2,1,101,70,171
454227,1,999,114,937,1051
454227,2,1,84,605,689
454227,4,3,30,332,362
454236,1,999,104,1025,1129
454236,2,1,104,1025,1129
454245,1,999,53,257,310
454245,2,1,53,257,310
454263,1,999,42,295,337
454263,2,1,42,295,337
454281,1,999,3,40,43
454281,2,1,3,40,43
454290,1,999,5,138,143
454290,2,1,5,138,143
454306,1,999,20,259,279
454306,2,1,20,259,279
454315,1,999,5,172,177
454315,2,1,5,172,177
454324,1,999,6,162,168
454324,2,1,6,162,168
454333,1,999,4,139,143
454333,2,1,4,139,143
454342,1,999,3,188,191
454342,2,1,3,188,191
454351,1,999,14,248,262
454351,2,1,14,248,262
454360,1,999,9,253,262
454360,2,1,9,253,262
454379,1,999,6,159,165
454379,2,1,6,159,165
454388,1,999,13,186,199
454388,2,1,13,186,199
454397,1,999,3,169,172
454397,2,1,3,169,172
454403,1,999,191,76,267
454403,2,1,191,76,267
454412,1,999,120,45,165
454412,2,1,120,45,165
454421,1,999,101,27,128
454421,2,1,101,27,128
454430,1,999,160,15,175
454430,2,1,160,15,175
454449,1,999,69,8,77
454449,2,1,69,8,77
454458,1,999,98,281,379
454458,2,1,98,281,379
454467,1,999,12,148,160
454467,2,1,12,148,160
454476,1,999,7,180,187
454476,2,1,7,180,187
454485,1,999,10,126,136
454485,2,1,10,126,136
454494,1,999,15,204,219
454494,2,1,15,204,219
454500,1,999,23,152,175
454500,2,1,23,152,175
454519,1,999,8,168,176
454519,2,1,8,168,176
454528,1,999,3,123,126
454528,2,1,3,123,126
454537,1,999,8,126,134
454537,2,1,8,126,134
454546,1,999,31,337,368
454546,2,1,31,337,368
454555,1,999,12,360,372
454555,2,1,12,360,372
454564,1,999,273,1011,1284
454564,2,1,273,1011,1284
454573,1,999,5,376,381
454573,2,1,5,376,381
454582,1,999,188,331,519
454582,2,1,157,269,426
454582,4,3,31,62,93
454591,1,999,68,197,265
454591,2,1,68,197,265
454607,1,999,11,266,277
454607,2,1,11,266,277
454616,1,999,460,79,539
454616,2,1,460,79,539
454625,1,999,159,1783,1942
454625,2,1,159,1783,1942
454634,1,999,1168,297,1465
454634,2,1,1168,297,1465
454652,1,999,17,183,200
454652,2,1,17,183,200
454689,1,999,344,255,599
454689,4,3,344,255,599
454698,1,999,131,233,364
454698,2,1,131,233,364
454704,1,999,21,1,22
454704,2,1,21,1,22
454713,1,999,122,474,596
454713,2,1,122,474,596
454722,1,999,2,31,33
454722,2,1,2,31,33
454731,1,999,102,163,265
454731,2,1,102,163,265
454740,1,999,83,262,345
454740,2,1,83,262,345
454759,1,999,33,3,36
454759,2,1,33,3,36
454768,1,999,21,230,251
454768,2,1,21,230,251
454777,1,999,30,246,276
454777,2,1,30,246,276
454786,1,999,165,206,371
454786,2,1,165,206,371
454795,1,999,7,35,42
454795,2,1,7,35,42
454801,1,999,28,115,143
454801,2,1,28,115,143
454810,1,999,27,73,100
454810,2,1,27,73,100
454829,1,999,653,419,1072
454829,2,1,123,91,214
454829,4,3,530,328,858
454838,1,999,12,29,41
454838,4,3,12,29,41
454847,1,999,11,76,87
454847,2,1,11,76,87
454856,1,999,45,395,440
454856,2,1,45,395,440
454865,1,999,117,394,511
454865,2,1,117,394,511
454874,1,999,16,151,167
454874,2,1,16,151,167
454883,1,999,38,481,519
454883,2,1,38,481,519
454892,1,999,10,53,63
454892,2,1,10,53,63
454908,1,999,238,238,476
454908,2,1,238,238,476
454917,1,999,7,281,288
454917,2,1,7,281,288
454926,1,999,43,305,348
454926,2,1,43,305,348
454935,1,999,3,66,69
454935,2,1,3,66,69
454944,1,999,10,228,238
454944,2,1,10,228,238
454953,1,999,0,27,27
454953,2,1,0,27,27
454962,1,999,0,25,25
454962,2,1,0,25,25
454971,1,999,12,310,322
454971,2,1,12,310,322
454980,1,999,7,121,128
454980,2,1,7,121,128
454999,1,999,2,93,95
454999,2,1,2,93,95
455008,1,999,8,164,172
455008,2,1,8,164,172
455017,1,999,2,41,43
455017,2,1,2,41,43
455026,1,999,79,6,85
455026,2,1,79,6,85
455035,1,999,23,15,38
455035,2,1,23,15,38
455053,1,999,30,156,186
455053,2,1,30,156,186
455062,1,999,6,65,71
455062,2,1,6,65,71
455071,1,999,23,79,102
455071,2,1,23,79,102
455080,1,999,15,249,264
455080,2,1,15,249,264
455099,1,999,32,28,60
455099,4,3,32,28,60
455105,1,999,5,105,110
455105,2,1,5,105,110
455114,1,999,3109,3081,6190
455114,2,1,3109,3081,6190
455141,1,999,28,386,414
455141,2,1,28,386,414
455169,1,999,393,419,812
455169,4,3,393,419,812
455178,1,999,11,36,47
455178,4,3,11,36,47
455187,1,999,17,125,142
455187,2,1,17,125,142
455196,1,999,176,837,1013
455196,2,1,176,837,1013
455202,1,999,37,157,194
455202,2,1,37,157,194
455211,1,999,12,177,189
455211,2,1,12,177,189
455220,1,999,6,104,110
455220,2,1,6,104,110
455239,1,999,5,100,105
455239,2,1,5,100,105
455248,1,999,0,10,10
455248,2,1,0,10,10
455257,1,999,252,0,252
455257,2,1,252,0,252
455266,1,999,1,66,67
455266,2,1,1,66,67
455275,1,999,31,401,432
455275,2,1,31,401,432
455284,1,999,20,290,310
455284,2,1,20,290,310
455293,1,999,0,29,29
455293,2,1,0,29,29
455309,1,999,44,139,183
455309,2,1,44,139,183
455318,1,999,2,55,57
455318,2,1,2,55,57
455327,1,999,32,91,123
455327,2,1,32,91,123
455336,1,999,287,21,308
455336,2,1,287,21,308
455345,1,999,12,119,131
455345,2,1,12,119,131
455354,1,999,19,359,378
455354,2,1,19,359,378
455363,1,999,6,40,46
455363,2,1,6,40,46
455372,1,999,0,40,40
455372,2,1,0,40,40
455381,1,999,3,110,113
455381,2,1,3,110,113
455390,1,999,80,417,497
455390,2,1,80,417,497
455406,1,999,82,68,150
455406,4,3,82,68,150
455415,1,999,6,11,17
455415,2,1,6,11,17
455424,1,999,181,27,208
455424,2,1,181,27,208
455433,1,999,28,78,106
455433,4,3,28,78,106
455460,1,999,25,160,185
455460,2,1,25,160,185
455479,1,999,62,790,852
455479,2,1,62,790,852
455488,1,999,167,649,816
455488,2,1,167,649,816
455497,1,999,5,283,288
455497,2,1,5,283,288
455512,1,999,1848,3183,5031
455512,2,1,1848,3183,5031
455530,1,999,745,730,1475
455530,2,1,745,730,1475
455549,1,999,31,274,305
455549,2,1,31,274,305
455558,1,999,254,201,455
455558,2,1,254,201,455
455567,1,999,296,186,482
455567,2,1,296,186,482
455585,1,999,103,381,484
455585,2,1,103,381,484
455594,1,999,4,11,15
455594,4,3,4,11,15
455600,1,999,373,870,1243
455600,2,1,373,870,1243
455619,1,999,137,449,586
455619,2,1,137,449,586
455628,1,999,188,515,703
455628,2,1,188,515,703
455646,1,999,23,132,155
455646,2,1,23,132,155
455655,1,999,148,640,788
455655,2,1,148,640,788
455664,1,999,77,362,439
455664,4,3,77,362,439
455673,1,999,6,176,182
455673,2,1,6,176,182
455682,1,999,67,220,287
455682,4,3,67,220,287
455707,1,999,7,43,50
455707,2,1,7,43,50
455716,1,999,126,601,727
455716,2,1,126,601,727
455725,1,999,9,155,164
455725,2,1,9,155,164
455734,1,999,63,236,299
455734,2,1,63,236,299
455743,1,999,30,93,123
455743,2,1,30,93,123
455752,1,999,61,1,62
455752,2,1,61,1,62
455761,1,999,19,347,366
455761,2,1,19,347,366
455770,1,999,29,36,65
455770,2,1,29,36,65
455789,1,999,1,16,17
455789,2,1,1,16,17
455798,1,999,4,53,57
455798,2,1,4,53,57
455804,1,999,109,42,151
455804,4,3,109,42,151
455813,1,999,44,45,89
455813,4,3,44,45,89
455822,1,999,10,149,159
455822,2,1,10,149,159
455831,1,999,20,192,212
455831,2,1,20,192,212
455840,1,999,15,135,150
455840,2,1,15,135,150
455859,1,999,5,123,128
455859,2,1,5,123,128
455868,1,999,55,13,68
455868,2,1,55,13,68
455877,1,999,15,128,143
455877,2,1,15,128,143
455886,1,999,8,160,168
455886,2,1,8,160,168
455895,1,999,4,194,198
455895,2,1,4,194,198
455901,1,999,13,253,266
455901,2,1,13,253,266
455910,1,999,29,70,99
455910,2,1,29,70,99
455929,1,999,9,94,103
455929,2,1,9,94,103
455938,1,999,2,47,49
455938,2,1,2,47,49
455947,1,999,10,190,200
455947,2,1,10,190,200
455956,1,999,41,23,64
455956,2,1,41,23,64
455965,1,999,15,169,184
455965,2,1,15,169,184
455974,1,999,4,42,46
455974,2,1,4,42,46
455983,1,999,157,253,410
455983,2,1,157,253,410
455992,1,999,68,243,311
455992,4,3,68,243,311
456001,1,999,31,1,32
456001,2,1,31,1,32
456010,1,999,40,58,98
456010,2,1,40,58,98
456029,1,999,17,292,309
456029,2,1,17,292,309
456038,1,999,150,864,1014
456038,2,1,150,864,1014
456056,1,999,114,827,941
456056,2,1,114,827,941
456065,1,999,13,225,238
456065,2,1,13,225,238
456074,1,999,7,163,170
456074,2,1,7,163,170
456092,1,999,6,125,131
456092,2,1,6,125,131
456117,1,999,52,69,121
456117,2,1,52,69,121
456126,1,999,18,185,203
456126,2,1,18,185,203
456135,1,999,8,235,243
456135,2,1,8,235,243
456144,1,999,162,10,172
456144,2,1,162,10,172
456153,1,999,167,21,188
456153,2,1,167,21,188
456171,1,999,35,26,61
456171,4,3,35,26,61
456180,1,999,58,203,261
456180,2,1,58,203,261
456205,1,999,82,743,825
456205,2,1,82,743,825
456214,1,999,263,367,630
456214,2,1,263,367,630
456250,1,999,20,439,459
456250,2,1,20,439,459
456278,1,999,243,1191,1434
456278,2,1,243,1191,1434
456287,1,999,8,182,190
456287,2,1,8,182,190
456296,1,999,1330,1680,3010
456296,2,1,1330,1680,3010
456302,1,999,474,300,774
456302,2,1,474,300,774
456311,1,999,81,576,657
456311,2,1,81,576,657
456320,1,999,341,1093,1434
456320,2,1,341,1093,1434
456339,1,999,165,417,582
456339,2,1,165,417,582
456348,1,999,3717,12046,15763
456348,2,1,2191,7590,9781
456348,4,3,1526,4456,5982
456357,1,999,112,980,1092
456357,2,1,112,980,1092
456366,1,999,61,577,638
456366,2,1,61,577,638
456375,1,999,16,193,209
456375,2,1,16,193,209
456384,1,999,10,267,277
456384,2,1,10,267,277
456393,1,999,313,137,450
456393,2,1,313,137,450
456409,1,999,402,119,521
456409,2,1,402,119,521
456418,1,999,397,206,603
456418,2,1,397,206,603
456427,1,999,484,130,614
456427,2,1,484,130,614
456436,1,999,366,87,453
456436,2,1,366,87,453
456445,1,999,367,129,496
456445,2,1,367,129,496
456454,1,999,96,134,230
456454,2,1,96,134,230
456481,1,999,109,147,256
456481,2,1,62,90,152
456481,4,3,47,57,104
456490,1,999,170,68,238
456490,2,1,143,51,194
456490,4,3,27,17,44
456506,1,999,12,241,253
456506,2,1,12,241,253
456515,1,999,19,199,218
456515,2,1,19,199,218
456542,1,999,52,26,78
456542,4,3,52,26,78
456551,1,999,2,92,94
456551,2,1,2,92,94
456560,1,999,80,64,144
456560,2,1,80,64,144
456588,1,999,7,63,70
456588,2,1,7,63,70
456597,1,999,12,204,216
456597,2,1,12,204,216
456612,1,999,212,482,694
456612,2,1,212,482,694
456621,1,999,174,265,439
456621,2,1,154,223,377
456621,4,3,20,42,62
456630,1,999,111,101,212
456630,2,1,85,82,167
456630,4,3,26,19,45
456667,1,999,388,617,1005
456667,2,1,329,521,850
456667,4,3,59,96,155
456719,1,999,8,206,214
456719,2,1,8,206,214
456728,1,999,7,111,118
456728,2,1,7,111,118
456737,1,999,11,153,164
456737,2,1,11,153,164
456746,1,999,8,125,133
456746,2,1,8,125,133
456755,1,999,7,76,83
456755,2,1,7,76,83
456764,1,999,5,175,180
456764,2,1,5,175,180
456773,1,999,8,110,118
456773,2,1,8,110,118
456782,1,999,190,418,608
456782,2,1,190,418,608
456791,1,999,149,544,693
456791,2,1,149,544,693
456807,1,999,103,455,558
456807,2,1,101,452,553
456807,4,3,2,3,5
456816,1,999,256,847,1103
456816,2,1,248,841,1089
456816,4,3,8,6,14
456825,1,999,17,142,159
456825,2,1,17,142,159
456834,1,999,207,167,374
456834,2,1,107,124,231
456834,4,3,100,43,143
456852,1,999,115,399,514
456852,2,1,115,399,514
456861,1,999,242,997,1239
456861,2,1,242,997,1239
456870,1,999,701,953,1654
456870,2,1,701,953,1654
456889,1,999,174,734,908
456889,2,1,174,734,908
456898,1,999,503,293,796
456898,2,1,503,293,796
456904,1,999,321,497,818
456904,2,1,321,497,818
456913,1,999,172,1002,1174
456913,2,1,172,1002,1174
456922,1,999,552,1249,1801
456922,2,1,552,1249,1801
456931,1,999,1146,669,1815
456931,2,1,1146,669,1815
456940,1,999,310,254,564
456940,2,1,310,254,564
456959,1,999,17,40,57
456959,2,1,17,40,57
456968,1,999,4,75,79
456968,2,1,4,75,79
456977,1,999,40,247,287
456977,2,1,40,247,287
456995,1,999,123,118,241
456995,2,1,123,118,241
457004,1,999,64,195,259
457004,2,1,64,195,259
457013,1,999,75,475,550
457013,2,1,75,475,550
457022,1,999,89,369,458
457022,2,1,89,369,458
457031,1,999,0,73,73
457031,2,1,0,73,73
457068,1,999,3,274,277
457068,2,1,3,274,277
457077,1,999,38,261,299
457077,2,1,38,261,299
457086,1,999,36,133,169
457086,2,1,36,133,169
457095,1,999,11,56,67
457095,2,1,11,56,67
457101,1,999,138,318,456
457101,2,1,138,318,456
457110,1,999,23,135,158
457110,2,1,23,135,158
457129,1,999,11,102,113
457129,2,1,11,102,113
457174,1,999,26,496,522
457174,2,1,26,496,522
457183,1,999,11,67,78
457183,2,1,11,67,78
457192,1,999,20,16,36
457192,2,1,20,16,36
457208,1,999,55,52,107
457208,2,1,55,52,107
457217,1,999,43,1,44
457217,2,1,43,1,44
457226,1,999,15,15,30
457226,2,1,15,15,30
457235,1,999,18,9,27
457235,2,1,18,9,27
457244,1,999,75,62,137
457244,2,1,75,62,137
457253,1,999,4,84,88
457253,2,1,4,84,88
457262,1,999,45,80,125
457262,2,1,45,80,125
457271,1,999,23,35,58
457271,4,3,23,35,58
457280,1,999,5,187,192
457280,2,1,5,187,192
457299,1,999,28,54,82
457299,2,1,28,54,82
457305,1,999,30,0,30
457305,2,1,30,0,30
457314,1,999,51,86,137
457314,2,1,51,86,137
457323,1,999,8,303,311
457323,2,1,8,303,311
457332,1,999,0,29,29
457332,2,1,0,29,29
457341,1,999,7,139,146
457341,2,1,7,139,146
457350,1,999,0,33,33
457350,2,1,0,33,33
457369,1,999,1,15,16
457369,2,1,1,15,16
457378,1,999,25,111,136
457378,2,1,25,111,136
457387,1,999,176,246,422
457387,2,1,176,246,422
457396,1,999,19,45,64
457396,2,1,19,45,64
457402,1,999,24,55,79
457402,2,1,17,46,63
457402,4,3,7,9,16
457411,1,999,128,2,130
457411,2,1,128,2,130
457420,1,999,5,107,112
457420,2,1,5,107,112
457439,1,999,3,61,64
457439,2,1,3,61,64
457448,1,999,24,177,201
457448,2,1,24,177,201
457457,1,999,2,16,18
457457,2,1,2,16,18
457466,1,999,50,6,56
457466,2,1,50,6,56
457475,1,999,3,97,100
457475,2,1,3,97,100
457484,1,999,81,57,138
457484,2,1,68,51,119
457484,4,3,13,6,19
457493,1,999,3,26,29
457493,2,1,3,26,29
457509,1,999,0,11,11
457509,2,1,0,11,11
457527,1,999,118,332,450
457527,2,1,118,332,450
457536,1,999,79,297,376
457536,2,1,79,297,376
457545,1,999,7,134,141
457545,2,1,7,134,141
457554,1,999,2,28,30
457554,2,1,2,28,30
457563,1,999,5,103,108
457563,2,1,5,103,108
457572,1,999,12,128,140
457572,2,1,12,128,140
457581,1,999,3,80,83
457581,2,1,3,80,83
457590,1,999,0,45,45
457590,2,1,0,45,45
457606,1,999,5,59,64
457606,2,1,5,59,64
457615,1,999,3,20,23
457615,2,1,3,20,23
457624,1,999,6,18,24
457624,2,1,6,18,24
457633,1,999,4,102,106
457633,2,1,4,102,106
457642,1,999,2,42,44
457642,2,1,2,42,44
457651,1,999,45,133,178
457651,2,1,45,133,178
457660,1,999,2,53,55
457660,2,1,2,53,55
457679,1,999,1,30,31
457679,2,1,1,30,31
457688,1,999,192,76,268
457688,2,1,192,76,268
457697,1,999,48,51,99
457697,2,1,48,51,99
457703,1,999,58,75,133
457703,2,1,58,75,133
457712,1,999,8,35,43
457712,2,1,8,35,43
457721,1,999,3,22,25
457721,2,1,3,22,25
457730,1,999,48,173,221
457730,2,1,48,173,221
457749,1,999,6,150,156
457749,2,1,6,150,156
457758,1,999,78,8,86
457758,2,1,78,8,86
457767,1,999,18,117,135
457767,2,1,18,117,135
457776,1,999,12,84,96
457776,2,1,12,84,96
457785,1,999,7,96,103
457785,2,1,7,96,103
457794,1,999,5,49,54
457794,2,1,5,49,54
457800,1,999,382,1332,1714
457800,2,1,382,1332,1714
457819,1,999,288,403,691
457819,2,1,288,403,691
457828,1,999,26,39,65
457828,2,1,26,39,65
457837,1,999,9,136,145
457837,2,1,9,136,145
457846,1,999,10,62,72
457846,2,1,10,62,72
457855,1,999,8,126,134
457855,2,1,8,126,134
457864,1,999,8,48,56
457864,2,1,8,48,56
457873,1,999,137,238,375
457873,2,1,137,238,375
457882,1,999,3,28,31
457882,2,1,3,28,31
457891,1,999,6,44,50
457891,2,1,6,44,50
457907,1,999,66,62,128
457907,2,1,66,62,128
457916,1,999,5,136,141
457916,2,1,5,136,141
457925,1,999,9,13,22
457925,2,1,9,13,22
457943,1,999,9,23,32
457943,2,1,9,23,32
457952,1,999,10,242,252
457952,2,1,10,242,252
457961,1,999,0,29,29
457961,2,1,0,29,29
457970,1,999,0,6,6
457970,2,1,0,6,6
457989,1,999,3,55,58
457989,2,1,3,55,58
457998,1,999,0,43,43
457998,2,1,0,43,43
458007,1,999,5,74,79
458007,2,1,5,74,79
458016,1,999,150,23,173
458016,2,1,150,23,173
458025,1,999,9,15,24
458025,2,1,9,15,24
458034,1,999,25,36,61
458034,2,1,25,36,61
458043,1,999,3,94,97
458043,2,1,3,94,97
458052,1,999,8,54,62
458052,2,1,8,54,62
458061,1,999,11,38,49
458061,2,1,11,38,49
458070,1,999,15,223,238
458070,2,1,15,223,238
458089,1,999,2,23,25
458089,2,1,2,23,25
458098,1,999,3,147,150
458098,2,1,3,147,150
458104,1,999,2,80,82
458104,2,1,2,80,82
458113,1,999,36,38,74
458113,2,1,36,38,74
458122,1,999,0,13,13
458122,2,1,0,13,13
458131,1,999,17,203,220
458131,2,1,17,203,220
458140,1,999,43,7,50
458140,2,1,43,7,50
458159,1,999,104,117,221
458159,4,3,104,117,221
458168,1,999,5,133,138
458168,2,1,5,133,138
458177,1,999,3,68,71
458177,2,1,3,68,71
458186,1,999,84,249,333
458186,2,1,84,249,333
458195,1,999,25,25,50
458195,2,1,25,25,50
458210,1,999,298,1043,1341
458210,2,1,298,1043,1341
458229,1,999,173,519,692
458229,2,1,173,519,692
458238,1,999,23,98,121
458238,2,1,23,98,121
458247,1,999,40,160,200
458247,2,1,40,160,200
458256,1,999,173,1408,1581
458256,2,1,173,1408,1581
458265,1,999,275,352,627
458265,2,1,275,352,627
458274,1,999,47,363,410
458274,2,1,47,363,410
458283,1,999,217,843,1060
458283,2,1,217,843,1060
458292,1,999,4,66,70
458292,2,1,4,66,70
458308,1,999,3,47,50
458308,2,1,3,47,50
458317,1,999,3,65,68
458317,2,1,3,65,68
458326,1,999,6,43,49
458326,2,1,6,43,49
458335,1,999,5,121,126
458335,2,1,5,121,126
458344,1,999,7,84,91
458344,2,1,7,84,91
458353,1,999,8,75,83
458353,2,1,8,75,83
458362,1,999,7,114,121
458362,2,1,7,114,121
458371,1,999,363,338,701
458371,2,1,363,338,701
458380,1,999,36,330,366
458380,2,1,36,330,366
458405,1,999,44,476,520
458405,2,1,44,476,520
458414,1,999,1113,1975,3088
458414,2,1,1113,1975,3088
458423,1,999,21,59,80
458423,2,1,21,59,80
458432,1,999,22,76,98
458432,2,1,22,76,98
458441,1,999,25,236,261
458441,2,1,25,236,261
458469,1,999,139,609,748
458469,2,1,139,609,748
458478,1,999,34,127,161
458478,2,1,34,127,161
458487,1,999,20,212,232
458487,2,1,20,212,232
458496,1,999,54,73,127
458496,2,1,54,73,127
458502,1,999,86,301,387
458502,2,1,86,301,387
458520,1,999,18,99,117
458520,2,1,18,99,117
458548,1,999,10,9,19
458548,4,3,10,9,19
458557,1,999,52,450,502
458557,2,1,52,450,502
458575,1,999,31,43,74
458575,2,1,31,43,74
458609,1,999,43,355,398
458609,2,1,43,355,398
458618,1,999,32,273,305
458618,2,1,32,273,305
458636,1,999,19,214,233
458636,2,1,19,214,233
458645,1,999,4,103,107
458645,2,1,4,103,107
458654,1,999,60,272,332
458654,2,1,60,272,332
458663,1,999,36,361,397
458663,2,1,36,361,397
458672,1,999,5,12,17
458672,2,1,5,12,17
458681,1,999,23,41,64
458681,2,1,23,41,64
458690,1,999,94,355,449
458690,2,1,94,355,449
458733,1,999,44,123,167
458733,2,1,44,123,167
458742,1,999,91,154,245
458742,2,1,91,154,245
458760,1,999,84,260,344
458760,2,1,78,257,335
458760,4,3,6,3,9
458779,1,999,29,143,172
458779,2,1,29,143,172
458797,1,999,12,60,72
458797,2,1,12,60,72
458803,1,999,9,193,202
458803,2,1,9,193,202
458812,1,999,5,157,162
458812,2,1,5,157,162
458821,1,999,26,139,165
458821,2,1,26,139,165
458849,1,999,0,9,9
458849,2,1,0,9,9
458885,1,999,77,215,292
458885,2,1,63,173,236
458885,4,3,14,42,56
458919,1,999,2596,6898,9494
458919,2,1,1956,5062,7018
458919,4,3,640,1836,2476
458937,1,999,34,77,111
458937,2,1,26,66,92
458937,4,3,8,11,19
458964,1,999,1290,3235,4525
458964,2,1,946,2229,3175
458964,4,3,344,1006,1350
458973,1,999,57,72,129
458973,2,1,49,59,108
458973,4,3,8,13,21
458991,1,999,101,379,480
458991,2,1,101,379,480
459000,1,999,38,262,300
459000,2,1,38,262,300
459019,1,999,15,214,229
459019,2,1,15,214,229
459028,1,999,16,106,122
459028,2,1,16,106,122
459037,1,999,10,178,188
459037,2,1,10,178,188
459046,1,999,18,129,147
459046,2,1,18,129,147
459055,1,999,1,2,3
459055,2,1,1,2,3
459064,1,999,12,121,133
459064,2,1,12,121,133
459073,1,999,13,82,95
459073,2,1,13,82,95
459116,1,999,11,159,170
459116,2,1,11,159,170
459125,1,999,0,21,21
459125,2,1,0,21,21
459134,1,999,0,41,41
459134,2,1,0,41,41
459143,1,999,5,79,84
459143,2,1,5,79,84
459152,1,999,114,203,317
459152,2,1,114,203,317
459161,1,999,34,98,132
459161,2,1,34,98,132
459170,1,999,4,124,128
459170,2,1,4,124,128
459189,1,999,2,65,67
459189,2,1,2,65,67
459198,1,999,3,70,73
459198,2,1,3,70,73
459204,1,999,106,326,432
459204,2,1,106,326,432
459213,1,999,43,273,316
459213,2,1,43,273,316
459222,1,999,30,38,68
459222,4,3,30,38,68
459231,1,999,20,247,267
459231,2,1,20,247,267
459240,1,999,4,22,26
459240,2,1,4,22,26
459259,1,999,51,241,292
459259,2,1,44,195,239
459259,4,3,7,46,53
459268,1,999,29,59,88
459268,2,1,25,41,66
459268,4,3,4,18,22
459277,1,999,16,338,354
459277,2,1,16,338,354
459286,1,999,22,186,208
459286,2,1,22,186,208
459295,1,999,8,138,146
459295,2,1,8,138,146
459301,1,999,1,108,109
459301,2,1,1,108,109
459310,1,999,2,4,6
459310,2,1,2,4,6
459329,1,999,69,130,199
459329,2,1,69,130,199
459338,1,999,5,64,69
459338,2,1,5,64,69
459347,1,999,10,43,53
459347,2,1,10,43,53
459356,1,999,52,137,189
459356,2,1,52,137,189
459365,1,999,1,25,26
459365,2,1,1,25,26
459374,1,999,4,48,52
459374,2,1,4,48,52
459392,1,999,13,106,119
459392,2,1,13,106,119
459408,1,999,7,64,71
459408,2,1,7,64,71
459417,1,999,30,5,35
459417,2,1,30,5,35
459426,1,999,2,73,75
459426,2,1,2,73,75
459435,1,999,86,0,86
459435,2,1,86,0,86
459444,1,999,1,249,250
459444,2,1,1,249,250
459453,1,999,9,85,94
459453,2,1,9,85,94
459462,1,999,212,18,230
459462,2,1,212,18,230
459471,1,999,0,30,30
459471,2,1,0,30,30
459480,1,999,1,34,35
459480,2,1,1,34,35
459499,1,999,5,4,9
459499,2,1,5,4,9
459514,1,999,1,25,26
459514,2,1,1,25,26
459523,1,999,20,76,96
459523,2,1,20,76,96
459532,1,999,6,140,146
459532,2,1,6,140,146
459541,1,999,1,73,74
459541,2,1,1,73,74
459550,1,999,5,163,168
459550,2,1,5,163,168
459569,1,999,1,13,14
459569,2,1,1,13,14
459578,1,999,7,169,176
459578,2,1,7,169,176
459587,1,999,140,105,245
459587,2,1,140,105,245
459596,1,999,202,123,325
459596,2,1,202,123,325
459602,1,999,157,55,212
459602,2,1,157,55,212
459611,1,999,202,30,232
459611,2,1,202,30,232
459620,1,999,75,16,91
459620,2,1,75,16,91
459639,1,999,245,30,275
459639,2,1,245,30,275
459648,1,999,125,49,174
459648,2,1,125,49,174
459657,1,999,154,52,206
459657,2,1,154,52,206
459666,1,999,27,7,34
459666,2,1,27,7,34
459675,1,999,265,40,305
459675,2,1,265,40,305
459684,1,999,305,108,413
459684,2,1,305,108,413
459693,1,999,200,81,281
459693,2,1,200,81,281
459709,1,999,558,223,781
459709,2,1,558,223,781
459718,1,999,366,121,487
459718,2,1,366,121,487
459727,1,999,77,93,170
459727,2,1,51,65,116
459727,4,3,26,28,54
459736,1,999,554,897,1451
459736,4,3,554,897,1451
459815,1,999,156,43,199
459815,2,1,156,43,199
459824,1,999,710,1265,1975
459824,2,1,56,154,210
459824,4,3,654,1111,1765
459833,1,999,25,65,90
459833,2,1,25,65,90
459842,1,999,59,196,255
459842,2,1,59,196,255
459851,1,999,13,16,29
459851,2,1,13,16,29
459860,1,999,90,196,286
459860,2,1,90,196,286
459879,1,999,89,145,234
459879,2,1,89,145,234
459888,1,999,42,137,179
459888,2,1,42,137,179
459897,1,999,35,38,73
459897,2,1,35,38,73
459903,1,999,57,96,153
459903,2,1,57,96,153
459912,1,999,33,102,135
459912,2,1,33,102,135
459921,1,999,17,71,88
459921,2,1,17,71,88
459958,1,999,82,548,630
459958,2,1,82,548,630
459967,1,999,25,253,278
459967,2,1,25,253,278
459976,1,999,5,113,118
459976,2,1,5,113,118
459985,1,999,54,304,358
459985,2,1,54,304,358
459994,1,999,3011,5860,8871
459994,2,1,2470,4545,7015
459994,4,3,541,1315,1856
460002,1,999,8,67,75
460002,2,1,8,67,75
460011,1,999,1,58,59
460011,2,1,1,58,59
460020,1,999,23,65,88
460020,2,1,23,65,88
460039,1,999,57,108,165
460039,2,1,57,108,165
460048,1,999,30,108,138
460048,2,1,30,108,138
460057,1,999,1,24,25
460057,2,1,1,24,25
460066,1,999,6,87,93
460066,2,1,6,87,93
460093,1,999,10,307,317
460093,2,1,10,307,317
460109,1,999,6,153,159
460109,2,1,6,153,159
460118,1,999,1,21,22
460118,2,1,1,21,22
460136,1,999,24,11,35
460136,2,1,24,11,35
460172,1,999,18,1,19
460172,2,1,18,1,19
460181,1,999,2,27,29
460181,2,1,2,27,29
460190,1,999,23,146,169
460190,2,1,23,146,169
460206,1,999,9,62,71
460206,2,1,9,62,71
460330,1,999,67,142,209
460330,2,1,67,142,209
460358,1,999,67,212,279
460358,2,1,67,212,279
460385,1,999,5,41,46
460385,2,1,5,41,46
460446,1,999,5,123,128
460446,2,1,5,123,128
460455,1,999,12,46,58
460455,2,1,12,46,58
460473,1,999,52,186,238
460473,2,1,52,186,238
460491,1,999,6,39,45
460491,2,1,6,39,45
460507,1,999,2,69,71
460507,2,1,2,69,71
460516,1,999,4,62,66
460516,2,1,4,62,66
460525,1,999,3,16,19
460525,2,1,3,16,19
460561,1,999,1,25,26
460561,2,1,1,25,26
460570,1,999,19,141,160
460570,2,1,19,141,160
460589,1,999,25,373,398
460589,2,1,25,373,398
460598,1,999,124,774,898
460598,2,1,124,774,898
460604,1,999,24,2,26
460604,2,1,24,2,26
460622,1,999,24,31,55
460622,2,1,24,31,55
460631,1,999,21,148,169
460631,2,1,21,148,169
460640,1,999,48,101,149
460640,2,1,48,101,149
